state_code,state,puma_code,puma,total_native_citizen_non_hispanic,total_naturalized_citizen_hispanic,total_non_citizen_hispanic,total_native_citizen_hispanic,total_naturalized_citizen_non_hispanic,total_non_citizen_non_hispanic,total_native_citizen,total_naturalized_citizen,total_non_citizen,total_foreign_non_hispanic,total_foreign_hispanic,total_foreign,total_employees,pct_native_citizen_non_hispanic,pct_native_citizen_hispanic,pct_total_foreign_non_hispanic,pct_total_foreign_hispanic,pct_naturalized_citizen_non_hispanic,pct_naturalized_citizen_hispanic,pct_non_citizen_non_hispanic,pct_non_citizen_hispanic,pct_native_citizen,pct_total_foreign,pct_naturalized_citizen,pct_non_citizen
01,Alabama/AL,0100100,"Lauderdale, Colbert, Franklin & Marion (Northeast) Counties PUMA, Alabama/AL",1210,406,399,0,0,0,1210,406,399,0,805,805,2015,60,0,0,40,0,20,0,20,60,40,20,20
01,Alabama/AL,0100200,"Limestone & Madison (Outer) Counties--Huntsville City (Far West & Southwest) PUMA, Alabama/AL",530,21,67,0,0,0,530,21,67,0,88,88,618,86,0,0,14,0,3,0,11,86,14,3,11
01,Alabama/AL,0100301,"Huntsville (North) & Madison (East) Cities PUMA, Alabama/AL",325,0,0,0,0,0,325,0,0,0,0,0,325,100,0,0,0,0,0,0,0,100,0,0,0
01,Alabama/AL,0100302,"Huntsville City (Central & South) PUMA, Alabama/AL",178,0,11,36,0,0,214,0,11,0,11,11,225,79,16,0,5,0,0,0,5,95,5,0,5
01,Alabama/AL,0100400,"DeKalb & Jackson Counties PUMA, Alabama/AL",697,39,631,326,0,0,1023,39,631,0,670,670,1693,41,19,0,40,0,2,0,37,60,40,2,37
01,Alabama/AL,0100500,"Marshall & Madison (Southeast) Counties--Huntsville City (Far Southeast) PUMA, Alabama/AL",1202,139,893,105,13,294,1307,152,1187,307,1032,1339,2646,45,4,12,39,0,5,11,34,49,51,6,45
01,Alabama/AL,0100600,"Morgan & Lawrence Counties--Decatur City PUMA, Alabama/AL",1075,0,112,68,0,120,1143,0,232,120,112,232,1375,78,5,9,8,0,0,9,8,83,17,0,17
01,Alabama/AL,0100700,"Cullman & Winston Counties PUMA, Alabama/AL",696,0,61,1,0,0,697,0,61,0,61,61,758,92,0,0,8,0,0,0,8,92,8,0,8
01,Alabama/AL,0100800,"St. Clair & Blount Counties PUMA, Alabama/AL",602,87,131,35,0,0,637,87,131,0,218,218,855,70,4,0,25,0,10,0,15,75,25,10,15
01,Alabama/AL,0100900,"Etowah County PUMA, Alabama/AL",908,45,59,55,6,0,963,51,59,6,104,110,1073,85,5,1,10,1,4,0,5,90,10,5,5
01,Alabama/AL,0101000,"Talladega, Cherokee, Randolph, Cleburne & Clay Counties PUMA, Alabama/AL",691,0,0,46,0,0,737,0,0,0,0,0,737,94,6,0,0,0,0,0,0,100,0,0,0
01,Alabama/AL,0101100,"Calhoun County PUMA, Alabama/AL",574,0,47,4,0,0,578,0,47,0,47,47,625,92,1,0,8,0,0,0,8,92,8,0,8
01,Alabama/AL,0101200,"Shelby County PUMA, Alabama/AL",123,0,116,0,0,0,123,0,116,0,116,116,239,51,0,0,49,0,0,0,49,51,49,0,49
01,Alabama/AL,0101301,"Birmingham City (West) PUMA, Alabama/AL",203,0,19,0,0,0,203,0,19,0,19,19,222,91,0,0,9,0,0,0,9,91,9,0,9
01,Alabama/AL,0101302,"Birmingham City (East) PUMA, Alabama/AL",234,0,109,0,0,0,234,0,109,0,109,109,343,68,0,0,32,0,0,0,32,68,32,0,32
01,Alabama/AL,0101303,"Jefferson County (Southeast)--Hoover (North), Vestavia Hills & Homewood Cities PUMA, Alabama/AL",136,0,33,13,0,0,149,0,33,0,33,33,182,75,7,0,18,0,0,0,18,82,18,0,18
01,Alabama/AL,0101304,"Jefferson County (Northeast)--Trussville, Center Point & Gardendale Cities PUMA, Alabama/AL",363,17,0,0,0,0,363,17,0,0,17,17,380,96,0,0,4,0,4,0,0,96,4,4,0
01,Alabama/AL,0101305,"Jefferson County (West)--Bessemer, Hueytown & Pleasant Grove Cities PUMA, Alabama/AL",74,0,0,0,0,0,74,0,0,0,0,0,74,100,0,0,0,0,0,0,0,100,0,0,0
01,Alabama/AL,0101400,"Walker, Marion (South & West), Fayette & Lamar Counties PUMA, Alabama/AL",339,0,0,0,0,0,339,0,0,0,0,0,339,100,0,0,0,0,0,0,0,100,0,0,0
01,Alabama/AL,0101500,"Tuscaloosa (Outer) & Pickens Counties--Northport City (North & West) PUMA, Alabama/AL",352,10,0,0,0,0,352,10,0,0,10,10,362,97,0,0,3,0,3,0,0,97,3,3,0
01,Alabama/AL,0101600,"Tuscaloosa & Northport (Southeast) Cities PUMA, Alabama/AL",247,0,0,0,0,0,247,0,0,0,0,0,247,100,0,0,0,0,0,0,0,100,0,0,0
01,Alabama/AL,0101700,"Dallas, Bibb, Marengo, Hale, Sumter, Perry & Greene Counties PUMA, Alabama/AL",868,0,5,4,0,0,872,0,5,0,5,5,877,99,0,0,1,0,0,0,1,99,1,0,1
01,Alabama/AL,0101800,"Chilton, Tallapoosa, Chambers & Coosa Counties PUMA, Alabama/AL",348,0,0,0,0,0,348,0,0,0,0,0,348,100,0,0,0,0,0,0,0,100,0,0,0
01,Alabama/AL,0101900,"Lee County--Auburn City PUMA, Alabama/AL",600,0,65,0,0,0,600,0,65,0,65,65,665,90,0,0,10,0,0,0,10,90,10,0,10
01,Alabama/AL,0102000,"Montgomery City & Pike Road Town (North) PUMA, Alabama/AL",311,0,0,23,0,0,334,0,0,0,0,0,334,93,7,0,0,0,0,0,0,100,0,0,0
01,Alabama/AL,0102100,"Elmore, Autauga, Montgomery (Outer) & Lowndes Counties PUMA, Alabama/AL",324,0,10,0,16,34,324,16,44,50,10,60,384,84,0,13,3,4,0,9,3,84,16,4,11
01,Alabama/AL,0102200,"Southwest Alabama PUMA, Alabama/AL",338,0,0,27,0,0,365,0,0,0,0,0,365,93,7,0,0,0,0,0,0,100,0,0,0
01,Alabama/AL,0102300,"Coffee, Covington, Butler & Crenshaw Counties PUMA, Alabama/AL",1371,0,14,30,0,0,1401,0,14,0,14,14,1415,97,2,0,1,0,0,0,1,99,1,0,1
01,Alabama/AL,0102400,"Russell, Pike, Barbour, Macon & Bullock Counties PUMA, Alabama/AL",1761,0,0,31,0,0,1792,0,0,0,0,0,1792,98,2,0,0,0,0,0,0,100,0,0,0
01,Alabama/AL,0102500,"Houston, Dale, Geneva & Henry Counties--Dothan City PUMA, Alabama/AL",1559,8,22,97,5,78,1656,13,100,83,30,113,1769,88,5,5,2,0,0,4,1,94,6,1,6
01,Alabama/AL,0102600,"Baldwin County PUMA, Alabama/AL",350,0,0,9,0,0,359,0,0,0,0,0,359,97,3,0,0,0,0,0,0,100,0,0,0
01,Alabama/AL,0102701,"Mobile City (East) PUMA, Alabama/AL",79,0,0,0,0,0,79,0,0,0,0,0,79,100,0,0,0,0,0,0,0,100,0,0,0
01,Alabama/AL,0102702,"Mobile City (West) PUMA, Alabama/AL",96,0,0,0,0,67,96,0,67,67,0,67,163,59,0,41,0,0,0,41,0,59,41,0,41
01,Alabama/AL,0102703,"Mobile County (Outer)--Prichard City, Tillmans Corner & Saraland City PUMA, Alabama/AL",522,0,0,0,87,20,522,87,20,107,0,107,629,83,0,17,0,14,0,3,0,83,17,14,3
02,Alaska/AK,0200101,"Anchorage Municipality (North) PUMA, Alaska/AK",28,0,0,0,0,0,28,0,0,0,0,0,28,100,0,0,0,0,0,0,0,100,0,0,0
02,Alaska/AK,0200102,"Anchorage Municipality (South) PUMA, Alaska/AK",162,29,0,0,0,30,162,29,30,30,29,59,221,73,0,14,13,0,13,14,0,73,27,13,14
02,Alaska/AK,0200200,"Matanuska-Susitna & Kenai Peninsula Boroughs PUMA, Alaska/AK",186,4,0,12,1,84,198,5,84,85,4,89,287,65,4,30,1,0,1,29,0,69,31,2,29
02,Alaska/AK,0200300,"Greater Fairbanks, Greater Juneau, Ketchikan Gateway Borough & Road-Connected Alaska PUMA, Alaska/AK",250,0,0,0,184,227,250,184,227,411,0,411,661,38,0,62,0,28,0,34,0,38,62,28,34
02,Alaska/AK,0200400,"Subsistence Alaska PUMA, Alaska/AK",400,129,484,38,469,2024,438,598,2508,2493,613,3106,3544,11,1,70,17,13,4,57,14,12,88,17,71
04,Arizona/AZ,0400100,"Maricopa County--Gilbert (South) & Queen Creek Towns PUMA, Arizona/AZ",56,28,55,0,18,0,56,46,55,18,83,101,157,36,0,11,53,11,18,0,35,36,64,29,35
04,Arizona/AZ,0400101,"Maricopa County--Mesa City (East) PUMA, Arizona/AZ",24,2,64,97,21,0,121,23,64,21,66,87,208,12,47,10,32,10,1,0,31,58,42,11,31
04,Arizona/AZ,0400102,"Maricopa County--Mesa City (North Central) PUMA, Arizona/AZ",17,0,4,84,43,0,101,43,4,43,4,47,148,11,57,29,3,29,0,0,3,68,32,29,3
04,Arizona/AZ,0400103,"Maricopa County--Mesa City (West) PUMA, Arizona/AZ",34,0,56,126,37,0,160,37,56,37,56,93,253,13,50,15,22,15,0,0,22,63,37,15,22
04,Arizona/AZ,0400104,"Maricopa County--Mesa City (South Central) PUMA, Arizona/AZ",116,0,138,0,0,0,116,0,138,0,138,138,254,46,0,0,54,0,0,0,54,46,54,0,54
04,Arizona/AZ,0400105,"Maricopa County--Gilbert Town (North) PUMA, Arizona/AZ",49,0,5,68,0,0,117,0,5,0,5,5,122,40,56,0,4,0,0,0,4,96,4,0,4
04,Arizona/AZ,0400106,"Maricopa County--Chandler City (Northeast) PUMA, Arizona/AZ",0,85,44,16,0,31,16,85,75,31,129,160,176,0,9,18,73,0,48,18,25,9,91,48,43
04,Arizona/AZ,0400107,"Maricopa County--Chandler City (South) PUMA, Arizona/AZ",72,0,0,63,0,0,135,0,0,0,0,0,135,53,47,0,0,0,0,0,0,100,0,0,0
04,Arizona/AZ,0400108,"Maricopa County--Tempe (South) & Chandler (Northwest) Cities PUMA, Arizona/AZ",80,0,19,25,42,0,105,42,19,42,19,61,166,48,15,25,11,25,0,0,11,63,37,25,11
04,Arizona/AZ,0400109,"Maricopa County--Tempe City (North) PUMA, Arizona/AZ",71,0,102,0,0,20,71,0,122,20,102,122,193,37,0,10,53,0,0,10,53,37,63,0,63
04,Arizona/AZ,0400110,"Maricopa County--Scottsdale City (Southwest) & Paradise Valley Town PUMA, Arizona/AZ",0,0,105,53,0,0,53,0,105,0,105,105,158,0,34,0,66,0,0,0,66,34,66,0,66
04,Arizona/AZ,0400111,"Maricopa County (Northeast)--Scottsdale City (Southeast) & Fountain Hills Town PUMA, Arizona/AZ",60,23,59,44,0,0,104,23,59,0,82,82,186,32,24,0,44,0,12,0,32,56,44,12,32
04,Arizona/AZ,0400112,"Maricopa County--Scottsdale (North), Phoenix (Far Northeast) Cities & Cave Creek PUMA, Arizona/AZ",28,61,0,0,0,0,28,61,0,0,61,61,89,31,0,0,69,0,69,0,0,31,69,69,0
04,Arizona/AZ,0400113,"Phoenix City (Northeast) PUMA, Arizona/AZ",38,0,121,0,0,0,38,0,121,0,121,121,159,24,0,0,76,0,0,0,76,24,76,0,76
04,Arizona/AZ,0400114,"Phoenix City (Northeast Central) PUMA, Arizona/AZ",0,0,61,0,0,0,0,0,61,0,61,61,61,0,0,0,100,0,0,0,100,0,100,0,100
04,Arizona/AZ,0400115,"Phoenix City (Northwest Central) PUMA, Arizona/AZ",176,0,89,126,41,0,302,41,89,41,89,130,432,41,29,9,21,9,0,0,21,70,30,9,21
04,Arizona/AZ,0400116,"Phoenix City (Uptown) PUMA, Arizona/AZ",7,0,189,84,32,121,91,32,310,153,189,342,433,2,19,35,44,7,0,28,44,21,79,7,72
04,Arizona/AZ,0400117,"Phoenix City (East) PUMA, Arizona/AZ",0,0,92,31,0,0,31,0,92,0,92,92,123,0,25,0,75,0,0,0,75,25,75,0,75
04,Arizona/AZ,0400118,"Phoenix City--Downtown & Sky Harbor International Airport PUMA, Arizona/AZ",43,70,172,153,30,0,196,100,172,30,242,272,468,9,33,6,52,6,15,0,37,42,58,21,37
04,Arizona/AZ,0400119,"Phoenix City (South) PUMA, Arizona/AZ",38,0,338,84,0,0,122,0,338,0,338,338,460,8,18,0,73,0,0,0,73,27,73,0,73
04,Arizona/AZ,0400120,"Phoenix City--Ahwatukee & South Mountain PUMA, Arizona/AZ",110,0,2,0,0,0,110,0,2,0,2,2,112,98,0,0,2,0,0,0,2,98,2,0,2
04,Arizona/AZ,0400121,"Phoenix (Southwest) & Tolleson Cities PUMA, Arizona/AZ",108,146,328,166,0,15,274,146,343,15,474,489,763,14,22,2,62,0,19,2,43,36,64,19,45
04,Arizona/AZ,0400122,"Phoenix City--Maryvale (East) PUMA, Arizona/AZ",67,6,271,121,0,0,188,6,271,0,277,277,465,14,26,0,60,0,1,0,58,40,60,1,58
04,Arizona/AZ,0400123,"Phoenix City--Maryvale (West) PUMA, Arizona/AZ",80,155,648,394,0,0,474,155,648,0,803,803,1277,6,31,0,63,0,12,0,51,37,63,12,51
04,Arizona/AZ,0400124,"Maricopa County--Glendale City (South) PUMA, Arizona/AZ",130,102,136,119,42,59,249,144,195,101,238,339,588,22,20,17,40,7,17,10,23,42,58,24,33
04,Arizona/AZ,0400125,"Phoenix City (West) PUMA, Arizona/AZ",118,0,119,0,11,0,118,11,119,11,119,130,248,48,0,4,48,4,0,0,48,48,52,4,48
04,Arizona/AZ,0400126,"Maricopa County--Glendale City (North) PUMA, Arizona/AZ",80,44,22,23,58,0,103,102,22,58,66,124,227,35,10,26,29,26,19,0,10,45,55,45,10
04,Arizona/AZ,0400127,"Maricopa County--Peoria City (South & Central) PUMA, Arizona/AZ",109,0,76,30,14,59,139,14,135,73,76,149,288,38,10,25,26,5,0,20,26,48,52,5,47
04,Arizona/AZ,0400128,"Phoenix City (North) PUMA, Arizona/AZ",50,4,0,0,0,0,50,4,0,0,4,4,54,93,0,0,7,0,7,0,0,93,7,7,0
04,Arizona/AZ,0400129,"Phoenix (Far North) & Peoria (Northwest) Cities PUMA, Arizona/AZ",21,0,0,0,0,0,21,0,0,0,0,0,21,100,0,0,0,0,0,0,0,100,0,0,0
04,Arizona/AZ,0400130,"Maricopa County--El Mirage City & Sun City PUMA, Arizona/AZ",13,34,16,53,0,0,66,34,16,0,50,50,116,11,46,0,43,0,29,0,14,57,43,29,14
04,Arizona/AZ,0400131,"Maricopa County--Surprise City (Central) PUMA, Arizona/AZ",77,0,2,58,0,0,135,0,2,0,2,2,137,56,42,0,1,0,0,0,1,99,1,0,1
04,Arizona/AZ,0400132,"Maricopa County--Goodyear, Glendale (West) & Litchfield Park (Northwest) Cities PUMA, Arizona/AZ",102,9,41,16,0,0,118,9,41,0,50,50,168,61,10,0,30,0,5,0,24,70,30,5,24
04,Arizona/AZ,0400133,"Maricopa County--Avondale (Central) & Litchfield Park (Central) Cities PUMA, Arizona/AZ",49,80,386,201,28,0,250,108,386,28,466,494,744,7,27,4,63,4,11,0,52,34,66,15,52
04,Arizona/AZ,0400134,"Maricopa County (West) & Gila River Indian Community (Northwest) PUMA, Arizona/AZ",246,176,986,188,0,0,434,176,986,0,1162,1162,1596,15,12,0,73,0,11,0,62,27,73,11,62
04,Arizona/AZ,0400201,"Pima County (West) PUMA, Arizona/AZ",59,46,3,63,0,0,122,46,3,0,49,49,171,35,37,0,29,0,27,0,2,71,29,27,2
04,Arizona/AZ,0400202,"Tucson (West) & Marana Cities PUMA, Arizona/AZ",39,26,105,60,0,0,99,26,105,0,131,131,230,17,26,0,57,0,11,0,46,43,57,11,46
04,Arizona/AZ,0400203,"Pima County (North Central)--Oro Valley Town PUMA, Arizona/AZ",82,0,28,49,0,0,131,0,28,0,28,28,159,52,31,0,18,0,0,0,18,82,18,0,18
04,Arizona/AZ,0400204,"Pima County (Northeast) PUMA, Arizona/AZ",12,0,44,0,0,0,12,0,44,0,44,44,56,21,0,0,79,0,0,0,79,21,79,0,79
04,Arizona/AZ,0400205,"Pima County (Southeast)--Tucson City (Far Southeast) & Sahuarita Town PUMA, Arizona/AZ",72,40,0,0,0,0,72,40,0,0,40,40,112,64,0,0,36,0,36,0,0,64,36,36,0
04,Arizona/AZ,0400206,"Tucson City (Northeast) PUMA, Arizona/AZ",45,0,12,9,0,0,54,0,12,0,12,12,66,68,14,0,18,0,0,0,18,82,18,0,18
04,Arizona/AZ,0400207,"Tucson City (Northwest) PUMA, Arizona/AZ",11,0,22,17,0,0,28,0,22,0,22,22,50,22,34,0,44,0,0,0,44,56,44,0,44
04,Arizona/AZ,0400208,"Tucson City (South) PUMA, Arizona/AZ",12,34,62,57,0,0,69,34,62,0,96,96,165,7,35,0,58,0,21,0,38,42,58,21,38
04,Arizona/AZ,0400209,"Tucson City (Southeast) PUMA, Arizona/AZ",50,0,73,0,0,0,50,0,73,0,73,73,123,41,0,0,59,0,0,0,59,41,59,0,59
04,Arizona/AZ,0400300,"Navajo & Apache Counties PUMA, Arizona/AZ",159,0,62,34,0,0,193,0,62,0,62,62,255,62,13,0,24,0,0,0,24,76,24,0,24
04,Arizona/AZ,0400400,"Coconino County--Flagstaff City PUMA, Arizona/AZ",130,42,58,163,0,0,293,42,58,0,100,100,393,33,41,0,25,0,11,0,15,75,25,11,15
04,Arizona/AZ,0400500,"Yavapai County PUMA, Arizona/AZ",134,26,37,83,0,0,217,26,37,0,63,63,280,48,30,0,22,0,9,0,13,78,22,9,13
04,Arizona/AZ,0400600,"Mohave & La Paz Counties--Lake Havasu City PUMA, Arizona/AZ",178,54,234,154,0,40,332,54,274,40,288,328,660,27,23,6,44,0,8,6,35,50,50,8,42
04,Arizona/AZ,0400700,"Yuma County--Yuma City PUMA, Arizona/AZ",228,1366,4529,972,0,0,1200,1366,4529,0,5895,5895,7095,3,14,0,83,0,19,0,64,17,83,19,64
04,Arizona/AZ,0400800,"Gila, Graham, Greenlee & Pinal (East) Counties PUMA, Arizona/AZ",212,0,25,187,0,0,399,0,25,0,25,25,424,50,44,0,6,0,0,0,6,94,6,0,6
04,Arizona/AZ,0400803,"Pinal County (North)--Apache Junction City PUMA, Arizona/AZ",21,74,0,166,0,0,187,74,0,0,74,74,261,8,64,0,28,0,28,0,0,72,28,28,0
04,Arizona/AZ,0400805,"Pinal County (Central)--Florence Town, Eloy (Northeast) & Coolidge Cities PUMA, Arizona/AZ",228,0,333,127,0,0,355,0,333,0,333,333,688,33,18,0,48,0,0,0,48,52,48,0,48
04,Arizona/AZ,0400807,"Pinal County (West)--Maricopa, Casa Grande & Eloy (Southeast) Cities PUMA, Arizona/AZ",106,324,755,514,0,0,620,324,755,0,1079,1079,1699,6,30,0,64,0,19,0,44,36,64,19,44
04,Arizona/AZ,0400900,"Cochise & Santa Cruz Counties--Sierra Vista City PUMA, Arizona/AZ",191,163,191,331,34,4,522,197,195,38,354,392,914,21,36,4,39,4,18,0,21,57,43,22,21
05,Arkansas/AR,0500100,"Benton County PUMA, Arkansas/AR",1531,708,2338,521,27,582,2052,735,2920,609,3046,3655,5707,27,9,11,53,0,12,10,41,36,64,13,51
05,Arkansas/AR,0500200,"Washington County PUMA, Arkansas/AR",1934,851,1697,565,56,558,2499,907,2255,614,2548,3162,5661,34,10,11,45,1,15,10,30,44,56,16,40
05,Arkansas/AR,0500300,"Baxter, Boone, Carroll, Marion, Madison, Newton & Searcy Counties PUMA, Arkansas/AR",1688,62,398,351,3,44,2039,65,442,47,460,507,2546,66,14,2,18,0,2,2,16,80,20,3,17
05,Arkansas/AR,0500400,"Independence, Cleburne, Van Buren, Sharp, Izard, Stone & Fulton Counties PUMA, Arkansas/AR",1677,22,65,52,38,9,1729,60,74,47,87,134,1863,90,3,3,5,2,1,0,3,93,7,3,4
05,Arkansas/AR,0500500,"Craighead (West), Greene, Randolph, Lawrence & Clay Counties PUMA, Arkansas/AR",2238,0,158,77,0,0,2315,0,158,0,158,158,2473,90,3,0,6,0,0,0,6,94,6,0,6
05,Arkansas/AR,0500600,"Crittenden, Mississippi & Craighead (East) Counties PUMA, Arkansas/AR",1786,23,181,83,9,86,1869,32,267,95,204,299,2168,82,4,4,9,0,1,4,8,86,14,1,12
05,Arkansas/AR,0500700,"St. Francis, Poinsett, Phillips, Cross, Lee & Monroe Counties PUMA, Arkansas/AR",2703,6,25,11,0,35,2714,6,60,35,31,66,2780,97,0,1,1,0,0,1,1,98,2,0,2
05,Arkansas/AR,0500800,"White, Jackson, Prairie & Woodruff Counties PUMA, Arkansas/AR",1872,12,277,0,0,51,1872,12,328,51,289,340,2212,85,0,2,13,0,1,2,13,85,15,1,15
05,Arkansas/AR,0500900,"Pulaski County (Outer)--North Little Rock, Sherwood & Jacksonville Cities PUMA, Arkansas/AR",793,0,21,70,0,0,863,0,21,0,21,21,884,90,8,0,2,0,0,0,2,98,2,0,2
05,Arkansas/AR,0501000,"Pulaski County (Central)--Little Rock City PUMA, Arkansas/AR",628,134,204,0,0,0,628,134,204,0,338,338,966,65,0,0,35,0,14,0,21,65,35,14,21
05,Arkansas/AR,0501100,"Faulkner & Lonoke Counties PUMA, Arkansas/AR",830,7,33,156,0,0,986,7,33,0,40,40,1026,81,15,0,4,0,1,0,3,96,4,1,3
05,Arkansas/AR,0501200,"Saline County PUMA, Arkansas/AR",230,0,0,0,0,0,230,0,0,0,0,0,230,100,0,0,0,0,0,0,0,100,0,0,0
05,Arkansas/AR,0501300,"Pope, Johnson, Yell, Conway & Perry Counties PUMA, Arkansas/AR",2484,189,967,265,13,175,2749,202,1142,188,1156,1344,4093,61,6,5,28,0,5,4,24,67,33,5,28
05,Arkansas/AR,0501400,"Sebastian & Crawford Counties PUMA, Arkansas/AR",1908,471,1233,198,265,394,2106,736,1627,659,1704,2363,4469,43,4,15,38,6,11,9,28,47,53,16,36
05,Arkansas/AR,0501500,"Logan, Polk, Franklin, Sevier, Howard & Scott Counties PUMA, Arkansas/AR",2549,295,858,235,69,101,2784,364,959,170,1153,1323,4107,62,6,4,28,2,7,2,21,68,32,9,23
05,Arkansas/AR,0501600,"Garland, Hot Spring, Clark & Montgomery Counties PUMA, Arkansas/AR",314,0,60,15,0,70,329,0,130,70,60,130,459,68,3,15,13,0,0,15,13,72,28,0,28
05,Arkansas/AR,0501700,"Jefferson, Grant & Arkansas (Northwest) Counties PUMA, Arkansas/AR",1643,69,78,9,0,0,1652,69,78,0,147,147,1799,91,1,0,8,0,4,0,4,92,8,4,4
05,Arkansas/AR,0501800,"Southeast Arkansas PUMA, Arkansas/AR",1364,65,238,75,0,11,1439,65,249,11,303,314,1753,78,4,1,17,0,4,1,14,82,18,4,14
05,Arkansas/AR,0501900,"South Central Arkansas PUMA, Arkansas/AR",651,0,0,21,0,0,672,0,0,0,0,0,672,97,3,0,0,0,0,0,0,100,0,0,0
05,Arkansas/AR,0502000,"Southwest Arkansas PUMA, Arkansas/AR",2027,93,34,75,12,0,2102,105,34,12,127,139,2241,90,3,1,6,1,4,0,2,94,6,5,2
06,California/CA,0600101,"Alameda County (North)--Berkeley & Albany Cities PUMA, California/CA",58,33,19,65,0,0,123,33,19,0,52,52,175,33,37,0,30,0,19,0,11,70,30,19,11
06,California/CA,0600102,"Alameda County (Northwest)--Oakland (Northwest) & Emeryville Cities PUMA, California/CA",221,30,287,105,97,147,326,127,434,244,317,561,887,25,12,28,36,11,3,17,32,37,63,14,49
06,California/CA,0600103,"Alameda County (Northeast)--Oakland (East) & Piedmont Cities PUMA, California/CA",84,13,34,12,11,0,96,24,34,11,47,58,154,55,8,7,31,7,8,0,22,62,38,16,22
06,California/CA,0600104,"Alameda County (North Central)--Oakland City (South Central) PUMA, California/CA",288,99,646,255,57,92,543,156,738,149,745,894,1437,20,18,10,52,4,7,6,45,38,62,11,51
06,California/CA,0600105,"Alameda County (West)--San Leandro, Alameda & Oakland (Southwest) Cities PUMA, California/CA",49,30,103,19,59,103,68,89,206,162,133,295,363,13,5,45,37,16,8,28,28,19,81,25,57
06,California/CA,0600106,"Alameda County (North Central)--Castro Valley, San Lorenzo & Ashland PUMA, California/CA",120,125,135,228,43,0,348,168,135,43,260,303,651,18,35,7,40,7,19,0,21,53,47,26,21
06,California/CA,0600107,"Alameda County (Central)--Hayward City PUMA, California/CA",88,72,402,256,69,23,344,141,425,92,474,566,910,10,28,10,52,8,8,3,44,38,62,15,47
06,California/CA,0600108,"Alameda County (Southwest)--Union City, Newark & Fremont (West) Cities PUMA, California/CA",147,76,58,155,18,49,302,94,107,67,134,201,503,29,31,13,27,4,15,10,12,60,40,19,21
06,California/CA,0600109,"Alameda County (South Central)--Fremont City (East) PUMA, California/CA",50,0,44,35,47,0,85,47,44,47,44,91,176,28,20,27,25,27,0,0,25,48,52,27,25
06,California/CA,0600110,"Alameda County (East)--Livermore, Pleasanton & Dublin Cities PUMA, California/CA",43,19,3,14,0,0,57,19,3,0,22,22,79,54,18,0,28,0,24,0,4,72,28,24,4
06,California/CA,0600300,"Alpine, Amador, Calaveras, Inyo, Mariposa, Mono & Tuolumne Counties PUMA, California/CA",324,57,237,78,0,4,402,57,241,4,294,298,700,46,11,1,42,0,8,1,34,57,43,8,34
06,California/CA,0600701,"Butte County (Northwest)--Chico City PUMA, California/CA",395,35,237,221,9,0,616,44,237,9,272,281,897,44,25,1,30,1,4,0,26,69,31,5,26
06,California/CA,0600702,"Butte County (Southeast)--Oroville City & Paradise Town PUMA, California/CA",479,135,612,331,29,27,810,164,639,56,747,803,1613,30,21,3,46,2,8,2,38,50,50,10,40
06,California/CA,0601100,"Colusa, Glenn, Tehama & Trinity Counties PUMA, California/CA",839,821,2971,680,13,0,1519,834,2971,13,3792,3805,5324,16,13,0,71,0,15,0,56,29,71,16,56
06,California/CA,0601301,"Contra Costa County (Far Southwest)--Richmond (Southwest) & San Pablo Cities PUMA, California/CA",44,90,452,102,69,0,146,159,452,69,542,611,757,6,13,9,72,9,12,0,60,19,81,21,60
06,California/CA,0601302,"Contra Costa County (Far Northwest)--Richmond (North), Hercules & El Cerrito Cites PUMA, California/CA",190,54,77,53,22,29,243,76,106,51,131,182,425,45,12,12,31,5,13,7,18,57,43,18,25
06,California/CA,0601303,"Contra Costa County (Northwest)--Concord (West), Martinez & Pleasant Hill Cities PUMA, California/CA",0,0,159,123,41,17,123,41,176,58,159,217,340,0,36,17,47,12,0,5,47,36,64,12,52
06,California/CA,0601304,"Contra Costa County--Walnut Creek (West), Lafayette, Orinda Cities & Moraga Town PUMA, California/CA",0,0,17,59,0,0,59,0,17,0,17,17,76,0,78,0,22,0,0,0,22,78,22,0,22
06,California/CA,0601305,"Contra Costa County (South)--San Ramon City & Danville Town PUMA, California/CA",2,0,16,0,0,14,2,0,30,14,16,30,32,6,0,44,50,0,0,44,50,6,94,0,94
06,California/CA,0601306,"Contra Costa County (Central)--Concord (South), Walnut Creek (East) & Clayton Cities PUMA, California/CA",71,36,107,23,0,0,94,36,107,0,143,143,237,30,10,0,60,0,15,0,45,40,60,15,45
06,California/CA,0601307,"Contra Costa County (North Central)--Pittsburg & Concord (North & East) Cities PUMA, California/CA",0,101,78,67,0,0,67,101,78,0,179,179,246,0,27,0,73,0,41,0,32,27,73,41,32
06,California/CA,0601308,"Contra Costa County (Northeast)--Antioch City PUMA, California/CA",0,0,140,74,0,0,74,0,140,0,140,140,214,0,35,0,65,0,0,0,65,35,65,0,65
06,California/CA,0601309,"Contra Costa County (East)--Brentwood & Oakley Cities PUMA, California/CA",23,37,51,37,0,0,60,37,51,0,88,88,148,16,25,0,59,0,25,0,34,41,59,25,34
06,California/CA,0601500,"Del Norte, Lassen, Modoc, Plumas & Siskiyou Counties PUMA, California/CA",801,107,291,307,19,15,1108,126,306,34,398,432,1540,52,20,2,26,1,7,1,19,72,28,8,20
06,California/CA,0601700,"El Dorado County--El Dorado Hills PUMA, California/CA",245,0,85,10,0,0,255,0,85,0,85,85,340,72,3,0,25,0,0,0,25,75,25,0,25
06,California/CA,0601901,"Fresno County (West)--Selma, Kerman & Coalinga Cities PUMA, California/CA",376,1412,10924,2137,69,127,2513,1481,11051,196,12336,12532,15045,2,14,1,82,0,9,1,73,17,83,10,73
06,California/CA,0601902,"Fresno County (North Central)--Fresno City (North) PUMA, California/CA",477,238,305,224,182,11,701,420,316,193,543,736,1437,33,16,13,38,13,17,1,21,49,51,29,22
06,California/CA,0601903,"Fresno County (Central)--Fresno City (East Central) PUMA, California/CA",235,94,758,441,78,54,676,172,812,132,852,984,1660,14,27,8,51,5,6,3,46,41,59,10,49
06,California/CA,0601904,"Fresno County (Central)--Fresno City (Southwest) PUMA, California/CA",299,648,2570,1307,162,228,1606,810,2798,390,3218,3608,5214,6,25,7,62,3,12,4,49,31,69,16,54
06,California/CA,0601905,"Fresno County (Central)--Fresno City (Southeast) PUMA, California/CA",116,549,3690,782,157,254,898,706,3944,411,4239,4650,5548,2,14,7,76,3,10,5,67,16,84,13,71
06,California/CA,0601906,"Fresno County (Central)--Clovis City PUMA, California/CA",156,121,303,172,56,45,328,177,348,101,424,525,853,18,20,12,50,7,14,5,36,38,62,21,41
06,California/CA,0601907,"Fresno County (East)--Sanger, Reedley & Parlier Cities PUMA, California/CA",205,927,6805,1469,61,0,1674,988,6805,61,7732,7793,9467,2,16,1,82,1,10,0,72,18,82,10,72
06,California/CA,0602300,"Humboldt County PUMA, California/CA",508,30,618,14,0,77,522,30,695,77,648,725,1247,41,1,6,52,0,2,6,50,42,58,2,56
06,California/CA,0602500,"Imperial County--El Centro City PUMA, California/CA",179,962,2120,1221,24,0,1400,986,2120,24,3082,3106,4506,4,27,1,68,1,21,0,47,31,69,22,47
06,California/CA,0602901,"Kern County (West)--Delano, Wasco & Shafter Cities PUMA, California/CA",348,1534,10405,2786,235,244,3134,1769,10649,479,11939,12418,15552,2,18,3,77,2,10,2,67,20,80,11,68
06,California/CA,0602902,"Kern County (Central)--Bakersfield City (West) PUMA, California/CA",531,493,836,1029,259,251,1560,752,1087,510,1329,1839,3399,16,30,15,39,8,15,7,25,46,54,22,32
06,California/CA,0602903,"Kern County (Central)--Bakersfield City (Northeast) PUMA, California/CA",218,763,4359,1783,0,12,2001,763,4371,12,5122,5134,7135,3,25,0,72,0,11,0,61,28,72,11,61
06,California/CA,0602904,"Kern County (Central)--Bakersfield City (Southeast) PUMA, California/CA",193,614,5760,1236,5,0,1429,619,5760,5,6374,6379,7808,2,16,0,82,0,8,0,74,18,82,8,74
06,California/CA,0602905,"Kern County (East)--Ridgecrest, Arvin, Tehachapi & California City Cities PUMA, California/CA",361,399,3108,1077,0,0,1438,399,3108,0,3507,3507,4945,7,22,0,71,0,8,0,63,29,71,8,63
06,California/CA,0603100,"Kings County--Hanford City PUMA, California/CA",963,822,4837,1575,24,29,2538,846,4866,53,5659,5712,8250,12,19,1,69,0,10,0,59,31,69,10,59
06,California/CA,0603300,"Lake & Mendocino Counties PUMA, California/CA",269,315,1428,448,21,33,717,336,1461,54,1743,1797,2514,11,18,2,69,1,13,1,57,29,71,13,58
06,California/CA,0603701,"Los Angeles County (North/Unincorporated)--Castaic PUMA, California/CA",88,26,133,128,0,0,216,26,133,0,159,159,375,23,34,0,42,0,7,0,35,58,42,7,35
06,California/CA,0603702,"Los Angeles County (Northwest)--Santa Clarita City PUMA, California/CA",0,71,0,62,9,0,62,80,0,9,71,80,142,0,44,6,50,6,50,0,0,44,56,56,0
06,California/CA,0603703,"Los Angeles County (North Central)--Lancaster City PUMA, California/CA",91,46,88,161,17,0,252,63,88,17,134,151,403,23,40,4,33,4,11,0,22,63,37,16,22
06,California/CA,0603704,"Los Angeles County (North Central)--Palmdale City PUMA, California/CA",80,93,288,180,0,0,260,93,288,0,381,381,641,12,28,0,59,0,15,0,45,41,59,15,45
06,California/CA,0603705,"Los Angeles County (North)--LA City (Northwest/Chatsworth & Porter Ranch) PUMA, California/CA",46,76,40,59,13,0,105,89,40,13,116,129,234,20,25,6,50,6,32,0,17,45,55,38,17
06,California/CA,0603706,"Los Angeles County (North)--LA City (North Central/Granada Hills & Sylmar) PUMA, California/CA",33,137,187,304,16,0,337,153,187,16,324,340,677,5,45,2,48,2,20,0,28,50,50,23,28
06,California/CA,0603707,"Los Angeles County--LA (North Central/Arleta & Pacoima) & San Fernando Cities PUMA, California/CA",14,373,399,519,0,0,533,373,399,0,772,772,1305,1,40,0,59,0,29,0,31,41,59,29,31
06,California/CA,0603708,"Los Angeles County (North)--LA City (Northeast/Sunland, Sun Valley & Tujunga) PUMA, California/CA",72,76,179,40,39,13,112,115,192,52,255,307,419,17,10,12,61,9,18,3,43,27,73,27,46
06,California/CA,0603709,"Los Angeles County (Central)--San Gabriel Valley Region (North) PUMA, California/CA",37,28,0,49,23,0,86,51,0,23,28,51,137,27,36,17,20,17,20,0,0,63,37,37,0
06,California/CA,0603710,"Los Angeles County--Baldwin Park, Azusa, Duarte & Irwindale Cities PUMA, California/CA",68,282,531,328,12,61,396,294,592,73,813,886,1282,5,26,6,63,1,22,5,41,31,69,23,46
06,California/CA,0603711,"Los Angeles County (East Central)--Glendora, Claremont, San Dimas & La Verne Cities PUMA, California/CA",99,103,6,146,25,0,245,128,6,25,109,134,379,26,39,7,29,7,27,0,2,65,35,34,2
06,California/CA,0603712,"Los Angeles County (East Central)--Pomona City PUMA, California/CA",17,174,497,400,0,12,417,174,509,12,671,683,1100,2,36,1,61,0,16,1,45,38,62,16,46
06,California/CA,0603713,"Los Angeles County (East Central)--Covina & Walnut Cities PUMA, California/CA",89,74,134,132,0,0,221,74,134,0,208,208,429,21,31,0,48,0,17,0,31,52,48,17,31
06,California/CA,0603714,"Los Angeles County--Diamond Bar, La Habra Heights (East) Cities & Rowland Heights PUMA, California/CA",25,31,0,52,48,50,77,79,50,98,31,129,206,12,25,48,15,23,15,24,0,37,63,38,24
06,California/CA,0603715,"Los Angeles County (East Central)--West Covina City PUMA, California/CA",22,254,241,281,8,5,303,262,246,13,495,508,811,3,35,2,61,1,31,1,30,37,63,32,30
06,California/CA,0603716,"Los Angeles County (East Central)--La Puente & Industry Cities PUMA, California/CA",53,285,576,176,24,0,229,309,576,24,861,885,1114,5,16,2,77,2,26,0,52,21,79,28,52
06,California/CA,0603717,"Los Angeles County (East Central)--Arcadia, San Gabriel & Temple City Cities PUMA, California/CA",17,48,166,84,55,135,101,103,301,190,214,404,505,3,17,38,42,11,10,27,33,20,80,20,60
06,California/CA,0603718,"Los Angeles County (Central)--Pasadena City PUMA, California/CA",22,51,65,0,38,0,22,89,65,38,116,154,176,12,0,22,66,22,29,0,37,12,88,51,37
06,California/CA,0603719,"Los Angeles County (Central)--Glendale City PUMA, California/CA",0,27,117,64,85,117,64,112,234,202,144,346,410,0,16,49,35,21,7,29,29,16,84,27,57
06,California/CA,0603720,"Los Angeles County (Central)--Burbank City PUMA, California/CA",0,13,119,11,0,23,11,13,142,23,132,155,166,0,7,14,80,0,8,14,72,7,93,8,86
06,California/CA,0603721,"Los Angeles County (North)--LA City (Northeast/North Hollywood & Valley Village) PUMA, California/CA",0,44,113,113,43,0,113,87,113,43,157,200,313,0,36,14,50,14,14,0,36,36,64,28,36
06,California/CA,0603722,"Los Angeles County (Northwest)--LA City (North Central/Van Nuys & North Sherman Oaks) PUMA, California/CA",28,136,366,53,0,17,81,136,383,17,502,519,600,5,9,3,84,0,23,3,61,14,86,23,64
06,California/CA,0603723,"Los Angeles County (North)--LA City (North Central/Mission Hills & Panorama City) PUMA, California/CA",0,166,465,172,7,0,172,173,465,7,631,638,810,0,21,1,78,1,20,0,57,21,79,21,57
06,California/CA,0603724,"Los Angeles County (Northwest)--LA City (Northwest/Encino & Tarzana) PUMA, California/CA",13,72,145,251,0,20,264,72,165,20,217,237,501,3,50,4,43,0,14,4,29,53,47,14,33
06,California/CA,0603725,"Los Angeles County--LA City (Northwest/Canoga Park, Winnetka & Woodland Hills) PUMA, California/CA",0,46,229,242,0,0,242,46,229,0,275,275,517,0,47,0,53,0,9,0,44,47,53,9,44
06,California/CA,0603726,"Los Angeles County--Calabasas, Agoura Hills, Malibu & Westlake Village Cities PUMA, California/CA",30,15,26,0,52,0,30,67,26,52,41,93,123,24,0,42,33,42,12,0,21,24,76,54,21
06,California/CA,0603727,"Los Angeles County (Central)--LA City (Central/Pacific Palisades) PUMA, California/CA",33,0,0,0,0,0,33,0,0,0,0,0,33,100,0,0,0,0,0,0,0,100,0,0,0
06,California/CA,0603728,"Los Angeles County (Southwest)--Santa Monica City PUMA, California/CA",0,0,0,16,0,0,16,0,0,0,0,0,16,0,100,0,0,0,0,0,0,100,0,0,0
06,California/CA,0603729,"Los Angeles County (West Central)--LA City (West Central/Westwood & West Los Angeles) PUMA, California/CA",88,0,26,0,0,0,88,0,26,0,26,26,114,77,0,0,23,0,0,0,23,77,23,0,23
06,California/CA,0603730,"Los Angeles County (West Central)--LA City (Central/Hancock Park & Mid-Wilshire) PUMA, California/CA",51,23,66,21,7,39,72,30,105,46,89,135,207,25,10,22,43,3,11,19,32,35,65,14,51
06,California/CA,0603731,"Los Angeles County (Central)--West Hollywood & Beverly Hills Cities PUMA, California/CA",0,0,0,35,0,0,35,0,0,0,0,0,35,0,100,0,0,0,0,0,0,100,0,0,0
06,California/CA,0603732,"Los Angeles County (Central)--LA City (East Central/Hollywood) PUMA, California/CA",0,70,223,105,0,0,105,70,223,0,293,293,398,0,26,0,74,0,18,0,56,26,74,18,56
06,California/CA,0603733,"Los Angeles County (Central)--LA City (Central/Koreatown) PUMA, California/CA",23,20,324,34,0,18,57,20,342,18,344,362,419,5,8,4,82,0,5,4,77,14,86,5,82
06,California/CA,0603734,"Los Angeles County--LA City (East Central/Silver Lake, Echo Park & Westlake) PUMA, California/CA",0,95,432,90,13,32,90,108,464,45,527,572,662,0,14,7,80,2,14,5,65,14,86,16,70
06,California/CA,0603735,"Los Angeles County--LA City (Mount Washington, Highland Park & Glassell Park) PUMA, California/CA",28,174,306,78,13,15,106,187,321,28,480,508,614,5,13,5,78,2,28,2,50,17,83,30,52
06,California/CA,0603736,"Los Angeles County (Central)--Alhambra & South Pasadena Cities PUMA, California/CA",13,54,145,112,31,40,125,85,185,71,199,270,395,3,28,18,50,8,14,10,37,32,68,22,47
06,California/CA,0603737,"Los Angeles County (Central)--Monterey Park & Rosemead Cities PUMA, California/CA",34,11,143,98,160,54,132,171,197,214,154,368,500,7,20,43,31,32,2,11,29,26,74,34,39
06,California/CA,0603738,"Los Angeles County (Central)--El Monte & South El Monte Cities PUMA, California/CA",37,89,417,253,35,45,290,124,462,80,506,586,876,4,29,9,58,4,10,5,48,33,67,14,53
06,California/CA,0603739,"Los Angeles County (Southeast)--Whittier City & Hacienda Heights PUMA, California/CA",53,80,179,236,16,59,289,96,238,75,259,334,623,9,38,12,42,3,13,9,29,46,54,15,38
06,California/CA,0603740,"Los Angeles County (Central)--Pico Rivera & Montebello Cities PUMA, California/CA",0,160,195,254,0,59,254,160,254,59,355,414,668,0,38,9,53,0,24,9,29,38,62,24,38
06,California/CA,0603741,"Los Angeles County (Central)--Bell Gardens, Bell, Maywood, Cudahy & Commerce Cities PUMA, California/CA",0,259,1079,152,0,0,152,259,1079,0,1338,1338,1490,0,10,0,90,0,17,0,72,10,90,17,72
06,California/CA,0603742,"Los Angeles County (Central)--Huntington Park City, Florence-Graham & Walnut Park PUMA, California/CA",11,352,1044,354,0,0,365,352,1044,0,1396,1396,1761,1,20,0,79,0,20,0,59,21,79,20,59
06,California/CA,0603743,"Los Angeles County (Central)--East Los Angeles PUMA, California/CA",0,167,712,204,0,0,204,167,712,0,879,879,1083,0,19,0,81,0,15,0,66,19,81,15,66
06,California/CA,0603744,"Los Angeles County (Central)--LA City (East Central/Central City & Boyle Heights) PUMA, California/CA",0,81,1084,211,33,40,211,114,1124,73,1165,1238,1449,0,15,5,80,2,6,3,75,15,85,8,78
06,California/CA,0603745,"Los Angeles County (Central)--LA City (Southeast/East Vernon) PUMA, California/CA",0,76,815,97,0,0,97,76,815,0,891,891,988,0,10,0,90,0,8,0,82,10,90,8,82
06,California/CA,0603746,"Los Angeles County--LA City (Central/Univ. of Southern California & Exposition Park) PUMA, California/CA",54,76,207,77,0,27,131,76,234,27,283,310,441,12,17,6,64,0,17,6,47,30,70,17,53
06,California/CA,0603747,"Los Angeles County (Central)--LA City (Central/West Adams & Baldwin Hills) PUMA, California/CA",80,151,157,7,21,0,87,172,157,21,308,329,416,19,2,5,74,5,36,0,38,21,79,41,38
06,California/CA,0603748,"Los Angeles County--LA (Southwest/Marina del Rey & Westchester) & Culver City Cities PUMA, California/CA",62,0,23,0,0,10,62,0,33,10,23,33,95,65,0,11,24,0,0,11,24,65,35,0,35
06,California/CA,0603749,"Los Angeles County (Central)--Inglewood City PUMA, California/CA",73,39,83,152,0,0,225,39,83,0,122,122,347,21,44,0,35,0,11,0,24,65,35,11,24
06,California/CA,0603750,"Los Angeles County (South Central)--LA City (South Central/Westmont) PUMA, California/CA",140,267,395,229,13,0,369,280,395,13,662,675,1044,13,22,1,63,1,26,0,38,35,65,27,38
06,California/CA,0603751,"Los Angeles County (South Central)--LA City (South Central/Watts) PUMA, California/CA",52,229,576,240,0,0,292,229,576,0,805,805,1097,5,22,0,73,0,21,0,53,27,73,21,53
06,California/CA,0603752,"Los Angeles County (South)--South Gate & Lynwood Cities PUMA, California/CA",16,251,582,191,0,0,207,251,582,0,833,833,1040,2,18,0,80,0,24,0,56,20,80,24,56
06,California/CA,0603753,"Los Angeles County (South)--Downey City PUMA, California/CA",62,68,78,166,0,0,228,68,78,0,146,146,374,17,44,0,39,0,18,0,21,61,39,18,21
06,California/CA,0603754,"Los Angeles County (Southeast)--La Mirada & Santa Fe Springs Cities PUMA, California/CA",62,28,43,275,0,9,337,28,52,9,71,80,417,15,66,2,17,0,7,2,10,81,19,7,12
06,California/CA,0603755,"Los Angeles County (Southeast)--Norwalk City PUMA, California/CA",45,211,228,120,29,36,165,240,264,65,439,504,669,7,18,10,66,4,32,5,34,25,75,36,39
06,California/CA,0603756,"Los Angeles County (Southeast)--Bellflower & Paramount Cities PUMA, California/CA",34,13,236,158,0,13,192,13,249,13,249,262,454,7,35,3,55,0,3,3,52,42,58,3,55
06,California/CA,0603757,"Los Angeles County (South Central)--Compton City & West Rancho Dominguez PUMA, California/CA",41,184,661,145,0,0,186,184,661,0,845,845,1031,4,14,0,82,0,18,0,64,18,82,18,64
06,California/CA,0603758,"Los Angeles County (South Central)--Gardena, Lawndale Cities & West Athens PUMA, California/CA",54,47,303,109,60,0,163,107,303,60,350,410,573,9,19,10,61,10,8,0,53,28,72,19,53
06,California/CA,0603759,"Los Angeles County (South Central)--Hawthorne City PUMA, California/CA",29,77,259,47,0,0,76,77,259,0,336,336,412,7,11,0,82,0,19,0,63,18,82,19,63
06,California/CA,0603760,"Los Angeles County--Redondo Beach, Manhattan Beach & Hermosa Beach Cities PUMA, California/CA",25,0,0,124,0,0,149,0,0,0,0,0,149,17,83,0,0,0,0,0,0,100,0,0,0
06,California/CA,0603761,"Los Angeles County (South Central)--Torrance City PUMA, California/CA",12,0,0,0,12,0,12,12,0,12,0,12,24,50,0,50,0,50,0,0,0,50,50,50,0
06,California/CA,0603762,"Los Angeles County (South Central)--Carson City PUMA, California/CA",45,8,113,153,21,53,198,29,166,74,121,195,393,11,39,19,31,5,2,13,29,50,50,7,42
06,California/CA,0603763,"Los Angeles County (South Central)--Long Beach City (North) PUMA, California/CA",12,53,466,99,14,0,111,67,466,14,519,533,644,2,15,2,81,2,8,0,72,17,83,10,72
06,California/CA,0603764,"Los Angeles County (South)--Lakewood, Cerritos, Artesia & Hawaiian Gardens Cities PUMA, California/CA",101,0,142,78,11,0,179,11,142,11,142,153,332,30,23,3,43,3,0,0,43,54,46,3,43
06,California/CA,0603765,"Los Angeles County (Southeast)--Long Beach City (East) PUMA, California/CA",38,12,0,150,0,0,188,12,0,0,12,12,200,19,75,0,6,0,6,0,0,94,6,6,0
06,California/CA,0603766,"Los Angeles County (South)--Long Beach City (Southwest & Port) PUMA, California/CA",72,40,281,77,15,0,149,55,281,15,321,336,485,15,16,3,66,3,8,0,58,31,69,11,58
06,California/CA,0603767,"Los Angeles County (South)--LA City (South/San Pedro) PUMA, California/CA",14,118,159,121,0,0,135,118,159,0,277,277,412,3,29,0,67,0,29,0,39,33,67,29,39
06,California/CA,0603768,"Los Angeles County (Southwest)--Palos Verdes Peninsula PUMA, California/CA",67,0,47,0,0,0,67,0,47,0,47,47,114,59,0,0,41,0,0,0,41,59,41,0,41
06,California/CA,0603769,"Los Angeles County (Southeast)--Long Beach (Central) & Signal Hill Cities PUMA, California/CA",0,27,0,21,26,0,21,53,0,26,27,53,74,0,28,35,36,35,36,0,0,28,72,72,0
06,California/CA,0603900,"Madera County--Madera City PUMA, California/CA",245,715,6180,1369,0,82,1614,715,6262,82,6895,6977,8591,3,16,1,80,0,8,1,72,19,81,8,73
06,California/CA,0604101,"Marin County (North & West)--Novato & San Rafael (North) Cities PUMA, California/CA",227,40,12,0,13,0,227,53,12,13,52,65,292,78,0,4,18,4,14,0,4,78,22,18,4
06,California/CA,0604102,"Marin County (Southeast)--San Rafael (South), Mill Valley & Sausalito Cities PUMA, California/CA",110,41,57,32,0,0,142,41,57,0,98,98,240,46,13,0,41,0,17,0,24,59,41,17,24
06,California/CA,0604701,"Merced County (West & South)--Los Banos & Livingston Cities PUMA, California/CA",705,1102,4436,929,361,229,1634,1463,4665,590,5538,6128,7762,9,12,8,71,5,14,3,57,21,79,19,60
06,California/CA,0604702,"Merced County (Northeast)--Merced & Atwater Cities PUMA, California/CA",442,1004,5045,871,165,90,1313,1169,5135,255,6049,6304,7617,6,11,3,79,2,13,1,66,17,83,15,67
06,California/CA,0605301,"Monterey County (North Central)--Seaside, Monterey, Marina & Pacific Grove Cities PUMA, California/CA",144,122,2533,422,0,223,566,122,2756,223,2655,2878,3444,4,12,6,77,0,4,6,74,16,84,4,80
06,California/CA,0605302,"Monterey County (Northeast)--Salinas City PUMA, California/CA",200,627,13760,1283,61,24,1483,688,13784,85,14387,14472,15955,1,8,1,90,0,4,0,86,9,91,4,86
06,California/CA,0605303,"Monterey (South & East) & San Benito Counties PUMA, California/CA",274,958,9052,1536,3,47,1810,961,9099,50,10010,10060,11870,2,13,0,84,0,8,0,76,15,85,8,77
06,California/CA,0605500,"Napa County--Napa City PUMA, California/CA",236,288,2161,192,76,36,428,364,2197,112,2449,2561,2989,8,6,4,82,3,10,1,72,14,86,12,74
06,California/CA,0605700,"Nevada & Sierra Counties PUMA, California/CA",122,75,2,0,0,0,122,75,2,0,77,77,199,61,0,0,39,0,38,0,1,61,39,38,1
06,California/CA,0605901,"Orange County (Southwest)--San Clemente, Laguna Niguel & San Juan Capistrano Cities PUMA, California/CA",70,0,41,40,0,0,110,0,41,0,41,41,151,46,26,0,27,0,0,0,27,73,27,0,27
06,California/CA,0605902,"Orange County (South Central)--Mission Viejo & Rancho Santa Margarita (West) Cities PUMA, California/CA",0,15,12,52,0,0,52,15,12,0,27,27,79,0,66,0,34,0,19,0,15,66,34,19,15
06,California/CA,0605903,"Orange County (West Central)--Newport Beach, Aliso Viejo & Laguna Hills Cities PUMA, California/CA",28,28,83,31,0,0,59,28,83,0,111,111,170,16,18,0,65,0,16,0,49,35,65,16,49
06,California/CA,0605904,"Orange County (Central)--Irvine City (Central) PUMA, California/CA",106,0,227,82,0,60,188,0,287,60,227,287,475,22,17,13,48,0,0,13,48,40,60,0,60
06,California/CA,0605905,"Orange County (Northeast)--Lake Forest, Irvine (North) Cities & Silverado PUMA, California/CA",68,30,461,140,0,20,208,30,481,20,491,511,719,9,19,3,68,0,4,3,64,29,71,4,67
06,California/CA,0605906,"Orange County (North)--Yorba Linda, La Habra & Brea Cities PUMA, California/CA",25,85,369,70,18,0,95,103,369,18,454,472,567,4,12,3,80,3,15,0,65,17,83,18,65
06,California/CA,0605907,"Orange County (North Central)--Fullerton & Placentia Cities PUMA, California/CA",15,77,365,141,30,0,156,107,365,30,442,472,628,2,22,5,70,5,12,0,58,25,75,17,58
06,California/CA,0605908,"Orange County (Northwest)--Buena Park, Cypress & Seal Beach Cities PUMA, California/CA",62,87,97,120,0,0,182,87,97,0,184,184,366,17,33,0,50,0,24,0,27,50,50,24,27
06,California/CA,0605909,"Orange County (North Central)--Anaheim City (West) PUMA, California/CA",12,117,297,111,99,86,123,216,383,185,414,599,722,2,15,26,57,14,16,12,41,17,83,30,53
06,California/CA,0605910,"Orange County (North Central)--Anaheim City (East) PUMA, California/CA",36,95,262,146,0,24,182,95,286,24,357,381,563,6,26,4,63,0,17,4,47,32,68,17,51
06,California/CA,0605911,"Orange County (Central)--Orange & Villa Park Cities PUMA, California/CA",0,20,227,12,0,0,12,20,227,0,247,247,259,0,5,0,95,0,8,0,88,5,95,8,88
06,California/CA,0605912,"Orange County (Northwest)--Westminster, Stanton & Garden Grove (West) Cities PUMA, California/CA",67,16,393,167,117,0,234,133,393,117,409,526,760,9,22,15,54,15,2,0,52,31,69,18,52
06,California/CA,0605913,"Orange County (Northwest)--Garden Grove City (East) PUMA, California/CA",0,120,209,230,72,86,230,192,295,158,329,487,717,0,32,22,46,10,17,12,29,32,68,27,41
06,California/CA,0605914,"Orange County (Northwest)--Huntington Beach City PUMA, California/CA",149,20,372,158,0,22,307,20,394,22,392,414,721,21,22,3,54,0,3,3,52,43,57,3,55
06,California/CA,0605915,"Orange County (Southeast)--Rancho Santa Margarita City (East) & Ladera Ranch PUMA, California/CA",31,0,48,0,27,0,31,27,48,27,48,75,106,29,0,25,45,25,0,0,45,29,71,25,45
06,California/CA,0605916,"Orange County (Central)--Santa Ana City (West) PUMA, California/CA",12,146,978,162,0,0,174,146,978,0,1124,1124,1298,1,12,0,87,0,11,0,75,13,87,11,75
06,California/CA,0605917,"Orange County (Central)--Santa Ana City (East) PUMA, California/CA",20,191,952,225,0,0,245,191,952,0,1143,1143,1388,1,16,0,82,0,14,0,69,18,82,14,69
06,California/CA,0605918,"Orange County (Central)--Costa Mesa & Fountain Valley Cities PUMA, California/CA",36,87,107,144,41,42,180,128,149,83,194,277,457,8,32,18,42,9,19,9,23,39,61,28,33
06,California/CA,0606101,"Placer County (Southwest)--Roseville City PUMA, California/CA",68,58,25,78,0,0,146,58,25,0,83,83,229,30,34,0,36,0,25,0,11,64,36,25,11
06,California/CA,0606102,"Placer County (Central)--Rocklin, Lincoln Cities & Loomis Town PUMA, California/CA",227,0,11,37,27,0,264,27,11,27,11,38,302,75,12,9,4,9,0,0,4,87,13,9,4
06,California/CA,0606103,"Placer County (East/High Country Region)--Auburn & Colfax Cities PUMA, California/CA",18,0,58,0,0,0,18,0,58,0,58,58,76,24,0,0,76,0,0,0,76,24,76,0,76
06,California/CA,0606501,"Riverside County (East)--Indio, Coachella, Blythe & La Quinta (East) Cities PUMA, California/CA",46,750,5073,634,0,35,680,750,5108,35,5823,5858,6538,1,10,1,89,0,11,1,78,10,90,11,78
06,California/CA,0606502,"Riverside County (Central)--Cathedral City, Palm Springs & Rancho Mirage Cities PUMA, California/CA",56,82,193,128,18,0,184,100,193,18,275,293,477,12,27,4,58,4,17,0,40,39,61,21,40
06,California/CA,0606503,"Riverside County (Southwest)--Temecula City PUMA, California/CA",11,16,66,20,0,0,31,16,66,0,82,82,113,10,18,0,73,0,14,0,58,27,73,14,58
06,California/CA,0606504,"Riverside County (Southwest)--Murrieta & Wildomar Cities PUMA, California/CA",91,53,11,79,26,0,170,79,11,26,64,90,260,35,30,10,25,10,20,0,4,65,35,30,4
06,California/CA,0606505,"Riverside County (Southwest)--Menifee, Lake Elsinore & Canyon Lake Cities PUMA, California/CA",47,49,81,157,0,0,204,49,81,0,130,130,334,14,47,0,39,0,15,0,24,61,39,15,24
06,California/CA,0606506,"Riverside County (Southwest)--Hemet City & East Hemet PUMA, California/CA",86,80,232,156,0,0,242,80,232,0,312,312,554,16,28,0,56,0,14,0,42,44,56,14,42
06,California/CA,0606507,"Riverside County (North Central)--San Jacinto, Beaumont, Banning & Calimesa Cities PUMA, California/CA",71,168,295,131,18,0,202,186,295,18,463,481,683,10,19,3,68,3,25,0,43,30,70,27,43
06,California/CA,0606508,"Riverside County (Northwest)--Moreno Valley City PUMA, California/CA",76,69,242,179,0,0,255,69,242,0,311,311,566,13,32,0,55,0,12,0,43,45,55,12,43
06,California/CA,0606509,"Riverside County (West Central)--Perris City, Temescal Valley & Mead Valley PUMA, California/CA",16,55,84,205,0,0,221,55,84,0,139,139,360,4,57,0,39,0,15,0,23,61,39,15,23
06,California/CA,0606510,"Riverside County (Northwest)--Riverside City (East) PUMA, California/CA",27,66,160,164,35,0,191,101,160,35,226,261,452,6,36,8,50,8,15,0,35,42,58,22,35
06,California/CA,0606511,"Riverside County (Northwest)--Riverside City (West) PUMA, California/CA",40,351,138,369,0,9,409,351,147,9,489,498,907,4,41,1,54,0,39,1,15,45,55,39,16
06,California/CA,0606512,"Riverside County (West Central)--Corona City (South), Woodcrest & Home Gardens PUMA, California/CA",22,44,109,120,13,0,142,57,109,13,153,166,308,7,39,4,50,4,14,0,35,46,54,19,35
06,California/CA,0606513,"Riverside County (West Central)--Corona (Northwest) & Norco Cities PUMA, California/CA",20,38,257,121,0,0,141,38,257,0,295,295,436,5,28,0,68,0,9,0,59,32,68,9,59
06,California/CA,0606514,"Riverside County (Northwest)--Jurupa Valley & Eastvale Cities PUMA, California/CA",27,155,224,452,0,0,479,155,224,0,379,379,858,3,53,0,44,0,18,0,26,56,44,18,26
06,California/CA,0606515,"Riverside County--Palm Desert, La Quinta (West) & Desert Hot Springs Cities PUMA, California/CA",185,88,52,74,0,31,259,88,83,31,140,171,430,43,17,7,33,0,20,7,12,60,40,20,19
06,California/CA,0606701,"Sacramento County (North Central)--Citrus Heights City PUMA, California/CA",170,16,73,32,21,0,202,37,73,21,89,110,312,54,10,7,29,7,5,0,23,65,35,12,23
06,California/CA,0606702,"Sacramento County (Central)--Rancho Cordova City PUMA, California/CA",21,0,60,34,25,0,55,25,60,25,60,85,140,15,24,18,43,18,0,0,43,39,61,18,43
06,California/CA,0606703,"Sacramento County (North Central)--Arden-Arcade, Carmichael & Fair Oaks (West) PUMA, California/CA",107,0,0,0,0,35,107,0,35,35,0,35,142,75,0,25,0,0,0,25,0,75,25,0,25
06,California/CA,0606704,"Sacramento County (North Central)--North Highlands, Foothill Farms & McClellan Park PUMA, California/CA",127,0,57,82,13,0,209,13,57,13,57,70,279,46,29,5,20,5,0,0,20,75,25,5,20
06,California/CA,0606705,"Sacramento County (Northwest)--Sacramento City (Northwest/Natomas) PUMA, California/CA",200,0,65,93,8,0,293,8,65,8,65,73,366,55,25,2,18,2,0,0,18,80,20,2,18
06,California/CA,0606706,"Sacramento County (North)--Sacramento City (North), Antelope & Rio Linda PUMA, California/CA",63,126,321,32,0,0,95,126,321,0,447,447,542,12,6,0,82,0,23,0,59,18,82,23,59
06,California/CA,0606707,"Sacramento County (West)--Sacramento City (Central/Downtown & Midtown) PUMA, California/CA",126,0,31,62,0,0,188,0,31,0,31,31,219,58,28,0,14,0,0,0,14,86,14,0,14
06,California/CA,0606708,"Sacramento County--Sacramento City (Southeast/Fruitridge, Avondale & Depot Park) PUMA, California/CA",133,82,423,269,90,12,402,172,435,102,505,607,1009,13,27,10,50,9,8,1,42,40,60,17,43
06,California/CA,0606709,"Sacramento County--Sacramento City (Southwest/Pocket, Meadowview & North Laguna) PUMA, California/CA",169,159,140,58,8,0,227,167,140,8,299,307,534,32,11,1,56,1,30,0,26,43,57,31,26
06,California/CA,0606710,"Sacramento County (Central)--Elk Grove City PUMA, California/CA",66,0,37,105,164,78,171,164,115,242,37,279,450,15,23,54,8,36,0,17,8,38,62,36,26
06,California/CA,0606711,"Sacramento County (South)--Galt, Isleton Cities & Delta Region PUMA, California/CA",56,101,683,179,70,157,235,171,840,227,784,1011,1246,4,14,18,63,6,8,13,55,19,81,14,67
06,California/CA,0606712,"Sacramento County (Northeast)--Folsom City, Orangevale & Fair Oaks (East) PUMA, California/CA",66,0,0,54,21,0,120,21,0,21,0,21,141,47,38,15,0,15,0,0,0,85,15,15,0
06,California/CA,0607101,"San Bernardino County (Northeast)--Twentynine Palms & Barstow Cities PUMA, California/CA",83,34,70,119,74,0,202,108,70,74,104,178,380,22,31,19,27,19,9,0,18,53,47,28,18
06,California/CA,0607102,"San Bernardino County (West Central)--Victorville & Adelanto Cities PUMA, California/CA",105,83,36,108,14,0,213,97,36,14,119,133,346,30,31,4,34,4,24,0,10,62,38,28,10
06,California/CA,0607103,"San Bernardino County (West Central)--Hesperia City & Apple Valley Town PUMA, California/CA",35,26,76,31,0,0,66,26,76,0,102,102,168,21,18,0,61,0,15,0,45,39,61,15,45
06,California/CA,0607104,"San Bernardino County (Southwest)--Phelan, Lake Arrowhead & Big Bear City PUMA, California/CA",119,7,67,126,0,0,245,7,67,0,74,74,319,37,39,0,23,0,2,0,21,77,23,2,21
06,California/CA,0607105,"San Bernardino County (Southwest)--Redlands & Yucaipa Cities PUMA, California/CA",124,136,150,75,0,0,199,136,150,0,286,286,485,26,15,0,59,0,28,0,31,41,59,28,31
06,California/CA,0607106,"San Bernardino County (Southwest)--Colton, Loma Linda & Grand Terrace Cities PUMA, California/CA",75,58,177,151,26,8,226,84,185,34,235,269,495,15,31,7,47,5,12,2,36,46,54,17,37
06,California/CA,0607107,"San Bernardino County (Southwest)--San Bernardino City (East) PUMA, California/CA",0,66,139,54,0,0,54,66,139,0,205,205,259,0,21,0,79,0,25,0,54,21,79,25,54
06,California/CA,0607108,"San Bernardino County (Southwest)--San Bernardino City (West) PUMA, California/CA",101,145,541,194,15,13,295,160,554,28,686,714,1009,10,19,3,68,1,14,1,54,29,71,16,55
06,California/CA,0607109,"San Bernardino County (Southwest)--Rialto City PUMA, California/CA",0,149,312,292,0,0,292,149,312,0,461,461,753,0,39,0,61,0,20,0,41,39,61,20,41
06,California/CA,0607110,"San Bernardino County (Southwest)--Fontana City (East) PUMA, California/CA",0,201,105,101,0,0,101,201,105,0,306,306,407,0,25,0,75,0,49,0,26,25,75,49,26
06,California/CA,0607111,"San Bernardino County (Southwest)--Rancho Cucamonga City PUMA, California/CA",15,84,15,78,0,0,93,84,15,0,99,99,192,8,41,0,52,0,44,0,8,48,52,44,8
06,California/CA,0607112,"San Bernardino County (Southwest)--Upland & Montclair Cities PUMA, California/CA",19,56,113,14,14,0,33,70,113,14,169,183,216,9,6,6,78,6,26,0,52,15,85,32,52
06,California/CA,0607113,"San Bernardino County (Southwest)--Ontario City PUMA, California/CA",87,109,990,217,40,0,304,149,990,40,1099,1139,1443,6,15,3,76,3,8,0,69,21,79,10,69
06,California/CA,0607114,"San Bernardino County (Southwest)--Chino & Chino Hills Cities PUMA, California/CA",75,87,69,203,59,0,278,146,69,59,156,215,493,15,41,12,32,12,18,0,14,56,44,30,14
06,California/CA,0607115,"San Bernardino County (Southwest)--Fontana City (West) PUMA, California/CA",84,157,232,252,0,12,336,157,244,12,389,401,737,11,34,2,53,0,21,2,31,46,54,21,33
06,California/CA,0607301,"San Diego County (Northwest)--Oceanside City & Camp Pendleton PUMA, California/CA",12,167,690,51,0,0,63,167,690,0,857,857,920,1,6,0,93,0,18,0,75,7,93,18,75
06,California/CA,0607302,"San Diego County (North & East)--Fallbrook, Alpine & Valley Center PUMA, California/CA",64,394,925,120,2,0,184,396,925,2,1319,1321,1505,4,8,0,88,0,26,0,61,12,88,26,61
06,California/CA,0607303,"San Diego County (Northwest)--Vista City PUMA, California/CA",76,282,1045,54,0,0,130,282,1045,0,1327,1327,1457,5,4,0,91,0,19,0,72,9,91,19,72
06,California/CA,0607304,"San Diego County (Northwest)--Carlsbad City PUMA, California/CA",0,95,0,0,0,0,0,95,0,0,95,95,95,0,0,0,100,0,100,0,0,0,100,100,0
06,California/CA,0607305,"San Diego County (Northwest)--San Marcos & Escondido (West) Cities PUMA, California/CA",112,13,641,349,36,0,461,49,641,36,654,690,1151,10,30,3,57,3,1,0,56,40,60,4,56
06,California/CA,0607306,"San Diego County (Northwest)--Escondido City (East) PUMA, California/CA",76,192,1095,113,14,0,189,206,1095,14,1287,1301,1490,5,8,1,86,1,13,0,73,13,87,14,73
06,California/CA,0607307,"San Diego County (Central)--Lakeside, Winter Gardens & Ramona PUMA, California/CA",161,0,25,63,0,0,224,0,25,0,25,25,249,65,25,0,10,0,0,0,10,90,10,0,10
06,California/CA,0607308,"San Diego County (Central)--San Diego (Northeast/Rancho Bernardo) & Poway Cities PUMA, California/CA",6,0,0,0,13,7,6,13,7,20,0,20,26,23,0,77,0,50,0,27,0,23,77,50,27
06,California/CA,0607309,"San Diego County (West)--San Diego (Northwest/San Dieguito) & Encinitas Cities PUMA, California/CA",27,0,20,21,0,0,48,0,20,0,20,20,68,40,31,0,29,0,0,0,29,71,29,0,29
06,California/CA,0607310,"San Diego County (West)--San Diego City (Southwest/Central Coastal) PUMA, California/CA",36,2,24,14,0,0,50,2,24,0,26,26,76,47,18,0,34,0,3,0,32,66,34,3,32
06,California/CA,0607311,"San Diego County (West Central)--San Diego City (Northwest/Del Mar Mesa) PUMA, California/CA",0,0,0,34,31,0,34,31,0,31,0,31,65,0,52,48,0,48,0,0,0,52,48,48,0
06,California/CA,0607312,"San Diego County (Central)--San Diego City (Central/Mira Mesa & University Heights) PUMA, California/CA",40,0,71,0,0,11,40,0,82,11,71,82,122,33,0,9,58,0,0,9,58,33,67,0,67
06,California/CA,0607313,"San Diego County (Central)--El Cajon & Santee Cities PUMA, California/CA",0,0,0,41,0,58,41,0,58,58,0,58,99,0,41,59,0,0,0,59,0,41,59,0,59
06,California/CA,0607314,"San Diego County (Central)--San Diego (East Central/Navajo) & La Mesa Cities PUMA, California/CA",95,0,0,56,0,0,151,0,0,0,0,0,151,63,37,0,0,0,0,0,0,100,0,0,0
06,California/CA,0607315,"San Diego County (West Central)--San Diego City (Central/Clairemont & Kearny Mesa) PUMA, California/CA",60,15,79,85,58,0,145,73,79,58,94,152,297,20,29,20,32,20,5,0,27,49,51,25,27
06,California/CA,0607316,"San Diego County (South Central)--San Diego City (Central/Centre City & Balboa Park) PUMA, California/CA",52,118,320,60,0,0,112,118,320,0,438,438,550,9,11,0,80,0,21,0,58,20,80,21,58
06,California/CA,0607317,"San Diego County (South Central)--San Diego City (Central/Mid-City) PUMA, California/CA",45,19,287,65,0,32,110,19,319,32,306,338,448,10,15,7,68,0,4,7,64,25,75,4,71
06,California/CA,0607318,"San Diego County (South)--San Diego City (Southeast/Encanto & Skyline) PUMA, California/CA",58,154,264,14,0,6,72,154,270,6,418,424,496,12,3,1,84,0,31,1,53,15,85,31,54
06,California/CA,0607319,"San Diego County (South Central)--Lemon Grove City, La Presa & Spring Valley PUMA, California/CA",51,37,15,22,0,0,73,37,15,0,52,52,125,41,18,0,42,0,30,0,12,58,42,30,12
06,California/CA,0607320,"San Diego County (Southwest)--Sweetwater Region--Chula Vista City (East) PUMA, California/CA",66,10,0,36,0,0,102,10,0,0,10,10,112,59,32,0,9,0,9,0,0,91,9,9,0
06,California/CA,0607321,"San Diego County (Southwest)--Chula Vista (West) & National City Cities PUMA, California/CA",10,78,296,151,23,0,161,101,296,23,374,397,558,2,27,4,67,4,14,0,53,29,71,18,53
06,California/CA,0607322,"San Diego County (South)--San Diego City (South/Otay Mesa & South Bay) PUMA, California/CA",0,130,185,61,0,0,61,130,185,0,315,315,376,0,16,0,84,0,35,0,49,16,84,35,49
06,California/CA,0607501,"San Francisco County (North & West)--Richmond District PUMA, California/CA",23,0,60,42,58,0,65,58,60,58,60,118,183,13,23,32,33,32,0,0,33,36,64,32,33
06,California/CA,0607502,"San Francisco County (North & East)--North Beach & Chinatown PUMA, California/CA",0,0,0,30,30,10,30,30,10,40,0,40,70,0,43,57,0,43,0,14,0,43,57,43,14
06,California/CA,0607503,"San Francisco County (Central)--South of Market & Potrero PUMA, California/CA",0,47,83,58,0,0,58,47,83,0,130,130,188,0,31,0,69,0,25,0,44,31,69,25,44
06,California/CA,0607504,"San Francisco County (Central)--Inner Mission & Castro PUMA, California/CA",0,14,68,34,63,0,34,77,68,63,82,145,179,0,19,35,46,35,8,0,38,19,81,43,38
06,California/CA,0607505,"San Francisco County (Central)--Sunset District (North) PUMA, California/CA",92,0,0,52,38,50,144,38,50,88,0,88,232,40,22,38,0,16,0,22,0,62,38,16,22
06,California/CA,0607506,"San Francisco County (South Central)--Sunset District (South) PUMA, California/CA",137,27,0,0,46,14,137,73,14,60,27,87,224,61,0,27,12,21,12,6,0,61,39,33,6
06,California/CA,0607507,"San Francisco County (South Central)--Bayview & Hunters Point PUMA, California/CA",0,40,136,0,77,82,0,117,218,159,176,335,335,0,0,47,53,23,12,24,41,0,100,35,65
06,California/CA,0607701,"San Joaquin County (Central)--Stockton City (North) PUMA, California/CA",312,79,723,135,323,260,447,402,983,583,802,1385,1832,17,7,32,44,18,4,14,39,24,76,22,54
06,California/CA,0607702,"San Joaquin County (Central)--Stockton City (South) PUMA, California/CA",133,662,3868,749,130,14,882,792,3882,144,4530,4674,5556,2,13,3,82,2,12,0,70,16,84,14,70
06,California/CA,0607703,"San Joaquin County (South)--Tracy, Manteca & Lathrop Cities PUMA, California/CA",342,116,737,265,83,101,607,199,838,184,853,1037,1644,21,16,11,52,5,7,6,45,37,63,12,51
06,California/CA,0607704,"San Joaquin County (North)--Lodi, Ripon & Escalon Cities PUMA, California/CA",645,680,4221,546,144,117,1191,824,4338,261,4901,5162,6353,10,9,4,77,2,11,2,66,19,81,13,68
06,California/CA,0607901,"San Luis Obispo County (West)--Coastal Region PUMA, California/CA",565,167,688,157,0,18,722,167,706,18,855,873,1595,35,10,1,54,0,10,1,43,45,55,10,44
06,California/CA,0607902,"San Luis Obispo County (East)--Inland Region PUMA, California/CA",162,129,610,203,0,0,365,129,610,0,739,739,1104,15,18,0,67,0,12,0,55,33,67,12,55
06,California/CA,0608101,"San Mateo County (North Central)--Daly City, Pacifica Cities & Colma Town PUMA, California/CA",69,59,97,22,144,23,91,203,120,167,156,323,414,17,5,40,38,35,14,6,23,22,78,49,29
06,California/CA,0608102,"San Mateo County (North Central)--South San Francisco, San Bruno & Brisbane Cities PUMA, California/CA",17,200,32,50,84,0,67,284,32,84,232,316,383,4,13,22,61,22,52,0,8,17,83,74,8
06,California/CA,0608103,"San Mateo County (Central)--San Mateo (North), Burlingame & Millbrae Cities PUMA, California/CA",0,0,76,0,0,0,0,0,76,0,76,76,76,0,0,0,100,0,0,0,100,0,100,0,100
06,California/CA,0608104,"San Mateo County (South & West)--San Mateo (South) & Half Moon Bay Cities PUMA, California/CA",157,0,271,0,0,0,157,0,271,0,271,271,428,37,0,0,63,0,0,0,63,37,63,0,63
06,California/CA,0608105,"San Mateo County (East Central)--Redwood City, San Carlos & Belmont Cities PUMA, California/CA",31,0,170,0,17,0,31,17,170,17,170,187,218,14,0,8,78,8,0,0,78,14,86,8,78
06,California/CA,0608106,"San Mateo County (Southeast)--Menlo Park, East Palo Alto Cities & Atherton Town PUMA, California/CA",17,7,272,21,0,0,38,7,272,0,279,279,317,5,7,0,88,0,2,0,86,12,88,2,86
06,California/CA,0608301,"Santa Barbara County (Northwest)--Santa Maria City & Orcutt PUMA, California/CA",9,260,10970,441,0,19,450,260,10989,19,11230,11249,11699,0,4,0,96,0,2,0,94,4,96,2,94
06,California/CA,0608302,"Santa Barbara County (North)--Lompoc, Guadalupe, Solvang & Buellton Cities PUMA, California/CA",117,187,1933,173,0,58,290,187,1991,58,2120,2178,2468,5,7,2,86,0,8,2,78,12,88,8,81
06,California/CA,0608303,"Santa Barbara County--South Coast Region PUMA, California/CA",82,141,210,37,0,0,119,141,210,0,351,351,470,17,8,0,75,0,30,0,45,25,75,30,45
06,California/CA,0608501,"Santa Clara County (Northwest)--Mountain View, Palo Alto & Los Altos Cities PUMA, California/CA",91,0,0,78,0,0,169,0,0,0,0,0,169,54,46,0,0,0,0,0,0,100,0,0,0
06,California/CA,0608502,"Santa Clara County (Northwest)--Sunnyvale & San Jose (North) Cities PUMA, California/CA",38,16,62,0,0,17,38,16,79,17,78,95,133,29,0,13,59,0,12,13,47,29,71,12,59
06,California/CA,0608503,"Santa Clara County (Northwest)--San Jose (Northwest) & Santa Clara Cities PUMA, California/CA",0,54,46,34,34,0,34,88,46,34,100,134,168,0,20,20,60,20,32,0,27,20,80,52,27
06,California/CA,0608504,"Santa Clara County (North Central)--Milpitas & San Jose (Northeast) Cities PUMA, California/CA",35,0,4,27,0,0,62,0,4,0,4,4,66,53,41,0,6,0,0,0,6,94,6,0,6
06,California/CA,0608505,"Santa Clara County (North Central)--San Jose City (East Central) & Alum Rock PUMA, California/CA",57,0,80,125,35,0,182,35,80,35,80,115,297,19,42,12,27,12,0,0,27,61,39,12,27
06,California/CA,0608506,"Santa Clara County (East)--Gilroy, Morgan Hill & San Jose (South) Cities PUMA, California/CA",62,358,852,330,7,23,392,365,875,30,1210,1240,1632,4,20,2,74,0,22,1,52,24,76,22,54
06,California/CA,0608507,"Santa Clara County (Southwest)--Cupertino, Saratoga Cities & Los Gatos Town PUMA, California/CA",58,0,0,0,0,0,58,0,0,0,0,0,58,100,0,0,0,0,0,0,0,100,0,0,0
06,California/CA,0608508,"Santa Clara County (Central)--San Jose (West Central) & Campbell Cities PUMA, California/CA",52,0,59,0,4,23,52,4,82,27,59,86,138,38,0,20,43,3,0,17,43,38,62,3,59
06,California/CA,0608509,"Santa Clara County (Central)--San Jose City (Northwest) PUMA, California/CA",26,64,318,305,42,0,331,106,318,42,382,424,755,3,40,6,51,6,8,0,42,44,56,14,42
06,California/CA,0608510,"Santa Clara County (Central)--San Jose City (Central) PUMA, California/CA",7,52,312,239,107,20,246,159,332,127,364,491,737,1,32,17,49,15,7,3,42,33,67,22,45
06,California/CA,0608511,"Santa Clara County (Central)--San Jose City (South Central/Branham) & Cambrian Park PUMA, California/CA",0,20,23,0,0,0,0,20,23,0,43,43,43,0,0,0,100,0,47,0,53,0,100,47,53
06,California/CA,0608512,"Santa Clara County (Central)--San Jose City (Southwest/Almaden Valley) PUMA, California/CA",38,16,17,0,44,0,38,60,17,44,33,77,115,33,0,38,29,38,14,0,15,33,67,52,15
06,California/CA,0608513,"Santa Clara County (Central)--San Jose City (Southeast/Evergreen) PUMA, California/CA",0,60,60,34,8,0,34,68,60,8,120,128,162,0,21,5,74,5,37,0,37,21,79,42,37
06,California/CA,0608514,"Santa Clara County (Central)--San Jose City (East Central/East Valley) PUMA, California/CA",0,70,240,161,43,0,161,113,240,43,310,353,514,0,31,8,60,8,14,0,47,31,69,22,47
06,California/CA,0608701,"Santa Cruz County (North)--Watsonville & Scotts Valley Cities PUMA, California/CA",82,363,4260,739,0,0,821,363,4260,0,4623,4623,5444,2,14,0,85,0,7,0,78,15,85,7,78
06,California/CA,0608702,"Santa Cruz County (South & Coastal)--Santa Cruz City PUMA, California/CA",94,15,219,32,0,0,126,15,219,0,234,234,360,26,9,0,65,0,4,0,61,35,65,4,61
06,California/CA,0608900,"Shasta County--Redding City PUMA, California/CA",341,110,14,17,0,0,358,110,14,0,124,124,482,71,4,0,26,0,23,0,3,74,26,23,3
06,California/CA,0609501,"Solano County (Southwest)--Vallejo & Benicia Cities PUMA, California/CA",39,17,285,84,80,0,123,97,285,80,302,382,505,8,17,16,60,16,3,0,56,24,76,19,56
06,California/CA,0609502,"Solano County (Central)--Fairfield & Suisun City Cities PUMA, California/CA",272,62,911,204,59,42,476,121,953,101,973,1074,1550,18,13,7,63,4,4,3,59,31,69,8,61
06,California/CA,0609503,"Solano County (Northeast)--Vacaville & Dixon Cities PUMA, California/CA",296,157,594,119,0,24,415,157,618,24,751,775,1190,25,10,2,63,0,13,2,50,35,65,13,52
06,California/CA,0609701,"Sonoma County (North)--Windsor Town, Healdsburg & Sonoma Cities PUMA, California/CA",449,285,1193,166,0,13,615,285,1206,13,1478,1491,2106,21,8,1,70,0,14,1,57,29,71,14,57
06,California/CA,0609702,"Sonoma County (South)--Petaluma, Rohnert Park & Cotati Cities PUMA, California/CA",299,87,532,93,19,11,392,106,543,30,619,649,1041,29,9,3,59,2,8,1,51,38,62,10,52
06,California/CA,0609703,"Sonoma County (Central)--Santa Rosa City PUMA, California/CA",286,572,1991,235,0,0,521,572,1991,0,2563,2563,3084,9,8,0,83,0,19,0,65,17,83,19,65
06,California/CA,0609901,"Stanislaus County (Southwest)--Ceres, Patterson & Newman Cities PUMA, California/CA",353,611,1763,741,21,19,1094,632,1782,40,2374,2414,3508,10,21,1,68,1,17,1,50,31,69,18,51
06,California/CA,0609902,"Stanislaus County (Central)--Modesto City (West) PUMA, California/CA",89,276,1503,691,69,36,780,345,1539,105,1779,1884,2664,3,26,4,67,3,10,1,56,29,71,13,58
06,California/CA,0609903,"Stanislaus County (Northeast)--Turlock, Riverbank, Oakdale & Waterford Cities PUMA, California/CA",1174,701,3354,1065,403,169,2239,1104,3523,572,4055,4627,6866,17,16,8,59,6,10,2,49,33,67,16,51
06,California/CA,0609904,"Stanislaus County (Central)--Modesto City (East) PUMA, California/CA",256,149,512,123,31,0,379,180,512,31,661,692,1071,24,11,3,62,3,14,0,48,35,65,17,48
06,California/CA,0610100,"Sutter & Yuba Counties--Yuba City PUMA, California/CA",728,464,1953,247,432,495,975,896,2448,927,2417,3344,4319,17,6,21,56,10,11,11,45,23,77,21,57
06,California/CA,0610701,"Tulare County (Northwest)--Visalia City PUMA, California/CA",447,394,1413,729,77,57,1176,471,1470,134,1807,1941,3117,14,23,4,58,2,13,2,45,38,62,15,47
06,California/CA,0610702,"Tulare County (West Central)--Tulare & Porterville Cities PUMA, California/CA",569,815,5343,2397,185,105,2966,1000,5448,290,6158,6448,9414,6,25,3,65,2,9,1,57,32,68,11,58
06,California/CA,0610703,"Tulare County (Outside Visalia, Tulare & Porterville Cities) PUMA, California/CA",618,2093,10503,3477,58,172,4095,2151,10675,230,12596,12826,16921,4,21,1,74,0,12,1,62,24,76,13,63
06,California/CA,0611101,"Ventura County (Southeast)--Simi Valley City PUMA, California/CA",72,13,69,46,0,0,118,13,69,0,82,82,200,36,23,0,41,0,6,0,34,59,41,6,34
06,California/CA,0611102,"Ventura County (Southeast)--Thousand Oaks City PUMA, California/CA",26,18,42,29,13,0,55,31,42,13,60,73,128,20,23,10,47,10,14,0,33,43,57,24,33
06,California/CA,0611103,"Ventura County (Southwest)--Oxnard & Port Hueneme Cities PUMA, California/CA",117,848,10792,927,13,0,1044,861,10792,13,11640,11653,12697,1,7,0,92,0,7,0,85,8,92,7,85
06,California/CA,0611104,"Ventura County (Southwest)--San Buenaventura (Ventura) City PUMA, California/CA",47,171,890,62,0,9,109,171,899,9,1061,1070,1179,4,5,1,90,0,15,1,75,9,91,15,76
06,California/CA,0611105,"Ventura County (North)--Santa Paula, Fillmore & Ojai Cities PUMA, California/CA",274,444,2815,429,0,0,703,444,2815,0,3259,3259,3962,7,11,0,82,0,11,0,71,18,82,11,71
06,California/CA,0611106,"Ventura County (South Central)--Camarillo & Moorpark Cities PUMA, California/CA",68,265,1319,252,31,0,320,296,1319,31,1584,1615,1935,4,13,2,82,2,14,0,68,17,83,15,68
06,California/CA,0611300,"Yolo County--Davis, Woodland & West Sacramento Cities PUMA, California/CA",453,358,1498,560,45,0,1013,403,1498,45,1856,1901,2914,16,19,2,64,2,12,0,51,35,65,14,51
08,Colorado/CO,0800100,"Northeast Colorado--Eastern Plains Region PUMA, Colorado/CO",2110,218,712,538,40,280,2648,258,992,320,930,1250,3898,54,14,8,24,1,6,7,18,68,32,7,25
08,Colorado/CO,0800102,"Larimer County (South)--Loveland City PUMA, Colorado/CO",272,38,0,0,0,0,272,38,0,0,38,38,310,88,0,0,12,0,12,0,0,88,12,12,0
08,Colorado/CO,0800103,"Larimer County (North)--Fort Collins City PUMA, Colorado/CO",454,0,94,84,0,0,538,0,94,0,94,94,632,72,13,0,15,0,0,0,15,85,15,0,15
08,Colorado/CO,0800200,"Northwest Colorado--Garfield, Routt, Moffat & Rio Blanco Counties PUMA, Colorado/CO",457,0,61,12,0,0,469,0,61,0,61,61,530,86,2,0,12,0,0,0,12,88,12,0,12
08,Colorado/CO,0800300,"Weld County (South Central)--Greeley, Windsor & Evans Cities PUMA, Colorado/CO",696,349,1354,571,29,361,1267,378,1715,390,1703,2093,3360,21,17,12,51,1,10,11,40,38,62,11,51
08,Colorado/CO,0800400,"Eagle, Summit, Grand & Jackson Counties PUMA, Colorado/CO",464,7,96,0,0,0,464,7,96,0,103,103,567,82,0,0,18,0,1,0,17,82,18,1,17
08,Colorado/CO,0800600,"Fremont, Chaffee, Park, Lake, Huerfano, Pueblo (Southwest) & Custer Counties PUMA, Colorado/CO",299,0,1,210,0,0,509,0,1,0,1,1,510,59,41,0,0,0,0,0,0,100,0,0,0
08,Colorado/CO,0800700,"Pueblo County (North)--Pueblo City & Pueblo West PUMA, Colorado/CO",281,96,202,306,0,0,587,96,202,0,298,298,885,32,35,0,34,0,11,0,23,66,34,11,23
08,Colorado/CO,0800800,"Southeast Colorado PUMA, Colorado/CO",760,156,788,866,0,0,1626,156,788,0,944,944,2570,30,34,0,37,0,6,0,31,63,37,6,31
08,Colorado/CO,0800801,"DRCOG Mountains--Jefferson (West), Boulder (West), Clear Creek & Gilpin Counties PUMA, Colorado/CO",119,0,0,0,0,0,119,0,0,0,0,0,119,100,0,0,0,0,0,0,0,100,0,0,0
08,Colorado/CO,0800802,"Boulder (Northeast) & Weld (Southwest) Counties--Longmont City & Erie Town PUMA, Colorado/CO",165,7,49,185,44,0,350,51,49,44,56,100,450,37,41,10,12,10,2,0,11,78,22,11,11
08,Colorado/CO,0800803,"Boulder County (Central)--Boulder City PUMA, Colorado/CO",116,57,128,0,18,0,116,75,128,18,185,203,319,36,0,6,58,6,18,0,40,36,64,24,40
08,Colorado/CO,0800804,"Broomfield, Jefferson (Northeast), Adams (Northwest) & Boulder (Southeast) Counties PUMA, Colorado/CO",106,0,13,12,0,0,118,0,13,0,13,13,131,81,9,0,10,0,0,0,10,90,10,0,10
08,Colorado/CO,0800805,"Adams (West) & Jefferson (Far Northeast) Counties--Westminster & Northglenn Cities PUMA, Colorado/CO",159,0,141,149,0,0,308,0,141,0,141,141,449,35,33,0,31,0,0,0,31,69,31,0,31
08,Colorado/CO,0800806,"Adams County (West Central)--Thornton & Federal Heights Cities PUMA, Colorado/CO",173,32,336,117,0,33,290,32,369,33,368,401,691,25,17,5,53,0,5,5,49,42,58,5,53
08,Colorado/CO,0800807,"Adams County (West Central)--Commerce City & Brighton Cities PUMA, Colorado/CO",304,73,466,250,0,19,554,73,485,19,539,558,1112,27,22,2,48,0,7,2,42,50,50,7,44
08,Colorado/CO,0800808,"Arapahoe County (West)--Aurora (Southwest) & Centennial (East) Cities PUMA, Colorado/CO",260,26,33,0,0,0,260,26,33,0,59,59,319,82,0,0,18,0,8,0,10,82,18,8,10
08,Colorado/CO,0800809,"Arapahoe (West) & Adams (South Central) Counties--Aurora City (North Central) PUMA, Colorado/CO",219,90,73,0,0,114,219,90,187,114,163,277,496,44,0,23,33,0,18,23,15,44,56,18,38
08,Colorado/CO,0800810,"Arapahoe (Northwest) & Adams (Southwest) Counties--Aurora City (Northwest) PUMA, Colorado/CO",133,7,206,12,36,156,145,43,362,192,213,405,550,24,2,35,39,7,1,28,37,26,74,8,66
08,Colorado/CO,0800811,"Arapahoe County (Southwest)--Centennial (West & Central) & Greenwood Village Cities PUMA, Colorado/CO",0,22,0,90,21,0,90,43,0,21,22,43,133,0,68,16,17,16,17,0,0,68,32,32,0
08,Colorado/CO,0800812,"Denver City (Northeast) PUMA, Colorado/CO",267,0,209,140,35,102,407,35,311,137,209,346,753,35,19,18,28,5,0,14,28,54,46,5,41
08,Colorado/CO,0800813,"Denver City (Northwest) PUMA, Colorado/CO",20,0,33,149,0,0,169,0,33,0,33,33,202,10,74,0,16,0,0,0,16,84,16,0,16
08,Colorado/CO,0800814,"Denver City (South Central) PUMA, Colorado/CO",130,0,0,0,0,5,130,0,5,5,0,5,135,96,0,4,0,0,0,4,0,96,4,0,4
08,Colorado/CO,0800815,"Denver City (Southeast) PUMA, Colorado/CO",142,0,0,16,0,110,158,0,110,110,0,110,268,53,6,41,0,0,0,41,0,59,41,0,41
08,Colorado/CO,0800816,"Denver City (Southwest) PUMA, Colorado/CO",106,77,288,67,17,0,173,94,288,17,365,382,555,19,12,3,66,3,14,0,52,31,69,17,52
08,Colorado/CO,0800817,"Jefferson County (Northeast)--Arvada City PUMA, Colorado/CO",80,0,35,0,0,19,80,0,54,19,35,54,134,60,0,14,26,0,0,14,26,60,40,0,40
08,Colorado/CO,0800818,"Jefferson County (East Central)--Lakewood (North), Wheat Ridge & Golden Cities PUMA, Colorado/CO",195,33,112,11,0,0,206,33,112,0,145,145,351,56,3,0,41,0,9,0,32,59,41,9,32
08,Colorado/CO,0800819,"Jefferson County (East Central)--Lakewood City (South) & Dakota Ridge PUMA, Colorado/CO",112,0,14,98,9,19,210,9,33,28,14,42,252,44,39,11,6,4,0,8,6,83,17,4,13
08,Colorado/CO,0800820,"Arapahoe (West) & Jefferson (East) Counties--Littleton, Englewood Cities & Columbine PUMA, Colorado/CO",57,0,27,37,12,0,94,12,27,12,27,39,133,43,28,9,20,9,0,0,20,71,29,9,20
08,Colorado/CO,0800821,"Douglas (West) & Jefferson (Southeast) Counties--Highlands Ranch & Chatfield Park PUMA, Colorado/CO",118,0,0,18,0,0,136,0,0,0,0,0,136,87,13,0,0,0,0,0,0,100,0,0,0
08,Colorado/CO,0800822,"Douglas County (South)--Castle Rock Town PUMA, Colorado/CO",100,0,7,30,0,0,130,0,7,0,7,7,137,73,22,0,5,0,0,0,5,95,5,0,5
08,Colorado/CO,0800823,"Douglas (Northeast) & Elbert (West) Counties--Parker Town & The Pinery PUMA, Colorado/CO",121,0,0,24,0,0,145,0,0,0,0,0,145,83,17,0,0,0,0,0,0,100,0,0,0
08,Colorado/CO,0800824,"DRCOG East Plains--Arapahoe (East) & Adams (East) Counties--Aurora City (Northeast) PUMA, Colorado/CO",398,138,429,113,59,99,511,197,528,158,567,725,1236,32,9,13,46,5,11,8,35,41,59,16,43
08,Colorado/CO,0800900,"La Plata, Montezuma, Gunnison, Archuleta, Dolores, Hinsdale & San Juan Counties PUMA, Colorado/CO",499,54,77,14,0,0,513,54,77,0,131,131,644,77,2,0,20,0,8,0,12,80,20,8,12
08,Colorado/CO,0801001,"Mesa County (Central)--Greater Grand Junction & Fruita Cities PUMA, Colorado/CO",116,0,29,51,0,0,167,0,29,0,29,29,196,59,26,0,15,0,0,0,15,85,15,0,15
08,Colorado/CO,0801002,"Mesa (Outside Grand Junction City), Montrose, Delta, San Miguel & Ouray Counties PUMA, Colorado/CO",562,268,305,193,34,77,755,302,382,111,573,684,1439,39,13,8,40,2,19,5,21,52,48,21,27
08,Colorado/CO,0804101,"El Paso (Outside Colorado Springs City) & Teller Counties--Fountain City PUMA, Colorado/CO",119,0,0,186,75,0,305,75,0,75,0,75,380,31,49,20,0,20,0,0,0,80,20,20,0
08,Colorado/CO,0804102,"El Paso County (West Central)--Colorado Springs City (West) PUMA, Colorado/CO",38,0,97,19,0,0,57,0,97,0,97,97,154,25,12,0,63,0,0,0,63,37,63,0,63
08,Colorado/CO,0804103,"El Paso County (Central)--Colorado Springs City (Central) PUMA, Colorado/CO",206,0,57,0,0,0,206,0,57,0,57,57,263,78,0,0,22,0,0,0,22,78,22,0,22
08,Colorado/CO,0804104,"El Paso County (Central)--Colorado Springs City (East) & Cimarron Hills PUMA, Colorado/CO",53,0,0,26,0,69,79,0,69,69,0,69,148,36,18,47,0,0,0,47,0,53,47,0,47
08,Colorado/CO,0804105,"El Paso County (Central)--Colorado Springs City (South) & Security-Widefield PUMA, Colorado/CO",43,0,0,116,20,0,159,20,0,20,0,20,179,24,65,11,0,11,0,0,0,89,11,11,0
08,Colorado/CO,0804106,"El Paso County (North Central)--Colorado Springs City (North) & Monument Town PUMA, Colorado/CO",33,0,0,0,30,0,33,30,0,30,0,30,63,52,0,48,0,48,0,0,0,52,48,48,0
09,Connecticut/CT,0900100,"Danbury, Ridgefield, Bethel, Brookfield, New Fairfield, Redding & Sherman Towns PUMA, Connecticut/CT",171,0,26,0,0,0,171,0,26,0,26,26,197,87,0,0,13,0,0,0,13,87,13,0,13
09,Connecticut/CT,0900101,"Fairfield, New Canaan, Wilton, Weston & Easton Towns PUMA, Connecticut/CT",7,0,0,0,0,0,7,0,0,0,0,0,7,100,0,0,0,0,0,0,0,100,0,0,0
09,Connecticut/CT,0900102,"Stamford & Greenwich Towns PUMA, Connecticut/CT",71,38,57,0,21,0,71,59,57,21,95,116,187,38,0,11,51,11,20,0,30,38,62,32,30
09,Connecticut/CT,0900103,"Norwalk, Westport & Darien Towns PUMA, Connecticut/CT",41,0,0,0,0,0,41,0,0,0,0,0,41,100,0,0,0,0,0,0,0,100,0,0,0
09,Connecticut/CT,0900104,"Bridgeport Town PUMA, Connecticut/CT",80,0,85,42,0,25,122,0,110,25,85,110,232,34,18,11,37,0,0,11,37,53,47,0,47
09,Connecticut/CT,0900105,"Stratford, Shelton, Trumbull, Newtown & Monroe Towns PUMA, Connecticut/CT",113,15,0,0,0,0,113,15,0,0,15,15,128,88,0,0,12,0,12,0,0,88,12,12,0
09,Connecticut/CT,0900300,"Hartford County (North) PUMA, Connecticut/CT",242,0,0,0,0,0,242,0,0,0,0,0,242,100,0,0,0,0,0,0,0,100,0,0,0
09,Connecticut/CT,0900301,"Manchester & East Hartford Towns PUMA, Connecticut/CT",33,0,0,0,76,16,33,76,16,92,0,92,125,26,0,74,0,61,0,13,0,26,74,61,13
09,Connecticut/CT,0900302,"Hartford Town PUMA, Connecticut/CT",0,0,57,70,20,78,70,20,135,98,57,155,225,0,31,44,25,9,0,35,25,31,69,9,60
09,Connecticut/CT,0900303,"West Hartford, Farmington, Simsbury, Bloomfield, Avon & Canton Towns PUMA, Connecticut/CT",50,0,18,43,22,0,93,22,18,22,18,40,133,38,32,17,14,17,0,0,14,70,30,17,14
09,Connecticut/CT,0900304,"Bristol, Southington & Burlington Towns PUMA, Connecticut/CT",92,0,0,69,0,37,161,0,37,37,0,37,198,46,35,19,0,0,0,19,0,81,19,0,19
09,Connecticut/CT,0900305,"New Britain, Berlin & Plainville Towns PUMA, Connecticut/CT",82,50,29,60,0,81,142,50,110,81,79,160,302,27,20,27,26,0,17,27,10,47,53,17,36
09,Connecticut/CT,0900306,"Glastonbury, Newington, Wethersfield, Rocky Hill & Marlborough Towns PUMA, Connecticut/CT",17,0,16,31,23,0,48,23,16,23,16,39,87,20,36,26,18,26,0,0,18,55,45,26,18
09,Connecticut/CT,0900500,"Litchfield County PUMA, Connecticut/CT",424,0,0,53,0,0,477,0,0,0,0,0,477,89,11,0,0,0,0,0,0,100,0,0,0
09,Connecticut/CT,0900700,"Middlesex County PUMA, Connecticut/CT",128,0,0,0,0,0,128,0,0,0,0,0,128,100,0,0,0,0,0,0,0,100,0,0,0
09,Connecticut/CT,0900900,"New Haven County (Northwest) PUMA, Connecticut/CT",78,0,0,0,18,0,78,18,0,18,0,18,96,81,0,19,0,19,0,0,0,81,19,19,0
09,Connecticut/CT,0900901,"Waterbury Town PUMA, Connecticut/CT",18,0,0,91,44,0,109,44,0,44,0,44,153,12,59,29,0,29,0,0,0,71,29,29,0
09,Connecticut/CT,0900902,"Meriden, Wallingford & North Haven Towns PUMA, Connecticut/CT",52,0,0,96,0,9,148,0,9,9,0,9,157,33,61,6,0,0,0,6,0,94,6,0,6
09,Connecticut/CT,0900903,"Hamden, Ansonia, Seymour, Derby, Woodbridge & Bethany Towns PUMA, Connecticut/CT",58,0,0,0,0,0,58,0,0,0,0,0,58,100,0,0,0,0,0,0,0,100,0,0,0
09,Connecticut/CT,0900904,"West Haven, Milford & Orange Towns PUMA, Connecticut/CT",89,41,153,0,0,0,89,41,153,0,194,194,283,31,0,0,69,0,14,0,54,31,69,14,54
09,Connecticut/CT,0900905,"New Haven Town PUMA, Connecticut/CT",75,0,20,268,9,35,343,9,55,44,20,64,407,18,66,11,5,2,0,9,5,84,16,2,14
09,Connecticut/CT,0901100,"New London County (North) PUMA, Connecticut/CT",174,0,0,0,0,0,174,0,0,0,0,0,174,100,0,0,0,0,0,0,0,100,0,0,0
09,Connecticut/CT,0901101,"New London County (South) PUMA, Connecticut/CT",145,0,0,0,0,0,145,0,0,0,0,0,145,100,0,0,0,0,0,0,0,100,0,0,0
09,Connecticut/CT,0901300,"Tolland County PUMA, Connecticut/CT",293,0,0,0,28,16,293,28,16,44,0,44,337,87,0,13,0,8,0,5,0,87,13,8,5
09,Connecticut/CT,0901500,"Windham County PUMA, Connecticut/CT",323,81,190,35,0,26,358,81,216,26,271,297,655,49,5,4,41,0,12,4,29,55,45,12,33
10,Delaware/DE,1000101,"New Castle County (East Central)--Wilmington City PUMA, Delaware/DE",224,18,245,88,0,0,312,18,245,0,263,263,575,39,15,0,46,0,3,0,43,54,46,3,43
10,Delaware/DE,1000102,"New Castle County (North)--Hockessin PUMA, Delaware/DE",289,42,55,0,0,18,289,42,73,18,97,115,404,72,0,4,24,0,10,4,14,72,28,10,18
10,Delaware/DE,1000103,"New Castle County (West Central)--Newark City & Brookside PUMA, Delaware/DE",243,28,20,17,16,47,260,44,67,63,48,111,371,65,5,17,13,4,8,13,5,70,30,12,18
10,Delaware/DE,1000104,"New Castle County (South)--Middletown Town, Bear & Glasgow PUMA, Delaware/DE",99,0,0,0,0,0,99,0,0,0,0,0,99,100,0,0,0,0,0,0,0,100,0,0,0
10,Delaware/DE,1000200,"Kent County--Dover City PUMA, Delaware/DE",934,0,231,47,169,316,981,169,547,485,231,716,1697,55,3,29,14,10,0,19,14,58,42,10,32
10,Delaware/DE,1000300,"Sussex County PUMA, Delaware/DE",1995,243,1194,223,112,285,2218,355,1479,397,1437,1834,4052,49,6,10,35,3,6,7,29,55,45,9,37
11,District of Columbia/DC,1100102,"District of Columbia (North) PUMA, District of Columbia/DC",0,0,39,0,0,0,0,0,39,0,39,39,39,0,0,0,100,0,0,0,100,0,100,0,100
11,District of Columbia/DC,1100103,"District of Columbia (Northeast) PUMA, District of Columbia/DC",32,0,0,0,0,0,32,0,0,0,0,0,32,100,0,0,0,0,0,0,0,100,0,0,0
11,District of Columbia/DC,1100104,"District of Columbia (East) PUMA, District of Columbia/DC",22,0,0,0,0,0,22,0,0,0,0,0,22,100,0,0,0,0,0,0,0,100,0,0,0
11,District of Columbia/DC,1100105,"District of Columbia (Central) PUMA, District of Columbia/DC",17,0,0,29,0,0,46,0,0,0,0,0,46,37,63,0,0,0,0,0,0,100,0,0,0
12,Florida/FL,1200101,"Alachua County (Central)--Gainesville City (Central) PUMA, Florida/FL",354,0,406,0,0,0,354,0,406,0,406,406,760,47,0,0,53,0,0,0,53,47,53,0,53
12,Florida/FL,1200102,"Alachua County (Outer) PUMA, Florida/FL",255,0,11,15,0,13,270,0,24,13,11,24,294,87,5,4,4,0,0,4,4,92,8,0,8
12,Florida/FL,1200500,"Walton, Washington, Holmes & Bay Counties PUMA, Florida/FL",204,0,58,11,0,0,215,0,58,0,58,58,273,75,4,0,21,0,0,0,21,79,21,0,21
12,Florida/FL,1200901,"Brevard County (Northwest)--Titusville, Rockledge & Cocoa Cities PUMA, Florida/FL",69,0,72,112,0,0,181,0,72,0,72,72,253,27,44,0,28,0,0,0,28,72,28,0,28
12,Florida/FL,1200902,"Brevard County (East)--Beaches & Merritt Island PUMA, Florida/FL",59,0,0,0,0,10,59,0,10,10,0,10,69,86,0,14,0,0,0,14,0,86,14,0,14
12,Florida/FL,1200903,"Brevard County (Southwest)--Melbourne & West Melbourne Cities PUMA, Florida/FL",21,0,0,93,0,0,114,0,0,0,0,0,114,18,82,0,0,0,0,0,0,100,0,0,0
12,Florida/FL,1200904,"Brevard County (Southeast)--Palm Bay City, Grant-Valkaria & Malabar Towns PUMA, Florida/FL",111,0,16,0,0,7,111,0,23,7,16,23,134,83,0,5,12,0,0,5,12,83,17,0,17
12,Florida/FL,1201101,"Broward County (West)--Coral Springs & Parkland Cities PUMA, Florida/FL",0,35,0,0,0,0,0,35,0,0,35,35,35,0,0,0,100,0,100,0,0,0,100,100,0
12,Florida/FL,1201102,"Broward County (North Central)--Margate & Coconut Creek Cities PUMA, Florida/FL",16,0,0,0,0,0,16,0,0,0,0,0,16,100,0,0,0,0,0,0,0,100,0,0,0
12,Florida/FL,1201103,"Broward County--Deerfield, Pompano Beach (North) & Lighthouse Point Cities PUMA, Florida/FL",48,0,0,0,0,55,48,0,55,55,0,55,103,47,0,53,0,0,0,53,0,47,53,0,53
12,Florida/FL,1201104,"Broward County--Pompano Beach (South) & Fort Lauderdale (Northeast) Cities PUMA, Florida/FL",25,0,7,12,0,0,37,0,7,0,7,7,44,57,27,0,16,0,0,0,16,84,16,0,16
12,Florida/FL,1201105,"Broward County (Central)--Tamarac, Oakland Park & North Lauderdale Cities PUMA, Florida/FL",32,14,10,9,10,0,41,24,10,10,24,34,75,43,12,13,32,13,19,0,13,55,45,32,13
12,Florida/FL,1201106,"Broward County (Central)--Plantation & Sunrise Cities PUMA, Florida/FL",11,0,23,15,22,12,26,22,35,34,23,57,83,13,18,41,28,27,0,14,28,31,69,27,42
12,Florida/FL,1201107,"Broward County (Central)--Lauderhill & Lauderdale Lakes Cities PUMA, Florida/FL",75,21,31,0,91,0,75,112,31,91,52,143,218,34,0,42,24,42,10,0,14,34,66,51,14
12,Florida/FL,1201108,"Broward County (East Central)--Fort Lauderdale City (Central) PUMA, Florida/FL",38,74,83,0,0,12,38,74,95,12,157,169,207,18,0,6,76,0,36,6,40,18,82,36,46
12,Florida/FL,1201109,"Broward County (Southeast)--Hollywood (North) & Dania Beach (South) Cities PUMA, Florida/FL",0,36,20,0,90,0,0,126,20,90,56,146,146,0,0,62,38,62,25,0,14,0,100,86,14
12,Florida/FL,1201110,"Broward County (Central)--Davie Town & Cooper City PUMA, Florida/FL",68,35,460,38,15,0,106,50,460,15,495,510,616,11,6,2,80,2,6,0,75,17,83,8,75
12,Florida/FL,1201111,"Broward County--Weston, Pembroke Pines (Northwest) Cities & Southwest Ranches Town PUMA, Florida/FL",95,0,27,24,44,26,119,44,53,70,27,97,216,44,11,32,12,20,0,12,12,55,45,20,25
12,Florida/FL,1201112,"Broward County (South Central)--Miramar (West) & Pembroke Pines (Southwest) Cities PUMA, Florida/FL",79,10,1,0,0,0,79,10,1,0,11,11,90,88,0,0,12,0,11,0,1,88,12,11,1
12,Florida/FL,1201113,"Broward County (Southeast)--Hollywood (South) & Pembroke Pines (East) Cities PUMA, Florida/FL",0,63,197,66,0,0,66,63,197,0,260,260,326,0,20,0,80,0,19,0,60,20,80,19,60
12,Florida/FL,1201114,"Broward County (Southeast)--Miramar (East), Hallandale Beach & West Park Cities PUMA, Florida/FL",83,35,25,33,15,0,116,50,25,15,60,75,191,43,17,8,31,8,18,0,13,61,39,26,13
12,Florida/FL,1201500,"Charlotte County PUMA, Florida/FL",120,0,14,0,0,0,120,0,14,0,14,14,134,90,0,0,10,0,0,0,10,90,10,0,10
12,Florida/FL,1201701,"Citrus County PUMA, Florida/FL",128,0,35,0,0,0,128,0,35,0,35,35,163,79,0,0,21,0,0,0,21,79,21,0,21
12,Florida/FL,1201900,"Clay County PUMA, Florida/FL",263,0,0,29,0,0,292,0,0,0,0,0,292,90,10,0,0,0,0,0,0,100,0,0,0
12,Florida/FL,1202101,"Collier County (Northwest) PUMA, Florida/FL",0,0,27,42,0,29,42,0,56,29,27,56,98,0,43,30,28,0,0,30,28,43,57,0,57
12,Florida/FL,1202102,"Collier County (Southwest) PUMA, Florida/FL",9,0,127,0,0,18,9,0,145,18,127,145,154,6,0,12,82,0,0,12,82,6,94,0,94
12,Florida/FL,1202103,"Collier County (East) PUMA, Florida/FL",183,99,3287,428,96,795,611,195,4082,891,3386,4277,4888,4,9,18,69,2,2,16,67,12,88,4,84
12,Florida/FL,1202300,"Columbia, Levy, Bradford, Gilchrist, Dixie & Union Counties PUMA, Florida/FL",565,18,171,47,0,0,612,18,171,0,189,189,801,71,6,0,24,0,2,0,21,76,24,2,21
12,Florida/FL,1202700,"Southwest Heartland--Highlands (Northwest), DeSoto & Hardee Counties PUMA, Florida/FL",545,482,2528,429,0,155,974,482,2683,155,3010,3165,4139,13,10,4,73,0,12,4,61,24,76,12,65
12,Florida/FL,1203101,"Duval County (Outer)--Jacksonville City (North & West) PUMA, Florida/FL",141,80,0,24,0,0,165,80,0,0,80,80,245,58,10,0,33,0,33,0,0,67,33,33,0
12,Florida/FL,1203102,"Duval County (Northwest Central)--Jacksonville City (Northwest) PUMA, Florida/FL",287,0,0,18,0,0,305,0,0,0,0,0,305,94,6,0,0,0,0,0,0,100,0,0,0
12,Florida/FL,1203103,"Duval County (North Central)--Jacksonville City (Arlington) PUMA, Florida/FL",111,0,21,0,0,0,111,0,21,0,21,21,132,84,0,0,16,0,0,0,16,84,16,0,16
12,Florida/FL,1203104,"Duval County (East)--Jacksonville City (Beaches) PUMA, Florida/FL",143,22,32,56,0,17,199,22,49,17,54,71,270,53,21,6,20,0,8,6,12,74,26,8,18
12,Florida/FL,1203105,"Duval County (Southeast)--Jacksonville City (Southeast) PUMA, Florida/FL",18,0,0,24,46,288,42,46,288,334,0,334,376,5,6,89,0,12,0,77,0,11,89,12,77
12,Florida/FL,1203106,"Duval County (South Central)--Jacksonville City (Southeast River) PUMA, Florida/FL",0,76,0,0,31,29,0,107,29,60,76,136,136,0,0,44,56,23,56,21,0,0,100,79,21
12,Florida/FL,1203107,"Duval County (Southwest Central)--Jacksonville City (Southwest) PUMA, Florida/FL",111,0,0,48,7,0,159,7,0,7,0,7,166,67,29,4,0,4,0,0,0,96,4,4,0
12,Florida/FL,1203301,"Escambia County (North) PUMA, Florida/FL",187,0,0,0,0,0,187,0,0,0,0,0,187,100,0,0,0,0,0,0,0,100,0,0,0
12,Florida/FL,1203302,"Escambia County (South) PUMA, Florida/FL",73,23,0,0,0,0,73,23,0,0,23,23,96,76,0,0,24,0,24,0,0,76,24,24,0
12,Florida/FL,1203500,"Flagler & Volusia (North Central) Counties PUMA, Florida/FL",198,0,62,10,0,0,208,0,62,0,62,62,270,73,4,0,23,0,0,0,23,77,23,0,23
12,Florida/FL,1205301,"Hernando County PUMA, Florida/FL",101,0,101,0,0,0,101,0,101,0,101,101,202,50,0,0,50,0,0,0,50,50,50,0,50
12,Florida/FL,1205701,"Hillsborough County (Central)--Tampa City (Central) PUMA, Florida/FL",78,31,60,70,12,20,148,43,80,32,91,123,271,29,26,12,34,4,11,7,22,55,45,16,30
12,Florida/FL,1205702,"Hillsborough County (Southwest)--Tampa City (South) PUMA, Florida/FL",55,0,353,43,22,20,98,22,373,42,353,395,493,11,9,9,72,4,0,4,72,20,80,4,76
12,Florida/FL,1205703,"Hillsborough County (Northwest) PUMA, Florida/FL",112,60,137,19,0,0,131,60,137,0,197,197,328,34,6,0,60,0,18,0,42,40,60,18,42
12,Florida/FL,1205704,"Hillsborough County (North Central) PUMA, Florida/FL",57,49,152,74,0,0,131,49,152,0,201,201,332,17,22,0,61,0,15,0,46,39,61,15,46
12,Florida/FL,1205705,"Hillsborough County (North Central)--Tampa City (North) PUMA, Florida/FL",37,0,8,48,0,15,85,0,23,15,8,23,108,34,44,14,7,0,0,14,7,79,21,0,21
12,Florida/FL,1205706,"Hillsborough County (Northeast) PUMA, Florida/FL",308,77,2370,380,0,0,688,77,2370,0,2447,2447,3135,10,12,0,78,0,2,0,76,22,78,2,76
12,Florida/FL,1205707,"Hillsborough County (Central) PUMA, Florida/FL",70,10,136,83,0,0,153,10,136,0,146,146,299,23,28,0,49,0,3,0,45,51,49,3,45
12,Florida/FL,1205708,"Hillsborough County (South County) PUMA, Florida/FL",108,177,1778,372,0,78,480,177,1856,78,1955,2033,2513,4,15,3,78,0,7,3,71,19,81,7,74
12,Florida/FL,1206100,"Indian River County PUMA, Florida/FL",130,77,364,29,0,0,159,77,364,0,441,441,600,22,5,0,74,0,13,0,61,26,74,13,61
12,Florida/FL,1206300,"Apalachee Region (Outside Leon County) PUMA, Florida/FL",1211,31,223,52,0,93,1263,31,316,93,254,347,1610,75,3,6,16,0,2,6,14,78,22,2,20
12,Florida/FL,1206901,"Lake County (North) PUMA, Florida/FL",440,51,296,0,13,0,440,64,296,13,347,360,800,55,0,2,43,2,6,0,37,55,45,8,37
12,Florida/FL,1206902,"Sumter (North) & Lake (North) Counties PUMA, Florida/FL",59,0,27,61,37,0,120,37,27,37,27,64,184,32,33,20,15,20,0,0,15,65,35,20,15
12,Florida/FL,1206903,"Lake (South) & Sumter (South) Counties PUMA, Florida/FL",363,42,146,18,48,0,381,90,146,48,188,236,617,59,3,8,30,8,7,0,24,62,38,15,24
12,Florida/FL,1207101,"Lee County (South & West)--Barrier Islands Region PUMA, Florida/FL",0,0,93,0,0,29,0,0,122,29,93,122,122,0,0,24,76,0,0,24,76,0,100,0,100
12,Florida/FL,1207102,"Lee County (Northwest)--Cape Coral City PUMA, Florida/FL",85,110,26,0,12,0,85,122,26,12,136,148,233,36,0,5,58,5,47,0,11,36,64,52,11
12,Florida/FL,1207103,"Lee County (Northeast)--Lehigh Acres & North Fort Myers PUMA, Florida/FL",88,49,48,95,0,248,183,49,296,248,97,345,528,17,18,47,18,0,9,47,9,35,65,9,56
12,Florida/FL,1207104,"Lee County (Central)--Greater Fort Myers City PUMA, Florida/FL",66,54,139,0,0,99,66,54,238,99,193,292,358,18,0,28,54,0,15,28,39,18,82,15,66
12,Florida/FL,1207105,"Lee County (Southeast)--Bonita Springs City & Estero (East) PUMA, Florida/FL",46,47,213,27,6,0,73,53,213,6,260,266,339,14,8,2,77,2,14,0,63,22,78,16,63
12,Florida/FL,1207300,"Leon County (Outer) PUMA, Florida/FL",69,0,0,35,0,0,104,0,0,0,0,0,104,66,34,0,0,0,0,0,0,100,0,0,0
12,Florida/FL,1207301,"Leon County (Central)--Tallahassee City (Central) PUMA, Florida/FL",49,0,0,111,0,0,160,0,0,0,0,0,160,31,69,0,0,0,0,0,0,100,0,0,0
12,Florida/FL,1208101,"Manatee County (North) PUMA, Florida/FL",145,51,181,8,11,15,153,62,196,26,232,258,411,35,2,6,56,3,12,4,44,37,63,15,48
12,Florida/FL,1208102,"Manatee County (West Central) PUMA, Florida/FL",115,0,335,9,77,18,124,77,353,95,335,430,554,21,2,17,60,14,0,3,60,22,78,14,64
12,Florida/FL,1208103,"Manatee County (South) PUMA, Florida/FL",109,25,40,25,62,0,134,87,40,62,65,127,261,42,10,24,25,24,10,0,15,51,49,33,15
12,Florida/FL,1208301,"Marion County (North) PUMA, Florida/FL",325,132,442,0,0,0,325,132,442,0,574,574,899,36,0,0,64,0,15,0,49,36,64,15,49
12,Florida/FL,1208302,"Marion County (Central)--Ocala City PUMA, Florida/FL",225,64,150,42,0,0,267,64,150,0,214,214,481,47,9,0,44,0,13,0,31,56,44,13,31
12,Florida/FL,1208303,"Marion County (South Central) PUMA, Florida/FL",119,140,13,94,0,27,213,140,40,27,153,180,393,30,24,7,39,0,36,7,3,54,46,36,10
12,Florida/FL,1208500,"Martin County PUMA, Florida/FL",67,92,586,32,0,28,99,92,614,28,678,706,805,8,4,3,84,0,11,3,73,12,88,11,76
12,Florida/FL,1208601,"Miami-Dade County (North Central)--Greater Miami Lakes Town PUMA, Florida/FL",29,69,45,17,0,0,46,69,45,0,114,114,160,18,11,0,71,0,43,0,28,29,71,43,28
12,Florida/FL,1208602,"Miami-Dade County (North Central)--Miami Gardens City (North & West) PUMA, Florida/FL",11,0,47,0,0,0,11,0,47,0,47,47,58,19,0,0,81,0,0,0,81,19,81,0,81
12,Florida/FL,1208603,"Miami-Dade County (Northeast)--Greater North Miami Beach City (West) PUMA, Florida/FL",34,25,17,12,22,68,46,47,85,90,42,132,178,19,7,51,24,12,14,38,10,26,74,26,48
12,Florida/FL,1208604,"Miami-Dade County (Northeast)--Aventura City & Surfside Town PUMA, Florida/FL",0,2,14,3,7,0,3,9,14,7,16,23,26,0,12,27,62,27,8,0,54,12,88,35,54
12,Florida/FL,1208605,"Miami-Dade County--North Miami City (Southwest) & Golden Glades (West) PUMA, Florida/FL",15,6,8,26,55,21,41,61,29,76,14,90,131,11,20,58,11,42,5,16,6,31,69,47,22
12,Florida/FL,1208606,"Miami-Dade County (Northeast)--Opa-Locka City, West Little River & Westview PUMA, Florida/FL",18,37,67,24,0,4,42,37,71,4,104,108,150,12,16,3,69,0,25,3,45,28,72,25,47
12,Florida/FL,1208607,"Miami-Dade County (Northeast)--Hialeah City (North Central) PUMA, Florida/FL",0,16,265,51,0,13,51,16,278,13,281,294,345,0,15,4,81,0,5,4,77,15,85,5,81
12,Florida/FL,1208608,"Miami-Dade County (North Central)--Doral, Sweetwater Cities & Fontainebleau PUMA, Florida/FL",0,84,73,25,0,19,25,84,92,19,157,176,201,0,12,9,78,0,42,9,36,12,88,42,46
12,Florida/FL,1208609,"Miami-Dade County (Northeast)--Hialeah City (South Central) PUMA, Florida/FL",0,58,236,0,0,0,0,58,236,0,294,294,294,0,0,0,100,0,20,0,80,0,100,20,80
12,Florida/FL,1208610,"Miami-Dade County (Central)--Miami Springs City & Miami International Airport PUMA, Florida/FL",13,35,123,0,0,0,13,35,123,0,158,158,171,8,0,0,92,0,20,0,72,8,92,20,72
12,Florida/FL,1208611,"Miami-Dade County (Northeast Central)--Miami City (North) PUMA, Florida/FL",59,0,115,0,17,66,59,17,181,83,115,198,257,23,0,32,45,7,0,26,45,23,77,7,70
12,Florida/FL,1208612,"Miami-Dade County (Northeast)--Miami Beach City & Miami Shores Village PUMA, Florida/FL",23,0,13,36,0,0,59,0,13,0,13,13,72,32,50,0,18,0,0,0,18,82,18,0,18
12,Florida/FL,1208613,"Miami-Dade County (Northeast Central)--Miami City (Downtown) PUMA, Florida/FL",0,215,219,31,0,10,31,215,229,10,434,444,475,0,7,2,91,0,45,2,46,7,93,45,48
12,Florida/FL,1208614,"Miami-Dade County (East)--Miami City (East) & Key Biscayne Village PUMA, Florida/FL",32,17,50,38,2,1,70,19,51,3,67,70,140,23,27,2,48,1,12,1,36,50,50,14,36
12,Florida/FL,1208615,"Miami-Dade County (East Central)--Miami City (West) PUMA, Florida/FL",0,4,33,21,0,0,21,4,33,0,37,37,58,0,36,0,64,0,7,0,57,36,64,7,57
12,Florida/FL,1208616,"Miami-Dade County (East)--Coral Gables City, Pinecrest Village & Kendall (South) PUMA, Florida/FL",10,67,32,6,0,0,16,67,32,0,99,99,115,9,5,0,86,0,58,0,28,14,86,58,28
12,Florida/FL,1208617,"Miami-Dade County (East Central)--South Miami City, Westchester & Coral Terrace PUMA, Florida/FL",0,105,94,10,0,0,10,105,94,0,199,199,209,0,5,0,95,0,50,0,45,5,95,50,45
12,Florida/FL,1208618,"Miami-Dade County (North Central)--Tamiami Trail Region (South)--Tamiami PUMA, Florida/FL",4,74,503,11,0,0,15,74,503,0,577,577,592,1,2,0,97,0,12,0,85,3,97,12,85
12,Florida/FL,1208619,"Miami-Dade County (Central)--Kendale Lakes (Southwest) & Kendall West (South) PUMA, Florida/FL",0,9,313,0,0,0,0,9,313,0,322,322,322,0,0,0,100,0,3,0,97,0,100,3,97
12,Florida/FL,1208620,"Miami-Dade County (East Central)--Kendall (North), Sunset & Westwood Lakes PUMA, Florida/FL",10,0,110,19,0,0,29,0,110,0,110,110,139,7,14,0,79,0,0,0,79,21,79,0,79
12,Florida/FL,1208621,"Miami-Dade County (Central)--The Hammocks (West), Richmond West (West) & Country Walk PUMA, Florida/FL",17,62,46,0,0,0,17,62,46,0,108,108,125,14,0,0,86,0,50,0,37,14,86,50,37
12,Florida/FL,1208622,"Miami-Dade County (Southwest)--South Miami Heights PUMA, Florida/FL",0,82,378,47,23,0,47,105,378,23,460,483,530,0,9,4,87,4,15,0,71,9,91,20,71
12,Florida/FL,1208623,"Miami-Dade County (Southeast)--Cutler Bay Town & Palmetto Bay Village PUMA, Florida/FL",0,0,386,0,3,55,0,3,441,58,386,444,444,0,0,13,87,1,0,12,87,0,100,1,99
12,Florida/FL,1208624,"Miami-Dade County (South)--Homestead City (North) & Florida City (North) PUMA, Florida/FL",72,230,1459,114,40,42,186,270,1501,82,1689,1771,1957,4,6,4,86,2,12,2,75,10,90,14,77
12,Florida/FL,1208700,"Miami-Dade (South/Outside Urban Development Boundary) & Monroe Counties PUMA, Florida/FL",40,108,515,74,32,39,114,140,554,71,623,694,808,5,9,9,77,4,13,5,64,14,86,17,69
12,Florida/FL,1208900,"Nassau & Baker Counties PUMA, Florida/FL",124,0,4,0,0,0,124,0,4,0,4,4,128,97,0,0,3,0,0,0,3,97,3,0,3
12,Florida/FL,1209100,"Okaloosa County PUMA, Florida/FL",78,0,0,0,30,0,78,30,0,30,0,30,108,72,0,28,0,28,0,0,0,72,28,28,0
12,Florida/FL,1209300,"Southeast Heartland--Highlands (South & East), Okeechobee, Hendry & Glades Counties PUMA, Florida/FL",740,165,2733,723,14,12,1463,179,2745,26,2898,2924,4387,17,16,1,66,0,4,0,62,33,67,4,63
12,Florida/FL,1209501,"Orange County (Northwest) PUMA, Florida/FL",263,198,248,35,9,0,298,207,248,9,446,455,753,35,5,1,59,1,26,0,33,40,60,27,33
12,Florida/FL,1209502,"Orange County (West Central)--Winter Garden, Ocoee Cities & Oakland Town PUMA, Florida/FL",71,0,90,0,0,0,71,0,90,0,90,90,161,44,0,0,56,0,0,0,56,44,56,0,56
12,Florida/FL,1209503,"Orange County (Southwest)--Disney-International Drive Region PUMA, Florida/FL",23,0,29,0,0,0,23,0,29,0,29,29,52,44,0,0,56,0,0,0,56,44,56,0,56
12,Florida/FL,1209504,"Orange County (South Central)--Orlando City (South Central), Conway & Pine Castle PUMA, Florida/FL",134,0,223,110,12,75,244,12,298,87,223,310,554,24,20,16,40,2,0,14,40,44,56,2,54
12,Florida/FL,1209505,"Orange County (Central)--Orlando City (East Downtown) & Azalea Park PUMA, Florida/FL",10,14,83,90,0,0,100,14,83,0,97,97,197,5,46,0,49,0,7,0,42,51,49,7,42
12,Florida/FL,1209506,"Orange County (Central)--Orlando City (West Downtown) & Pine Hills (Southeast) PUMA, Florida/FL",86,0,0,7,22,0,93,22,0,22,0,22,115,75,6,19,0,19,0,0,0,81,19,19,0
12,Florida/FL,1209507,"Orange County (North Central)--Orlando (North), Winter Park & Maitland Cities PUMA, Florida/FL",26,0,0,0,15,0,26,15,0,15,0,15,41,63,0,37,0,37,0,0,0,63,37,37,0
12,Florida/FL,1209508,"Orange County (North Central)--Orlando City (Univ. of Central Florida) & Union Park PUMA, Florida/FL",73,0,0,10,0,11,83,0,11,11,0,11,94,78,11,12,0,0,0,12,0,88,12,0,12
12,Florida/FL,1209509,"Orange County (Southeast) PUMA, Florida/FL",86,0,45,103,23,0,189,23,45,23,45,68,257,33,40,9,18,9,0,0,18,74,26,9,18
12,Florida/FL,1209510,"Orange County (Northeast) PUMA, Florida/FL",116,143,0,17,0,12,133,143,12,12,143,155,288,40,6,4,50,0,50,4,0,46,54,50,4
12,Florida/FL,1209701,"Osceola County (West) PUMA, Florida/FL",92,101,0,149,0,0,241,101,0,0,101,101,342,27,44,0,30,0,30,0,0,70,30,30,0
12,Florida/FL,1209702,"Osceola County (East) PUMA, Florida/FL",224,0,8,170,0,0,394,0,8,0,8,8,402,56,42,0,2,0,0,0,2,98,2,0,2
12,Florida/FL,1209901,"Palm Beach County (Northeast) PUMA, Florida/FL",11,0,0,0,0,0,11,0,0,0,0,0,11,100,0,0,0,0,0,0,0,100,0,0,0
12,Florida/FL,1209902,"Palm Beach County (Northeast)--Palm Beach Gardens & Riviera Beach Cities PUMA, Florida/FL",108,0,50,7,11,0,115,11,50,11,50,61,176,61,4,6,28,6,0,0,28,65,35,6,28
12,Florida/FL,1209903,"Palm Beach County (East)--West Palm Beach City (Southeast) & Palm Beach Town PUMA, Florida/FL",98,107,156,81,14,18,179,121,174,32,263,295,474,21,17,7,55,3,23,4,33,38,62,26,37
12,Florida/FL,1209904,"Palm Beach County (East)--Greenacres City (North) & Palm Springs Village (North) PUMA, Florida/FL",11,99,241,55,31,18,66,130,259,49,340,389,455,2,12,11,75,7,22,4,53,15,85,29,57
12,Florida/FL,1209905,"Palm Beach County (East Central)--Lake Worth City, Lantana Town & Atlantis City PUMA, Florida/FL",65,41,443,33,0,216,98,41,659,216,484,700,798,8,4,27,61,0,5,27,56,12,88,5,83
12,Florida/FL,1209906,"Palm Beach County (East Central)--Greater Boynton Beach City (North) PUMA, Florida/FL",7,45,0,0,22,0,7,67,0,22,45,67,74,9,0,30,61,30,61,0,0,9,91,91,0
12,Florida/FL,1209907,"Palm Beach County (Southeast)--Greater Delray Beach City PUMA, Florida/FL",19,11,0,0,27,0,19,38,0,27,11,38,57,33,0,47,19,47,19,0,0,33,67,67,0
12,Florida/FL,1209908,"Palm Beach County (Southeast)--Boca Raton City & Highland Beach Town PUMA, Florida/FL",43,0,0,21,0,0,64,0,0,0,0,0,64,67,33,0,0,0,0,0,0,100,0,0,0
12,Florida/FL,1209909,"Palm Beach County (West of Boca Raton City) PUMA, Florida/FL",79,0,0,0,0,0,79,0,0,0,0,0,79,100,0,0,0,0,0,0,0,100,0,0,0
12,Florida/FL,1209910,"Palm Beach County (Central)--Wellington Village & Agricultural Reserve PUMA, Florida/FL",79,57,126,0,23,26,79,80,152,49,183,232,311,25,0,16,59,7,18,8,41,25,75,26,49
12,Florida/FL,1209911,"Palm Beach County (West)--Glades & Western Communities PUMA, Florida/FL",645,403,606,164,86,314,809,489,920,400,1009,1409,2218,29,7,18,45,4,18,14,27,36,64,22,41
12,Florida/FL,1210101,"Pasco County (East Central) PUMA, Florida/FL",238,0,316,155,0,0,393,0,316,0,316,316,709,34,22,0,45,0,0,0,45,55,45,0,45
12,Florida/FL,1210102,"Pasco County (West Central) PUMA, Florida/FL",23,0,0,0,0,0,23,0,0,0,0,0,23,100,0,0,0,0,0,0,0,100,0,0,0
12,Florida/FL,1210103,"Pasco County (Gulf Coast) PUMA, Florida/FL",21,0,15,0,11,4,21,11,19,15,15,30,51,41,0,29,29,22,0,8,29,41,59,22,37
12,Florida/FL,1210104,"Pasco County (South) PUMA, Florida/FL",149,72,0,0,0,0,149,72,0,0,72,72,221,67,0,0,33,0,33,0,0,67,33,33,0
12,Florida/FL,1210301,"Pinellas County (North) PUMA, Florida/FL",28,0,0,0,0,0,28,0,0,0,0,0,28,100,0,0,0,0,0,0,0,100,0,0,0
12,Florida/FL,1210302,"Pinellas County (North Central) PUMA, Florida/FL",39,0,0,0,0,0,39,0,0,0,0,0,39,100,0,0,0,0,0,0,0,100,0,0,0
12,Florida/FL,1210303,"Pinellas County (Central)--Clearwater City (South & Central) PUMA, Florida/FL",113,0,0,0,0,16,113,0,16,16,0,16,129,88,0,12,0,0,0,12,0,88,12,0,12
12,Florida/FL,1210304,"Pinellas County (Central)--Greater Largo City PUMA, Florida/FL",0,0,0,42,0,0,42,0,0,0,0,0,42,0,100,0,0,0,0,0,0,100,0,0,0
12,Florida/FL,1210305,"Pinellas County (West Central)--Greater Seminole City PUMA, Florida/FL",36,0,27,0,0,0,36,0,27,0,27,27,63,57,0,0,43,0,0,0,43,57,43,0,43
12,Florida/FL,1210306,"Pinellas County (Central)--Greater Pinellas Park City PUMA, Florida/FL",0,0,14,0,52,2,0,52,16,54,14,68,68,0,0,79,21,76,0,3,21,0,100,76,24
12,Florida/FL,1210307,"Pinellas County (Southeast)--St. Petersburg City (East) PUMA, Florida/FL",161,0,0,0,0,0,161,0,0,0,0,0,161,100,0,0,0,0,0,0,0,100,0,0,0
12,Florida/FL,1210308,"Pinellas County (South Central)--St. Petersburg City (West) PUMA, Florida/FL",69,0,0,0,0,0,69,0,0,0,0,0,69,100,0,0,0,0,0,0,0,100,0,0,0
12,Florida/FL,1210501,"Polk County (Northwest) PUMA, Florida/FL",227,97,323,82,0,28,309,97,351,28,420,448,757,30,11,4,55,0,13,4,43,41,59,13,46
12,Florida/FL,1210502,"Polk County (Northeast) PUMA, Florida/FL",392,42,70,191,21,50,583,63,120,71,112,183,766,51,25,9,15,3,5,7,9,76,24,8,16
12,Florida/FL,1210503,"Polk County (Central) PUMA, Florida/FL",225,14,461,445,0,106,670,14,567,106,475,581,1251,18,36,8,38,0,1,8,37,54,46,1,45
12,Florida/FL,1210504,"Polk County (South) PUMA, Florida/FL",627,15,747,159,0,33,786,15,780,33,762,795,1581,40,10,2,48,0,1,2,47,50,50,1,49
12,Florida/FL,1210700,"Putnam & St. Johns (South) Counties PUMA, Florida/FL",404,71,456,145,0,22,549,71,478,22,527,549,1098,37,13,2,48,0,6,2,42,50,50,6,44
12,Florida/FL,1210900,"St. Johns County (North) PUMA, Florida/FL",214,45,0,96,0,0,310,45,0,0,45,45,355,60,27,0,13,0,13,0,0,87,13,13,0
12,Florida/FL,1211101,"St. Lucie County (North) PUMA, Florida/FL",125,35,241,0,46,123,125,81,364,169,276,445,570,22,0,30,48,8,6,22,42,22,78,14,64
12,Florida/FL,1211102,"St. Lucie County (South) PUMA, Florida/FL",136,0,0,0,0,0,136,0,0,0,0,0,136,100,0,0,0,0,0,0,0,100,0,0,0
12,Florida/FL,1211300,"Santa Rosa County PUMA, Florida/FL",239,0,42,0,7,0,239,7,42,7,42,49,288,83,0,2,15,2,0,0,15,83,17,2,15
12,Florida/FL,1211501,"Sarasota County (North) PUMA, Florida/FL",433,0,89,36,0,0,469,0,89,0,89,89,558,78,6,0,16,0,0,0,16,84,16,0,16
12,Florida/FL,1211502,"Sarasota County (Central & Gulf Coast) PUMA, Florida/FL",77,11,141,26,0,16,103,11,157,16,152,168,271,28,10,6,56,0,4,6,52,38,62,4,58
12,Florida/FL,1211503,"Sarasota County (East) PUMA, Florida/FL",7,0,4,0,0,0,7,0,4,0,4,4,11,64,0,0,36,0,0,0,36,64,36,0,36
12,Florida/FL,1211701,"Seminole County (West) PUMA, Florida/FL",47,0,58,0,0,9,47,0,67,9,58,67,114,41,0,8,51,0,0,8,51,41,59,0,59
12,Florida/FL,1211702,"Seminole County (North Central) PUMA, Florida/FL",119,0,124,164,15,0,283,15,124,15,124,139,422,28,39,4,29,4,0,0,29,67,33,4,29
12,Florida/FL,1211703,"Seminole County (South Central) PUMA, Florida/FL",61,0,18,26,0,0,87,0,18,0,18,18,105,58,25,0,17,0,0,0,17,83,17,0,17
12,Florida/FL,1211704,"Seminole County (East) PUMA, Florida/FL",0,0,33,0,0,0,0,0,33,0,33,33,33,0,0,0,100,0,0,0,100,0,100,0,100
12,Florida/FL,1212100,"Suwannee, Taylor, Madison, Hamilton & Lafayette Counties PUMA, Florida/FL",1310,62,223,175,0,49,1485,62,272,49,285,334,1819,72,10,3,16,0,3,3,12,82,18,3,15
12,Florida/FL,1212701,"Volusia County (Central & Northwest)--DeLand, DeBary Cities & Pierson Town PUMA, Florida/FL",130,63,280,124,0,0,254,63,280,0,343,343,597,22,21,0,57,0,11,0,47,43,57,11,47
12,Florida/FL,1212702,"Volusia County (Northeast)--Daytona Beach, Ormond Beach & Holly Hill Cities PUMA, Florida/FL",0,0,40,0,0,0,0,0,40,0,40,40,40,0,0,0,100,0,0,0,100,0,100,0,100
12,Florida/FL,1212703,"Volusia County--Port Orange, Edgewater, New Smyrna Beach (East) & Oak Hill Cities PUMA, Florida/FL",291,0,17,0,9,0,291,9,17,9,17,26,317,92,0,3,5,3,0,0,5,92,8,3,5
12,Florida/FL,1212704,"Volusia County (Southwest Central)--Deltona & Lake Helen Cities PUMA, Florida/FL",141,35,36,44,38,38,185,73,74,76,71,147,332,42,13,23,21,11,11,11,11,56,44,22,22
13,Georgia/GA,1300100,"Coastal Regional Commission (South)--Glynn Camden & McIntosh Counties PUMA, Georgia/GA",612,0,35,122,13,0,734,13,35,13,35,48,782,78,16,2,4,2,0,0,4,94,6,2,4
13,Georgia/GA,1300200,"Coastal Regional Commission (West)--Liberty, Bryan & Long Counties PUMA, Georgia/GA",96,0,151,0,0,12,96,0,163,12,151,163,259,37,0,5,58,0,0,5,58,37,63,0,63
13,Georgia/GA,1300300,"Coastal Regional Commission (North)--Bulloch, Effingham & Screven Counties PUMA, Georgia/GA",661,0,127,17,219,0,678,219,127,219,127,346,1024,65,2,21,12,21,0,0,12,66,34,21,12
13,Georgia/GA,1300401,"Coastal Regional Commission (East)--Chatham County (West Central)--Savannah City PUMA, Georgia/GA",397,0,15,0,0,0,397,0,15,0,15,15,412,96,0,0,4,0,0,0,4,96,4,0,4
13,Georgia/GA,1300402,"Coastal Regional Commission (East)--Chatham County (East & Outside Savannah City) PUMA, Georgia/GA",55,0,0,0,0,0,55,0,0,0,0,0,55,100,0,0,0,0,0,0,0,100,0,0,0
13,Georgia/GA,1300500,"Southern Georgia Regional Commission (East & Central) PUMA, Georgia/GA",1541,74,496,446,0,179,1987,74,675,179,570,749,2736,56,16,7,21,0,3,7,18,73,27,3,25
13,Georgia/GA,1300600,"Southern Georgia Regional Commission (South Central)--Lowndes County--Valdosta City PUMA, Georgia/GA",304,58,163,82,0,0,386,58,163,0,221,221,607,50,14,0,36,0,10,0,27,64,36,10,27
13,Georgia/GA,1300700,"Southern Georgia Regional Commission (West) PUMA, Georgia/GA",1075,117,734,157,9,0,1232,126,734,9,851,860,2092,51,8,0,41,0,6,0,35,59,41,6,35
13,Georgia/GA,1300800,"Southwest Georgia Regional Commission (East)--Colquitt, Thomas & Worth Counties PUMA, Georgia/GA",1446,35,1789,107,0,39,1553,35,1828,39,1824,1863,3416,42,3,1,53,0,1,1,52,45,55,1,54
13,Georgia/GA,1300900,"Southwest Georgia Regional Commission (North Central)--Dougherty & Lee Counties PUMA, Georgia/GA",1340,0,106,57,45,0,1397,45,106,45,106,151,1548,87,4,3,7,3,0,0,7,90,10,3,7
13,Georgia/GA,1301001,"Atlanta Regional Commission (Central)--Fulton County (North)--Sandy Springs City PUMA, Georgia/GA",18,0,0,0,0,0,18,0,0,0,0,0,18,100,0,0,0,0,0,0,0,100,0,0,0
13,Georgia/GA,1301002,"Atlanta Regional Commission (Central)--Fulton County (Northeast)--Johns Creek City PUMA, Georgia/GA",0,0,0,0,22,0,0,22,0,22,0,22,22,0,0,100,0,100,0,0,0,0,100,100,0
13,Georgia/GA,1301003,"Atlanta Regional Commission (Central)--Fulton County (Central)--Atlanta City (South) PUMA, Georgia/GA",169,0,75,60,0,0,229,0,75,0,75,75,304,56,20,0,25,0,0,0,25,75,25,0,25
13,Georgia/GA,1301004,"Atlanta Regional Commission (Central)--Fulton County (South)--Union & Fairburn Cities PUMA, Georgia/GA",172,0,0,7,0,0,179,0,0,0,0,0,179,96,4,0,0,0,0,0,0,100,0,0,0
13,Georgia/GA,1301005,"Atlanta Regional Commission (Central)--Fulton County (Northwest)--Roswell City PUMA, Georgia/GA",237,0,258,0,0,13,237,0,271,13,258,271,508,47,0,3,51,0,0,3,51,47,53,0,53
13,Georgia/GA,1301006,"Atlanta Regional Commission (Central)--Fulton County (Central)--Atlanta City (North) PUMA, Georgia/GA",82,0,0,0,0,0,82,0,0,0,0,0,82,100,0,0,0,0,0,0,0,100,0,0,0
13,Georgia/GA,1301007,"Atlanta Regional Commission (Central)--Fulton County (East)--Atlanta City (Southeast) PUMA, Georgia/GA",79,0,0,0,10,0,79,10,0,10,0,10,89,89,0,11,0,11,0,0,0,89,11,11,0
13,Georgia/GA,1301008,"Atlanta Regional Commission (Central)--DeKalb County (South) PUMA, Georgia/GA",318,0,0,0,0,0,318,0,0,0,0,0,318,100,0,0,0,0,0,0,0,100,0,0,0
13,Georgia/GA,1301100,"Southwest Georgia Regional Commission (West & Central) PUMA, Georgia/GA",2435,0,575,24,0,0,2459,0,575,0,575,575,3034,80,1,0,19,0,0,0,19,81,19,0,19
13,Georgia/GA,1301200,"Heart of Georgia Altamaha Regional Commission (Southeast) PUMA, Georgia/GA",1462,54,891,413,0,15,1875,54,906,15,945,960,2835,52,15,1,33,0,2,1,31,66,34,2,32
13,Georgia/GA,1301300,"Heart of Georgia Altamaha Regional Commission (North & West) PUMA, Georgia/GA",817,28,131,78,0,0,895,28,131,0,159,159,1054,78,7,0,15,0,3,0,12,85,15,3,12
13,Georgia/GA,1301400,"Middle Georgia Regional Commission (Central)--Bibb County--Macon City PUMA, Georgia/GA",509,0,8,0,0,16,509,0,24,16,8,24,533,95,0,3,2,0,0,3,2,95,5,0,5
13,Georgia/GA,1301500,"Middle Georgia Regional Commission (South)--Houston & Pulaski Counties PUMA, Georgia/GA",1380,0,0,17,42,35,1397,42,35,77,0,77,1474,94,1,5,0,3,0,2,0,95,5,3,2
13,Georgia/GA,1301600,"Middle Georgia Regional Commission (North & Outside Bibb County) PUMA, Georgia/GA",783,0,235,72,0,8,855,0,243,8,235,243,1098,71,7,1,21,0,0,1,21,78,22,0,22
13,Georgia/GA,1301700,"River Valley Regional Commission (West Central)--Muscogee & Chattahoochee Counties PUMA, Georgia/GA",1298,13,0,35,0,45,1333,13,45,45,13,58,1391,93,3,3,1,0,1,3,0,96,4,1,3
13,Georgia/GA,1301800,"River Valley Regional Commission (Outside Muscogee & Chattahoochee Counties) PUMA, Georgia/GA",2618,44,202,135,0,32,2753,44,234,32,246,278,3031,86,4,1,8,0,1,1,7,91,9,1,8
13,Georgia/GA,1301900,"Three Rivers Regional Commission (East) PUMA, Georgia/GA",277,0,5,8,0,0,285,0,5,0,5,5,290,96,3,0,2,0,0,0,2,98,2,0,2
13,Georgia/GA,1302001,"Atlanta Regional Commission (Central)--DeKalb County (East Central)--Redan PUMA, Georgia/GA",493,31,12,0,60,61,493,91,73,121,43,164,657,75,0,18,7,9,5,9,2,75,25,14,11
13,Georgia/GA,1302002,"Atlanta Regional Commission--DeKalb County--Decatur & Avondale Estates Cities PUMA, Georgia/GA",347,0,2,11,0,66,358,0,68,66,2,68,426,81,3,15,0,0,0,15,0,84,16,0,16
13,Georgia/GA,1302003,"Atlanta Regional Commission (Central)--DeKalb County (Northeast)--Tucker PUMA, Georgia/GA",304,23,59,20,97,2061,324,120,2120,2158,82,2240,2564,12,1,84,3,4,1,80,2,13,87,5,83
13,Georgia/GA,1302004,"Atlanta Regional Commission--DeKalb County (North)--Dunwoody City PUMA, Georgia/GA",11,33,53,0,39,33,11,72,86,72,86,158,169,7,0,43,51,23,20,20,31,7,93,43,51
13,Georgia/GA,1302100,"Three Rivers Regional Commission (North Central)--Coweta County PUMA, Georgia/GA",95,0,62,0,0,21,95,0,83,21,62,83,178,53,0,12,35,0,0,12,35,53,47,0,47
13,Georgia/GA,1302200,"Three Rivers Regional Commission (Southwest)--Troup, Meriwether & Heard Counties PUMA, Georgia/GA",234,0,88,0,8,18,234,8,106,26,88,114,348,67,0,7,25,2,0,5,25,67,33,2,30
13,Georgia/GA,1302300,"Three Rivers Regional Commission (Northwest)--Carroll County PUMA, Georgia/GA",1044,0,68,0,0,0,1044,0,68,0,68,68,1112,94,0,0,6,0,0,0,6,94,6,0,6
13,Georgia/GA,1302400,"Atlanta Regional Commission (South Central)--Fayette County PUMA, Georgia/GA",62,0,0,0,0,0,62,0,0,0,0,0,62,100,0,0,0,0,0,0,0,100,0,0,0
13,Georgia/GA,1302500,"Northwest Georgia Regional Commission (Southwest)--Floyd, Polk & Haralson Counties PUMA, Georgia/GA",607,0,189,71,19,0,678,19,189,19,189,208,886,69,8,2,21,2,0,0,21,77,23,2,21
13,Georgia/GA,1302600,"Northwest Georgia Regional Commission--Walker, Catoosa, Chattooga & Dade Counties PUMA, Georgia/GA",734,0,23,0,0,13,734,0,36,13,23,36,770,95,0,2,3,0,0,2,3,95,5,0,5
13,Georgia/GA,1302700,"Northwest Georgia Regional Commission (North Central)--Whitfield County PUMA, Georgia/GA",58,26,200,0,0,0,58,26,200,0,226,226,284,20,0,0,80,0,9,0,70,20,80,9,70
13,Georgia/GA,1302800,"Northwest Georgia Regional Commission (Northeast) PUMA, Georgia/GA",1075,202,281,26,0,22,1101,202,303,22,483,505,1606,67,2,1,30,0,13,1,17,69,31,13,19
13,Georgia/GA,1302900,"Northwest Georgia Regional Commission (East Central)--Bartow County PUMA, Georgia/GA",307,0,18,51,0,0,358,0,18,0,18,18,376,82,14,0,5,0,0,0,5,95,5,0,5
13,Georgia/GA,1303001,"Atlanta Regional Commission (Northwest)--Cobb County (Central)--Marietta City PUMA, Georgia/GA",155,0,174,36,0,41,191,0,215,41,174,215,406,38,9,10,43,0,0,10,43,47,53,0,53
13,Georgia/GA,1303002,"Atlanta Regional Commission--Cobb County (Northwest)--Kennesaw & Acworth Cities PUMA, Georgia/GA",164,0,38,13,0,23,177,0,61,23,38,61,238,69,5,10,16,0,0,10,16,74,26,0,26
13,Georgia/GA,1303003,"Atlanta Regional Commission (Northwest)--Cobb County (Southwest)--Powder Springs City PUMA, Georgia/GA",66,0,0,22,23,0,88,23,0,23,0,23,111,59,20,21,0,21,0,0,0,79,21,21,0
13,Georgia/GA,1303004,"Atlanta Regional Commission (Northwest)--Cobb County (Southeast)--Smyrna City PUMA, Georgia/GA",94,34,65,72,54,21,166,88,86,75,99,174,340,28,21,22,29,16,10,6,19,49,51,26,25
13,Georgia/GA,1303005,"Atlanta Regional Commission (Northwest)--Cobb County (Northeast) PUMA, Georgia/GA",43,0,0,17,0,0,60,0,0,0,0,0,60,72,28,0,0,0,0,0,0,100,0,0,0
13,Georgia/GA,1303101,"Atlanta Regional Commission--Cherokee County (Central)--Woodstock & Canton Cities PUMA, Georgia/GA",17,89,200,120,0,11,137,89,211,11,289,300,437,4,27,3,66,0,20,3,46,31,69,20,48
13,Georgia/GA,1303102,"Atlanta Regional Commission--Cherokee County (Outside Woodstock & Canton Cities) PUMA, Georgia/GA",97,0,0,65,0,0,162,0,0,0,0,0,162,60,40,0,0,0,0,0,0,100,0,0,0
13,Georgia/GA,1303200,"Georgia Mountains Regional Commission (North & Northwest) PUMA, Georgia/GA",698,0,216,0,0,0,698,0,216,0,216,216,914,76,0,0,24,0,0,0,24,76,24,0,24
13,Georgia/GA,1303300,"Georgia Mountains Regional Commission (Southwest)--Forsyth County PUMA, Georgia/GA",241,20,273,12,0,8,253,20,281,8,293,301,554,44,2,1,53,0,4,1,49,46,54,4,51
13,Georgia/GA,1303400,"Georgia Mountains Regional Commission (South Central)--Hall County PUMA, Georgia/GA",1101,342,4193,305,126,211,1406,468,4404,337,4535,4872,6278,18,5,5,72,2,5,3,67,22,78,7,70
13,Georgia/GA,1303500,"Georgia Mountains Regional Commission (Southeast) PUMA, Georgia/GA",998,49,667,44,0,7,1042,49,674,7,716,723,1765,57,2,0,41,0,3,0,38,59,41,3,38
13,Georgia/GA,1303600,"Northeast Georgia Regional Commission (Central)--Clarke County--Athens City PUMA, Georgia/GA",772,150,71,88,0,28,860,150,99,28,221,249,1109,70,8,3,20,0,14,3,6,78,22,14,9
13,Georgia/GA,1303700,"Northeast Georgia Regional Commission (East) PUMA, Georgia/GA",838,20,28,111,0,13,949,20,41,13,48,61,1010,83,11,1,5,0,2,1,3,94,6,2,4
13,Georgia/GA,1303800,"Northeast Georgia Regional Commission (Northwest)--Barrow & Jackson Counties PUMA, Georgia/GA",543,9,139,0,24,0,543,33,139,24,148,172,715,76,0,3,21,3,1,0,19,76,24,5,19
13,Georgia/GA,1303900,"Northeast Georgia Regional Commission (Southwest)--Walton, Morgan & Jasper Counties PUMA, Georgia/GA",484,0,72,0,0,0,484,0,72,0,72,72,556,87,0,0,13,0,0,0,13,87,13,0,13
13,Georgia/GA,1304000,"Central Savannah River Area Regional Commission (East Central)--Richmond County PUMA, Georgia/GA",881,0,4,31,69,0,912,69,4,69,4,73,985,89,3,7,0,7,0,0,0,93,7,7,0
13,Georgia/GA,1304001,"Atlanta Regional Commission (Northeast)--Gwinnett County (West Central)--Duluth City PUMA, Georgia/GA",87,21,87,87,12,8,174,33,95,20,108,128,302,29,29,7,36,4,7,3,29,58,42,11,31
13,Georgia/GA,1304002,"Atlanta Regional Commission (Northeast)--Gwinnett County (North)--Sugar Hill City PUMA, Georgia/GA",108,0,27,0,27,0,108,27,27,27,27,54,162,67,0,17,17,17,0,0,17,67,33,17,17
13,Georgia/GA,1304003,"Atlanta Regional Commission--Gwinnett County (Central)--Lawrenceville City PUMA, Georgia/GA",65,105,299,36,28,23,101,133,322,51,404,455,556,12,6,9,73,5,19,4,54,18,82,24,58
13,Georgia/GA,1304004,"Atlanta Regional Commission (Northeast)--Gwinnett County (East) PUMA, Georgia/GA",257,0,2,0,18,15,257,18,17,33,2,35,292,88,0,11,1,6,0,5,1,88,12,6,6
13,Georgia/GA,1304005,"Atlanta Regional Commission (Northeast)--Gwinnett County (South)--Snellville City PUMA, Georgia/GA",240,0,111,23,86,26,263,86,137,112,111,223,486,49,5,23,23,18,0,5,23,54,46,18,28
13,Georgia/GA,1304006,"Atlanta Regional Commission (Northeast)--Gwinnett County (Southwest)--Lilburn City PUMA, Georgia/GA",225,59,273,74,101,54,299,160,327,155,332,487,786,29,9,20,42,13,8,7,35,38,62,20,42
13,Georgia/GA,1304100,"Central Savannah River Area Regional Commission (East Central)--Columbia County PUMA, Georgia/GA",19,0,4,51,0,0,70,0,4,0,4,4,74,26,69,0,5,0,0,0,5,95,5,0,5
13,Georgia/GA,1304200,"Central Savannah River Area Regional Commission (West & Outside Richmond & Columbia) PUMA, Georgia/GA",1172,0,438,14,0,0,1186,0,438,0,438,438,1624,72,1,0,27,0,0,0,27,73,27,0,27
13,Georgia/GA,1304300,"Atlanta & Northeast Georgia Regional Commissions--Newton & Rockdale Counties PUMA, Georgia/GA",522,0,19,14,8,13,536,8,32,21,19,40,576,91,2,4,3,1,0,2,3,93,7,1,6
13,Georgia/GA,1304400,"Atlanta Regional Commission (Southwest)--Douglas County PUMA, Georgia/GA",256,100,30,0,95,86,256,195,116,181,130,311,567,45,0,32,23,17,18,15,5,45,55,34,20
13,Georgia/GA,1304500,"Northwest Georgia Regional Commission (Southeast)--Paulding County PUMA, Georgia/GA",238,0,0,0,0,17,238,0,17,17,0,17,255,93,0,7,0,0,0,7,0,93,7,0,7
13,Georgia/GA,1304600,"Atlanta Regional Commission--Fulton County (Central)--Atlanta City (Central) PUMA, Georgia/GA",458,0,0,14,0,0,472,0,0,0,0,0,472,97,3,0,0,0,0,0,0,100,0,0,0
13,Georgia/GA,1305001,"Atlanta Regional Commission (South Central)--Clayton County (South) PUMA, Georgia/GA",370,0,47,0,14,0,370,14,47,14,47,61,431,86,0,3,11,3,0,0,11,86,14,3,11
13,Georgia/GA,1305002,"Atlanta Regional Commission (South Central)--Clayton County (North)--Forest Park City PUMA, Georgia/GA",289,79,116,2,104,37,291,183,153,141,195,336,627,46,0,22,31,17,13,6,19,46,54,29,24
13,Georgia/GA,1306001,"Atlanta Regional Commission (Southeast)--Henry County (South)--McDonough City PUMA, Georgia/GA",280,0,18,87,58,0,367,58,18,58,18,76,443,63,20,13,4,13,0,0,4,83,17,13,4
13,Georgia/GA,1306002,"Atlanta Regional Commission (Southeast)--Henry County (North)--Stockbridge City PUMA, Georgia/GA",283,0,0,0,51,0,283,51,0,51,0,51,334,85,0,15,0,15,0,0,0,85,15,15,0
15,Hawaii/HI,1500100,"Maui, Kalawao & Kauai Counties PUMA, Hawaii/HI",547,0,25,70,231,421,617,231,446,652,25,677,1294,42,5,50,2,18,0,33,2,48,52,18,34
15,Hawaii/HI,1500200,"Hawaii County PUMA, Hawaii/HI",1226,98,138,93,229,423,1319,327,561,652,236,888,2207,56,4,30,11,10,4,19,6,60,40,15,25
15,Hawaii/HI,1500301,"Honolulu County--Rural Oahu PUMA, Hawaii/HI",271,0,12,18,11,28,289,11,40,39,12,51,340,80,5,11,4,3,0,8,4,85,15,3,12
15,Hawaii/HI,1500302,"Honolulu County--Koolaupoko PUMA, Hawaii/HI",176,0,0,21,42,18,197,42,18,60,0,60,257,68,8,23,0,16,0,7,0,77,23,16,7
15,Hawaii/HI,1500303,"Honolulu County--East Honolulu to Kapahulu PUMA, Hawaii/HI",68,0,0,0,13,0,68,13,0,13,0,13,81,84,0,16,0,16,0,0,0,84,16,16,0
15,Hawaii/HI,1500304,"Honolulu County--Tantalus to Waikiki PUMA, Hawaii/HI",128,0,0,0,14,38,128,14,38,52,0,52,180,71,0,29,0,8,0,21,0,71,29,8,21
15,Hawaii/HI,1500305,"Honolulu County--Nuuanu to Kalihi PUMA, Hawaii/HI",70,0,0,45,123,296,115,123,296,419,0,419,534,13,8,78,0,23,0,55,0,22,78,23,55
15,Hawaii/HI,1500306,"Honolulu County--Moanalua to Pearl City PUMA, Hawaii/HI",106,0,0,0,117,126,106,117,126,243,0,243,349,30,0,70,0,34,0,36,0,30,70,34,36
15,Hawaii/HI,1500307,"Honolulu County--Central Oahu PUMA, Hawaii/HI",178,0,0,0,172,155,178,172,155,327,0,327,505,35,0,65,0,34,0,31,0,35,65,34,31
15,Hawaii/HI,1500308,"Honolulu County--Ewa PUMA, Hawaii/HI",127,0,0,0,186,226,127,186,226,412,0,412,539,24,0,76,0,35,0,42,0,24,76,35,42
16,Idaho/ID,1600100,"Bonner, Latah, Shoshone, Boundary, Benewah & Kootenai (Southeast) Counties PUMA, Idaho/ID",788,19,0,78,0,0,866,19,0,0,19,19,885,89,9,0,2,0,2,0,0,98,2,2,0
16,Idaho/ID,1600200,"Kootenai County (Northwest)--Coeur d'Alene, Post Falls & Hayden Cities PUMA, Idaho/ID",539,0,5,42,0,0,581,0,5,0,5,5,586,92,7,0,1,0,0,0,1,99,1,0,1
16,Idaho/ID,1600300,"Central Idaho--Lewiston City & Nez Perce Reservation PUMA, Idaho/ID",760,3,111,120,0,19,880,3,130,19,114,133,1013,75,12,2,11,0,0,2,11,87,13,0,13
16,Idaho/ID,1600400,"Ada (North), Payette, Canyon (North), Gem & Washington Counties--Eagle City PUMA, Idaho/ID",1169,296,883,249,23,0,1418,319,883,23,1179,1202,2620,45,10,1,45,1,11,0,34,54,46,12,34
16,Idaho/ID,1600500,"Canyon (South) & Owyhee Counties--Caldwell & Nampa (South & West) Cities PUMA, Idaho/ID",930,508,1911,571,0,7,1501,508,1918,7,2419,2426,3927,24,15,0,62,0,13,0,49,38,62,13,49
16,Idaho/ID,1600600,"Canyon (East) & Ada (West) Counties--Nampa (Central & East) & Meridian (West) Cities PUMA, Idaho/ID",390,87,351,283,0,0,673,87,351,0,438,438,1111,35,25,0,39,0,8,0,32,61,39,8,32
16,Idaho/ID,1600701,"Ada County (Central)--Meridian (Northeast) & Boise (Far West) Cities PUMA, Idaho/ID",205,0,0,93,53,0,298,53,0,53,0,53,351,58,26,15,0,15,0,0,0,85,15,15,0
16,Idaho/ID,1600702,"Ada County (Northeast)--Boise (North & West) & Garden City Cities PUMA, Idaho/ID",186,0,219,207,35,94,393,35,313,129,219,348,741,25,28,17,30,5,0,13,30,53,47,5,42
16,Idaho/ID,1600800,"Ada County (South)--Boise (South) & Kuna Cities PUMA, Idaho/ID",195,30,0,31,0,56,226,30,56,56,30,86,312,62,10,18,10,0,10,18,0,72,28,10,18
16,Idaho/ID,1600900,"Twin Falls & Cassia Counties--Twin Falls City PUMA, Idaho/ID",1772,511,2119,397,29,29,2169,540,2148,58,2630,2688,4857,36,8,1,54,1,11,1,44,45,55,11,44
16,Idaho/ID,1601000,"Elmore, Jerome, Blaine, Minidoka, Gooding, Lincoln & Camas Counties PUMA, Idaho/ID",2340,533,3014,723,10,37,3063,543,3051,47,3547,3594,6657,35,11,1,53,0,8,1,45,46,54,8,46
16,Idaho/ID,1601100,"Bingham (Outside Fort Hall AIR), Madison, Jefferson, Fremont & Teton Counties PUMA, Idaho/ID",1831,358,873,385,0,0,2216,358,873,0,1231,1231,3447,53,11,0,36,0,10,0,25,64,36,10,25
16,Idaho/ID,1601200,"Bonneville County--Idaho Falls City PUMA, Idaho/ID",836,109,402,62,0,0,898,109,402,0,511,511,1409,59,4,0,36,0,8,0,29,64,36,8,29
16,Idaho/ID,1601300,"Southeast Idaho--Pocatello, Chubbuck Cities & Fort Hall Reservation PUMA, Idaho/ID",1197,85,778,329,25,0,1526,110,778,25,863,888,2414,50,14,1,36,1,4,0,32,63,37,5,32
17,Illinois/IL,1700104,"Jo Daviess, Carroll, Whiteside & Lee Counties PUMA, Illinois/IL",1431,13,50,156,57,0,1587,70,50,57,63,120,1707,84,9,3,4,3,1,0,3,93,7,4,3
17,Illinois/IL,1700105,"Rock Island County PUMA, Illinois/IL",341,0,333,17,335,843,358,335,1176,1178,333,1511,1869,18,1,63,18,18,0,45,18,19,81,18,63
17,Illinois/IL,1700202,"Henry, Mercer, Henderson, Warren, Hancock, McDonough & Fulton Counties PUMA, Illinois/IL",2009,26,128,52,5,45,2061,31,173,50,154,204,2265,89,2,2,7,0,1,2,6,91,9,1,8
17,Illinois/IL,1700300,"Adams, Pike, Brown, Schuyler & Mason Counties PUMA, Illinois/IL",1473,4,17,0,21,103,1473,25,120,124,21,145,1618,91,0,8,1,1,0,6,1,91,9,2,7
17,Illinois/IL,1700401,"Cass, Morgan, Scott, Greene, Macoupin, Jersey & Calhoun Counties PUMA, Illinois/IL",1704,191,362,40,49,40,1744,240,402,89,553,642,2386,71,2,4,23,2,8,2,15,73,27,10,17
17,Illinois/IL,1700501,"Montgomery, Bond, Clinton, Fayette & Effingham Counties PUMA, Illinois/IL",1190,0,27,31,0,0,1221,0,27,0,27,27,1248,95,2,0,2,0,0,0,2,98,2,0,2
17,Illinois/IL,1700600,"Douglas, Edgar, Coles & Cumberland Counties PUMA, Illinois/IL",1182,0,15,0,0,0,1182,0,15,0,15,15,1197,99,0,0,1,0,0,0,1,99,1,0,1
17,Illinois/IL,1700700,"Clark, Jasper, Crawford, Lawrence, Richland, Clay & Wayne Counties PUMA, Illinois/IL",1183,0,0,68,27,0,1251,27,0,27,0,27,1278,93,5,2,0,2,0,0,0,98,2,2,0
17,Illinois/IL,1700800,"South & Southeast Illinois PUMA, Illinois/IL",963,23,72,0,0,0,963,23,72,0,95,95,1058,91,0,0,9,0,2,0,7,91,9,2,7
17,Illinois/IL,1700900,"Jackson, Williamson, Franklin & Perry Counties PUMA, Illinois/IL",989,0,9,0,0,0,989,0,9,0,9,9,998,99,0,0,1,0,0,0,1,99,1,0,1
17,Illinois/IL,1701001,"Monroe, Randolph, Washington, Jefferson & Marion Counties PUMA, Illinois/IL",1476,0,7,13,0,0,1489,0,7,0,7,7,1496,99,1,0,0,0,0,0,0,100,0,0,0
17,Illinois/IL,1701104,"St. Clair County (Central & Northeast) PUMA, Illinois/IL",256,27,54,0,0,0,256,27,54,0,81,81,337,76,0,0,24,0,8,0,16,76,24,8,16
17,Illinois/IL,1701105,"St. Clair County (Northwest, Southwest & Southeast) PUMA, Illinois/IL",310,0,0,0,0,0,310,0,0,0,0,0,310,100,0,0,0,0,0,0,0,100,0,0,0
17,Illinois/IL,1701204,"Madison County (East) PUMA, Illinois/IL",271,17,0,0,0,5,271,17,5,5,17,22,293,92,0,2,6,0,6,2,0,92,8,6,2
17,Illinois/IL,1701205,"Madison County (West)--Granite City, Alton, Wood River Cities & Godfrey Village PUMA, Illinois/IL",397,0,0,26,0,0,423,0,0,0,0,0,423,94,6,0,0,0,0,0,0,100,0,0,0
17,Illinois/IL,1701300,"Sangamon County--Springfield City PUMA, Illinois/IL",623,32,0,0,0,70,623,32,70,70,32,102,725,86,0,10,4,0,4,10,0,86,14,4,10
17,Illinois/IL,1701500,"Macon County--Decatur City PUMA, Illinois/IL",1267,0,0,0,0,0,1267,0,0,0,0,0,1267,100,0,0,0,0,0,0,0,100,0,0,0
17,Illinois/IL,1701602,"Menard, Logan, De Witt, Piatt, Moultrie, Shelby & Christian Counties PUMA, Illinois/IL",1599,0,0,39,16,0,1638,16,0,16,0,16,1654,97,2,1,0,1,0,0,0,99,1,1,0
17,Illinois/IL,1701701,"Peoria County--Peoria City PUMA, Illinois/IL",359,0,26,88,0,0,447,0,26,0,26,26,473,76,19,0,5,0,0,0,5,95,5,0,5
17,Illinois/IL,1701900,"Tazewell County PUMA, Illinois/IL",431,0,0,3,0,0,434,0,0,0,0,0,434,99,1,0,0,0,0,0,0,100,0,0,0
17,Illinois/IL,1702000,"McLean County PUMA, Illinois/IL",552,9,22,31,5,0,583,14,22,5,31,36,619,89,5,1,5,1,1,0,4,94,6,2,4
17,Illinois/IL,1702100,"Champaign County--Champaign & Urbana Cities PUMA, Illinois/IL",1116,0,0,33,0,30,1149,0,30,30,0,30,1179,95,3,3,0,0,0,3,0,97,3,0,3
17,Illinois/IL,1702200,"Livingston, Ford, Iroquois & Vermilion Counties PUMA, Illinois/IL",1839,51,105,91,8,0,1930,59,105,8,156,164,2094,88,4,0,7,0,2,0,5,92,8,3,5
17,Illinois/IL,1702300,"Kankakee County PUMA, Illinois/IL",442,52,387,195,0,31,637,52,418,31,439,470,1107,40,18,3,40,0,5,3,35,58,42,5,38
17,Illinois/IL,1702400,"LaSalle County PUMA, Illinois/IL",471,42,161,66,0,27,537,42,188,27,203,230,767,61,9,4,26,0,5,4,21,70,30,5,25
17,Illinois/IL,1702501,"Knox, Stark, Bureau, Marshall & Woodford Counties PUMA, Illinois/IL",1363,21,130,53,5,10,1416,26,140,15,151,166,1582,86,3,1,10,0,1,1,8,90,10,2,9
17,Illinois/IL,1702601,"DeKalb County PUMA, Illinois/IL",390,112,201,9,0,0,399,112,201,0,313,313,712,55,1,0,44,0,16,0,28,56,44,16,28
17,Illinois/IL,1702700,"Stephenson & Ogle Counties PUMA, Illinois/IL",1542,123,224,52,45,8,1594,168,232,53,347,400,1994,77,3,3,17,2,6,0,11,80,20,8,12
17,Illinois/IL,1702801,"Winnebago County (Southeast & West)--Rockford City PUMA, Illinois/IL",817,134,152,165,44,160,982,178,312,204,286,490,1472,56,11,14,19,3,9,11,10,67,33,12,21
17,Illinois/IL,1702901,"Winnebago (Northeast) & Boone Counties PUMA, Illinois/IL",859,55,252,172,0,147,1031,55,399,147,307,454,1485,58,12,10,21,0,4,10,17,69,31,4,27
17,Illinois/IL,1703005,"Kane County (Southeast)--Aurora Township PUMA, Illinois/IL",351,113,398,216,0,118,567,113,516,118,511,629,1196,29,18,10,43,0,9,10,33,47,53,9,43
17,Illinois/IL,1703007,"Kane County (East)--St. Charles, Batavia (Central) & Geneva (Central) Townships PUMA, Illinois/IL",124,25,0,23,0,0,147,25,0,0,25,25,172,72,13,0,15,0,15,0,0,85,15,15,0
17,Illinois/IL,1703008,"Kane County (Northeast)--Elgin (North & Central) & Dundee Townships PUMA, Illinois/IL",175,120,352,207,17,131,382,137,483,148,472,620,1002,17,21,15,47,2,12,13,35,38,62,14,48
17,Illinois/IL,1703009,"Kane County (West) PUMA, Illinois/IL",589,174,48,0,0,0,589,174,48,0,222,222,811,73,0,0,27,0,21,0,6,73,27,21,6
17,Illinois/IL,1703102,"Will County (West Central)--Joliet & Troy Townships PUMA, Illinois/IL",214,0,246,72,0,0,286,0,246,0,246,246,532,40,14,0,46,0,0,0,46,54,46,0,46
17,Illinois/IL,1703105,"Will County (Northwest Central)--Plainfield & Lockport Townships PUMA, Illinois/IL",245,109,164,132,65,0,377,174,164,65,273,338,715,34,18,9,38,9,15,0,23,53,47,24,23
17,Illinois/IL,1703106,"Will County (Northwest)--DuPage & Wheatland Townships PUMA, Illinois/IL",158,71,82,59,41,0,217,112,82,41,153,194,411,38,14,10,37,10,17,0,20,53,47,27,20
17,Illinois/IL,1703107,"Will County (Northeast)--Frankfort, Homer & New Lenox (North) Townships PUMA, Illinois/IL",86,0,0,0,0,0,86,0,0,0,0,0,86,100,0,0,0,0,0,0,0,100,0,0,0
17,Illinois/IL,1703108,"Will County (South) PUMA, Illinois/IL",321,19,6,0,0,0,321,19,6,0,25,25,346,93,0,0,7,0,5,0,2,93,7,5,2
17,Illinois/IL,1703202,"DuPage County (Central)--Milton Township PUMA, Illinois/IL",46,0,15,0,91,0,46,91,15,91,15,106,152,30,0,60,10,60,0,0,10,30,70,60,10
17,Illinois/IL,1703203,"DuPage County (South Central)--Lisle Township PUMA, Illinois/IL",130,34,0,0,0,0,130,34,0,0,34,34,164,79,0,0,21,0,21,0,0,79,21,21,0
17,Illinois/IL,1703204,"DuPage County (Southeast)--Downers Grove Township PUMA, Illinois/IL",73,0,0,0,0,14,73,0,14,14,0,14,87,84,0,16,0,0,0,16,0,84,16,0,16
17,Illinois/IL,1703205,"DuPage County (East Central)--York Township PUMA, Illinois/IL",270,0,0,16,0,0,286,0,0,0,0,0,286,94,6,0,0,0,0,0,0,100,0,0,0
17,Illinois/IL,1703207,"Dupage County (Northeast)--Addison & Bloomingdale (North) Townships PUMA, Illinois/IL",114,56,244,19,58,0,133,114,244,58,300,358,491,23,4,12,61,12,11,0,50,27,73,23,50
17,Illinois/IL,1703208,"DuPage County (Northwest)--Bloomingdale (South), Wayne & Winfield (North) Townships PUMA, Illinois/IL",216,92,393,158,54,40,374,146,433,94,485,579,953,23,17,10,51,6,10,4,41,39,61,15,45
17,Illinois/IL,1703209,"DuPage County (Southwest)--Naperville & Winfield (South) Townships PUMA, Illinois/IL",31,32,174,147,0,0,178,32,174,0,206,206,384,8,38,0,54,0,8,0,45,46,54,8,45
17,Illinois/IL,1703306,"Lake County (Northwest)--Avon, Lake Villa, Antioch & Grant Townships PUMA, Illinois/IL",217,113,154,39,0,0,256,113,154,0,267,267,523,41,7,0,51,0,22,0,29,49,51,22,29
17,Illinois/IL,1703307,"Lake County (Northeast)--Waukegan, Zion, Benton & Newport Townships PUMA, Illinois/IL",9,94,382,197,0,0,206,94,382,0,476,476,682,1,29,0,70,0,14,0,56,30,70,14,56
17,Illinois/IL,1703308,"Lake County (Southwest)--Ela, Freemont, Wauconda & Cuba Townships PUMA, Illinois/IL",86,0,0,0,0,0,86,0,0,0,0,0,86,100,0,0,0,0,0,0,0,100,0,0,0
17,Illinois/IL,1703309,"Lake County (East Central)--Warren, Libertyville (North & East) & Shields Townships PUMA, Illinois/IL",136,12,43,34,0,0,170,12,43,0,55,55,225,60,15,0,24,0,5,0,19,76,24,5,19
17,Illinois/IL,1703310,"Lake County--Vernon, Moraine, West Deerfield & Libertyville (Southeast) Townships PUMA, Illinois/IL",164,0,97,20,0,18,184,0,115,18,97,115,299,55,7,6,32,0,0,6,32,62,38,0,38
17,Illinois/IL,1703401,"Cook County (Northwest)--Palatine & Barrington Townships PUMA, Illinois/IL",27,46,54,19,28,0,46,74,54,28,100,128,174,16,11,16,57,16,26,0,31,26,74,43,31
17,Illinois/IL,1703407,"Cook County (West Central)--Proviso, Riverside & River Forest Townships PUMA, Illinois/IL",167,33,108,96,0,0,263,33,108,0,141,141,404,41,24,0,35,0,8,0,27,65,35,8,27
17,Illinois/IL,1703408,"Cook County (Central)--Cicero, Berwyn & Oak Park Townships PUMA, Illinois/IL",166,322,682,343,0,14,509,322,696,14,1004,1018,1527,11,22,1,66,0,21,1,45,33,67,21,46
17,Illinois/IL,1703409,"Cook County (West Central)--Lyons & Stickney Townships PUMA, Illinois/IL",205,50,184,77,51,77,282,101,261,128,234,362,644,32,12,20,36,8,8,12,29,44,56,16,41
17,Illinois/IL,1703410,"Cook County (Southwest)--Orland (West & Central), Palos & Lemont Townships PUMA, Illinois/IL",124,0,0,36,76,0,160,76,0,76,0,76,236,53,15,32,0,32,0,0,0,68,32,32,0
17,Illinois/IL,1703411,"Cook County (South Central)--Worth & Calumet Townships PUMA, Illinois/IL",180,58,26,73,26,0,253,84,26,26,84,110,363,50,20,7,23,7,16,0,7,70,30,23,7
17,Illinois/IL,1703412,"Cook County (South Central)--Bremen & Orland (East) Townships PUMA, Illinois/IL",193,0,102,74,0,0,267,0,102,0,102,102,369,52,20,0,28,0,0,0,28,72,28,0,28
17,Illinois/IL,1703413,"Cook County (Southeast)--Thornton Township PUMA, Illinois/IL",485,185,159,183,0,59,668,185,218,59,344,403,1071,45,17,6,32,0,17,6,15,62,38,17,20
17,Illinois/IL,1703414,"Cook County (South)--Bloom & Rich Townships PUMA, Illinois/IL",562,48,0,14,23,13,576,71,13,36,48,84,660,85,2,5,7,3,7,2,0,87,13,11,2
17,Illinois/IL,1703415,"Cook County (North)--Wheeling Township (North & East) PUMA, Illinois/IL",9,0,212,0,12,92,9,12,304,104,212,316,325,3,0,32,65,4,0,28,65,3,97,4,94
17,Illinois/IL,1703416,"Cook County (Northeast)--Northfield & New Trier Townships PUMA, Illinois/IL",77,0,0,0,69,0,77,69,0,69,0,69,146,53,0,47,0,47,0,0,0,53,47,47,0
17,Illinois/IL,1703417,"Cook County (Northwest)--Hanover & Schaumburg (Northwest) Townships PUMA, Illinois/IL",20,40,440,25,0,0,45,40,440,0,480,480,525,4,5,0,91,0,8,0,84,9,91,8,84
17,Illinois/IL,1703418,"Cook County (Northwest)--Schaumburg Township (South & Central) PUMA, Illinois/IL",93,0,76,50,27,37,143,27,113,64,76,140,283,33,18,23,27,10,0,13,27,51,49,10,40
17,Illinois/IL,1703419,"Cook County (Northwest)--Elk Grove & Wheeling (Southwest) Townships PUMA, Illinois/IL",185,28,205,0,20,44,185,48,249,64,233,297,482,38,0,13,48,4,6,9,43,38,62,10,52
17,Illinois/IL,1703420,"Cook County (North)--Maine, Norwood Park Townships & Chicago City--Edison Park PUMA, Illinois/IL",235,0,230,0,66,23,235,66,253,89,230,319,554,42,0,16,42,12,0,4,42,42,58,12,46
17,Illinois/IL,1703421,"Cook County (North)--Niles & Evanston Townships PUMA, Illinois/IL",15,0,13,0,41,32,15,41,45,73,13,86,101,15,0,72,13,41,0,32,13,15,85,41,45
17,Illinois/IL,1703422,"Cook County (West)--Leyden, Norwood Park (South) Townships & Chicago City--O'Hare PUMA, Illinois/IL",223,63,109,41,40,85,264,103,194,125,172,297,561,40,7,22,31,7,11,15,19,47,53,18,35
17,Illinois/IL,1703501,"Chicago City (North)--Edgewater, Uptown & Rogers Park PUMA, Illinois/IL",123,0,457,0,76,67,123,76,524,143,457,600,723,17,0,20,63,11,0,9,63,17,83,11,72
17,Illinois/IL,1703502,"Chicago City (North)--Lake View & Lincoln Park PUMA, Illinois/IL",22,9,31,0,0,0,22,9,31,0,40,40,62,35,0,0,65,0,15,0,50,35,65,15,50
17,Illinois/IL,1703503,"Chicago City (North)--West Ridge, Lincoln Square & North Center PUMA, Illinois/IL",75,0,0,0,23,30,75,23,30,53,0,53,128,59,0,41,0,18,0,23,0,59,41,18,23
17,Illinois/IL,1703504,"Chicago City (Northwest)--Irving Park, Albany Park, Forest Glen & North Park PUMA, Illinois/IL",20,74,169,36,9,43,56,83,212,52,243,295,351,6,10,15,69,3,21,12,48,16,84,24,60
17,Illinois/IL,1703520,"Chicago City (Northwest)--Portage Park, Dunning & Jefferson Park PUMA, Illinois/IL",40,14,142,43,86,38,83,100,180,124,156,280,363,11,12,34,43,24,4,10,39,23,77,28,50
17,Illinois/IL,1703521,"Chicago City (West)--Austin, Belmont Cragin & Montclare PUMA, Illinois/IL",236,261,767,72,16,0,308,277,767,16,1028,1044,1352,17,5,1,76,1,19,0,57,23,77,20,57
17,Illinois/IL,1703522,"Chicago City (Northwest)--Logan Square, Avondale & Hermosa PUMA, Illinois/IL",96,160,513,313,0,0,409,160,513,0,673,673,1082,9,29,0,62,0,15,0,47,38,62,15,47
17,Illinois/IL,1703523,"Chicago City (West)--North & South Lawndale, Humboldt Park, East & West Garfield Park PUMA, Illinois/IL",416,84,772,136,0,0,552,84,772,0,856,856,1408,30,10,0,61,0,6,0,55,39,61,6,55
17,Illinois/IL,1703524,"Chicago City (West)--West Town, Near West Side & Lower West Side PUMA, Illinois/IL",178,71,120,40,0,0,218,71,120,0,191,191,409,44,10,0,47,0,17,0,29,53,47,17,29
17,Illinois/IL,1703525,"Chicago City (Central)--Near North Side, Loop & Near South Side PUMA, Illinois/IL",166,0,0,0,0,0,166,0,0,0,0,0,166,100,0,0,0,0,0,0,0,100,0,0,0
17,Illinois/IL,1703526,"Chicago City (Southwest)--Brighton Park, New City, Bridgeport & McKinley Park PUMA, Illinois/IL",42,143,903,402,53,142,444,196,1045,195,1046,1241,1685,2,24,12,62,3,8,8,54,26,74,12,62
17,Illinois/IL,1703527,"Chicago City (Southwest)--Gage Park, Garfield Ridge & West Lawn PUMA, Illinois/IL",22,324,725,315,101,18,337,425,743,119,1049,1168,1505,1,21,8,70,7,22,1,48,22,78,28,49
17,Illinois/IL,1703528,"Chicago City (South)--Chicago Lawn, Englewood/West Englewood & Greater Grand Crossing PUMA, Illinois/IL",249,69,286,80,30,0,329,99,286,30,355,385,714,35,11,4,50,4,10,0,40,46,54,14,40
17,Illinois/IL,1703529,"Chicago City (South)--South Shore, Hyde Park, Woodlawn, Grand Boulevard & Douglas PUMA, Illinois/IL",270,0,0,0,0,26,270,0,26,26,0,26,296,91,0,9,0,0,0,9,0,91,9,0,9
17,Illinois/IL,1703530,"Chicago City (South)--Ashburn, Washington Heights, Morgan Park & Beverly PUMA, Illinois/IL",102,138,50,69,0,0,171,138,50,0,188,188,359,28,19,0,52,0,38,0,14,48,52,38,14
17,Illinois/IL,1703531,"Chicago City (South)--Auburn Gresham, Roseland, Chatham, Avalon Park & Burnside PUMA, Illinois/IL",628,0,15,0,45,0,628,45,15,45,15,60,688,91,0,7,2,7,0,0,2,91,9,7,2
17,Illinois/IL,1703532,"Chicago City (South)--South Chicago, Pullman, West Pullman, East Side & South Deering PUMA, Illinois/IL",400,236,127,137,0,46,537,236,173,46,363,409,946,42,14,5,38,0,25,5,13,57,43,25,18
17,Illinois/IL,1703601,"McHenry County (North, West & Central) PUMA, Illinois/IL",488,110,70,94,0,0,582,110,70,0,180,180,762,64,12,0,24,0,14,0,9,76,24,14,9
17,Illinois/IL,1703602,"McHenry County (Southeast)--Algonquin, McHenry & Nunda Townships PUMA, Illinois/IL",413,0,15,0,25,0,413,25,15,25,15,40,453,91,0,6,3,6,0,0,3,91,9,6,3
17,Illinois/IL,1703700,"Kendall & Grundy Counties PUMA, Illinois/IL",356,71,0,99,16,53,455,87,53,69,71,140,595,60,17,12,12,3,12,9,0,76,24,15,9
18,Indiana/IN,1800101,"Lake County (Northwest)--Hammond & East Chicago Cities PUMA, Indiana/IN",93,77,259,214,0,0,307,77,259,0,336,336,643,14,33,0,52,0,12,0,40,48,52,12,40
18,Indiana/IN,1800102,"Lake County (Northeast)--Gary City & Griffith Town PUMA, Indiana/IN",237,0,42,12,8,0,249,8,42,8,42,50,299,79,4,3,14,3,0,0,14,83,17,3,14
18,Indiana/IN,1800103,"Lake County (Central) PUMA, Indiana/IN",255,38,0,111,0,93,366,38,93,93,38,131,497,51,22,19,8,0,8,19,0,74,26,8,19
18,Indiana/IN,1800104,"Lake County (South) PUMA, Indiana/IN",78,36,0,0,0,0,78,36,0,0,36,36,114,68,0,0,32,0,32,0,0,68,32,32,0
18,Indiana/IN,1800200,"Porter County PUMA, Indiana/IN",181,0,16,30,0,0,211,0,16,0,16,16,227,80,13,0,7,0,0,0,7,93,7,0,7
18,Indiana/IN,1800300,"LaPorte County PUMA, Indiana/IN",567,33,42,10,0,0,577,33,42,0,75,75,652,87,2,0,12,0,5,0,6,88,12,5,6
18,Indiana/IN,1800401,"St. Joseph County (North)--South Bend City PUMA, Indiana/IN",202,0,93,50,0,25,252,0,118,25,93,118,370,55,14,7,25,0,0,7,25,68,32,0,32
18,Indiana/IN,1800402,"St. Joseph County (Outside South Bend City)--Mishawaka City PUMA, Indiana/IN",314,0,0,0,0,0,314,0,0,0,0,0,314,100,0,0,0,0,0,0,0,100,0,0,0
18,Indiana/IN,1800500,"Elkhart County--Elkhart & Goshen Cities PUMA, Indiana/IN",596,143,93,0,0,0,596,143,93,0,236,236,832,72,0,0,28,0,17,0,11,72,28,17,11
18,Indiana/IN,1800600,"Noble, DeKalb, LaGrange & Steuben Counties PUMA, Indiana/IN",1124,0,118,0,0,0,1124,0,118,0,118,118,1242,90,0,0,10,0,0,0,10,90,10,0,10
18,Indiana/IN,1800700,"Jasper, Starke, Fulton, Newton & Pulaski Counties PUMA, Indiana/IN",898,132,78,4,0,0,902,132,78,0,210,210,1112,81,0,0,19,0,12,0,7,81,19,12,7
18,Indiana/IN,1800800,"Kosciusko & Marshall Counties PUMA, Indiana/IN",1028,85,162,75,14,72,1103,99,234,86,247,333,1436,72,5,6,17,1,6,5,11,77,23,7,16
18,Indiana/IN,1800900,"Huntington, Whitley, Adams & Wells Counties PUMA, Indiana/IN",1357,0,19,38,0,0,1395,0,19,0,19,19,1414,96,3,0,1,0,0,0,1,99,1,0,1
18,Indiana/IN,1801001,"Allen County (Central)--Fort Wayne City (South) PUMA, Indiana/IN",437,9,107,0,0,149,437,9,256,149,116,265,702,62,0,21,17,0,1,21,15,62,38,1,36
18,Indiana/IN,1801002,"Allen County (Central)--Fort Wayne City (North) PUMA, Indiana/IN",336,0,10,6,45,166,342,45,176,211,10,221,563,60,1,37,2,8,0,29,2,61,39,8,31
18,Indiana/IN,1801003,"Allen County (Outside Fort Wayne City) PUMA, Indiana/IN",282,0,0,0,17,0,282,17,0,17,0,17,299,94,0,6,0,6,0,0,0,94,6,6,0
18,Indiana/IN,1801100,"Montgomery, Clinton, White, Carroll & Benton Counties PUMA, Indiana/IN",1724,144,441,35,0,0,1759,144,441,0,585,585,2344,74,1,0,25,0,6,0,19,75,25,6,19
18,Indiana/IN,1801200,"Tippecanoe County--Lafayette & West Lafayette Cities PUMA, Indiana/IN",1262,91,82,0,6,32,1262,97,114,38,173,211,1473,86,0,3,12,0,6,2,6,86,14,7,8
18,Indiana/IN,1801300,"Howard, Cass & Tipton Counties--Kokomo City PUMA, Indiana/IN",991,199,415,232,116,209,1223,315,624,325,614,939,2162,46,11,15,28,5,9,10,19,57,43,15,29
18,Indiana/IN,1801400,"Grant, Miami & Wabash Counties PUMA, Indiana/IN",1419,42,29,20,10,0,1439,52,29,10,71,81,1520,93,1,1,5,1,3,0,2,95,5,3,2
18,Indiana/IN,1801500,"Henry, Randolph, Jay & Blackford Counties PUMA, Indiana/IN",1262,0,96,51,0,10,1313,0,106,10,96,106,1419,89,4,1,7,0,0,1,7,93,7,0,7
18,Indiana/IN,1801600,"Clay, Sullivan, Parke, Fountain, Vermillion & Warren Counties PUMA, Indiana/IN",749,0,28,24,0,0,773,0,28,0,28,28,801,94,3,0,3,0,0,0,3,97,3,0,3
18,Indiana/IN,1801700,"Vigo County--Terre Haute City PUMA, Indiana/IN",284,0,58,0,0,0,284,0,58,0,58,58,342,83,0,0,17,0,0,0,17,83,17,0,17
18,Indiana/IN,1801801,"Boone & Hamilton (Northwest) Counties PUMA, Indiana/IN",272,0,0,0,0,0,272,0,0,0,0,0,272,100,0,0,0,0,0,0,0,100,0,0,0
18,Indiana/IN,1801803,"Hamilton County (East)--Noblesville City & Fishers Town (East) PUMA, Indiana/IN",23,0,41,0,0,0,23,0,41,0,41,41,64,36,0,0,64,0,0,0,64,36,64,0,64
18,Indiana/IN,1801900,"Madison County--Anderson City PUMA, Indiana/IN",684,0,25,77,0,0,761,0,25,0,25,25,786,87,10,0,3,0,0,0,3,97,3,0,3
18,Indiana/IN,1802000,"Delaware County--Muncie City PUMA, Indiana/IN",494,0,0,0,0,0,494,0,0,0,0,0,494,100,0,0,0,0,0,0,0,100,0,0,0
18,Indiana/IN,1802100,"Morgan, Putnam & Brown Counties PUMA, Indiana/IN",469,18,0,0,0,0,469,18,0,0,18,18,487,96,0,0,4,0,4,0,0,96,4,4,0
18,Indiana/IN,1802200,"Hendricks County PUMA, Indiana/IN",477,0,0,0,12,11,477,12,11,23,0,23,500,95,0,5,0,2,0,2,0,95,5,2,2
18,Indiana/IN,1802301,"Marion County--Pike & Washington (Northwest) Townships--Indianapolis City (Northwest) PUMA, Indiana/IN",253,49,73,25,0,144,278,49,217,144,122,266,544,47,5,26,22,0,9,26,13,51,49,9,40
18,Indiana/IN,1802302,"Marion County--Washington Township (South & East)--Indianapolis City (North) PUMA, Indiana/IN",240,0,18,0,0,0,240,0,18,0,18,18,258,93,0,0,7,0,0,0,7,93,7,0,7
18,Indiana/IN,1802303,"Marion County--Lawrence Township--Indianapolis (Northeast) & Lawrence Cities PUMA, Indiana/IN",307,0,60,0,0,0,307,0,60,0,60,60,367,84,0,0,16,0,0,0,16,84,16,0,16
18,Indiana/IN,1802304,"Marion County--Wayne & Decatur (Northwest) Townships--Indianapolis City (West) PUMA, Indiana/IN",405,7,137,0,0,0,405,7,137,0,144,144,549,74,0,0,26,0,1,0,25,74,26,1,25
18,Indiana/IN,1802305,"Marion County--Center Township--Indianapolis City (Central) PUMA, Indiana/IN",177,0,41,18,0,0,195,0,41,0,41,41,236,75,8,0,17,0,0,0,17,83,17,0,17
18,Indiana/IN,1802306,"Marion County--Warren & Franklin Townships--Indianapolis City (East & Southeast) PUMA, Indiana/IN",243,0,16,0,0,0,243,0,16,0,16,16,259,94,0,0,6,0,0,0,6,94,6,0,6
18,Indiana/IN,1802307,"Marion County--Perry & Decatur (South & East) Townships--Indianapolis City (South) PUMA, Indiana/IN",126,0,0,0,0,107,126,0,107,107,0,107,233,54,0,46,0,0,0,46,0,54,46,0,46
18,Indiana/IN,1802400,"Johnson County--Greenwood City PUMA, Indiana/IN",147,0,0,0,0,0,147,0,0,0,0,0,147,100,0,0,0,0,0,0,0,100,0,0,0
18,Indiana/IN,1802500,"Hancock & Shelby Counties PUMA, Indiana/IN",396,0,0,15,0,0,411,0,0,0,0,0,411,96,4,0,0,0,0,0,0,100,0,0,0
18,Indiana/IN,1802600,"Wayne, Fayette, Rush & Union Counties PUMA, Indiana/IN",701,34,32,4,0,0,705,34,32,0,66,66,771,91,1,0,9,0,4,0,4,91,9,4,4
18,Indiana/IN,1802700,"Greene, Daviess, Owen, Orange & Martin Counties PUMA, Indiana/IN",1028,98,220,0,50,20,1028,148,240,70,318,388,1416,73,0,5,22,4,7,1,16,73,27,10,17
18,Indiana/IN,1802800,"Monroe County--Bloomington City PUMA, Indiana/IN",41,0,0,0,0,0,41,0,0,0,0,0,41,100,0,0,0,0,0,0,0,100,0,0,0
18,Indiana/IN,1802900,"Bartholomew & Jackson Counties--Columbus City PUMA, Indiana/IN",310,0,84,0,0,0,310,0,84,0,84,84,394,79,0,0,21,0,0,0,21,79,21,0,21
18,Indiana/IN,1803000,"Jefferson, Jennings, Decatur & Scott Counties PUMA, Indiana/IN",1016,32,89,0,0,0,1016,32,89,0,121,121,1137,89,0,0,11,0,3,0,8,89,11,3,8
18,Indiana/IN,1803100,"Dearborn, Franklin, Ripley, Switzerland & Ohio Counties PUMA, Indiana/IN",551,0,0,0,0,0,551,0,0,0,0,0,551,100,0,0,0,0,0,0,0,100,0,0,0
18,Indiana/IN,1803200,"Warrick, Gibson & Posey Counties PUMA, Indiana/IN",703,0,88,0,0,33,703,0,121,33,88,121,824,85,0,4,11,0,0,4,11,85,15,0,15
18,Indiana/IN,1803300,"Vanderburgh County--Evansville City PUMA, Indiana/IN",1100,14,63,14,0,71,1114,14,134,71,77,148,1262,87,1,6,6,0,1,6,5,88,12,1,11
18,Indiana/IN,1803400,"Dubois, Knox, Spencer, Perry, Pike & Crawford Counties PUMA, Indiana/IN",1306,63,114,66,0,0,1372,63,114,0,177,177,1549,84,4,0,11,0,4,0,7,89,11,4,7
18,Indiana/IN,1803500,"Floyd, Harrison & Washington Counties PUMA, Indiana/IN",539,0,0,76,0,0,615,0,0,0,0,0,615,88,12,0,0,0,0,0,0,100,0,0,0
18,Indiana/IN,1803600,"Clark County--Jeffersonville City PUMA, Indiana/IN",285,41,51,10,0,0,295,41,51,0,92,92,387,74,3,0,24,0,11,0,13,76,24,11,13
19,Iowa/IA,1900100,"Sioux, Clay, Dickinson, O'Brien, Lyon, Emmet, Palo Alto & Osceola Counties PUMA, Iowa/IA",1548,159,577,206,0,36,1754,159,613,36,736,772,2526,61,8,1,29,0,6,1,23,69,31,6,24
19,Iowa/IA,1900200,"Cerro Gordo, Floyd, Kossuth, Hancock, Winnebago, Mitchell & Worth Counties PUMA, Iowa/IA",1931,25,30,30,38,19,1961,63,49,57,55,112,2073,93,1,3,3,2,1,1,1,95,5,3,2
19,Iowa/IA,1900400,"Bremer, Winneshiek, Fayette, Clayton, Allamakee, Chickasaw & Howard Counties PUMA, Iowa/IA",1839,29,285,27,0,121,1866,29,406,121,314,435,2301,80,1,5,14,0,1,5,12,81,19,1,18
19,Iowa/IA,1900500,"Black Hawk County--Waterloo & Cedar Falls Cities PUMA, Iowa/IA",1102,256,347,189,104,409,1291,360,756,513,603,1116,2407,46,8,21,25,4,11,17,14,54,46,15,31
19,Iowa/IA,1900600,"Webster, Hardin, Hamilton, Butler, Wright, Grundy, Franklin & Humboldt Counties PUMA, Iowa/IA",2276,29,203,89,0,0,2365,29,203,0,232,232,2597,88,3,0,9,0,1,0,8,91,9,1,8
19,Iowa/IA,1900700,"Dubuque, Buchanan, Jackson & Delaware Counties--Dubuque City PUMA, Iowa/IA",1512,0,111,0,20,0,1512,20,111,20,111,131,1643,92,0,1,7,1,0,0,7,92,8,1,7
19,Iowa/IA,1900800,"Clinton, Muscatine, Jones & Cedar Counties PUMA, Iowa/IA",1762,128,258,458,21,78,2220,149,336,99,386,485,2705,65,17,4,14,1,5,3,10,82,18,6,12
19,Iowa/IA,1900900,"Scott County--Davenport City PUMA, Iowa/IA",1106,28,82,98,90,62,1204,118,144,152,110,262,1466,75,7,10,8,6,2,4,6,82,18,8,10
19,Iowa/IA,1901000,"Linn County--Cedar Rapids City PUMA, Iowa/IA",1585,59,127,74,0,242,1659,59,369,242,186,428,2087,76,4,12,9,0,3,12,6,79,21,3,18
19,Iowa/IA,1901100,"Johnson County--Iowa City PUMA, Iowa/IA",520,0,0,85,0,333,605,0,333,333,0,333,938,55,9,36,0,0,0,36,0,64,36,0,36
19,Iowa/IA,1901200,"Marshall, Benton, Poweshiek, Tama & Iowa Counties PUMA, Iowa/IA",1901,296,868,255,30,531,2156,326,1399,561,1164,1725,3881,49,7,14,30,1,8,14,22,56,44,8,36
19,Iowa/IA,1901300,"Story & Boone Counties--Ames City PUMA, Iowa/IA",815,0,39,0,21,0,815,21,39,21,39,60,875,93,0,2,4,2,0,0,4,93,7,2,4
19,Iowa/IA,1901400,"Warren, Jasper, Marion, Dallas (West) & Madison Counties PUMA, Iowa/IA",1072,208,99,116,127,186,1188,335,285,313,307,620,1808,59,6,17,17,7,12,10,5,66,34,19,16
19,Iowa/IA,1901500,"Polk (Southwest) & Dallas (East) Counties--West Des Moines & Urbandale Cities PUMA, Iowa/IA",582,0,44,35,0,0,617,0,44,0,44,44,661,88,5,0,7,0,0,0,7,93,7,0,7
19,Iowa/IA,1901600,"Polk County (East)--Ankeny & Altoona Cities PUMA, Iowa/IA",510,0,0,66,0,0,576,0,0,0,0,0,576,89,11,0,0,0,0,0,0,100,0,0,0
19,Iowa/IA,1901700,"Des Moines City PUMA, Iowa/IA",578,66,282,9,121,1173,587,187,1455,1294,348,1642,2229,26,0,58,16,5,3,53,13,26,74,8,65
19,Iowa/IA,1901800,"South Central Iowa PUMA, Iowa/IA",2066,9,135,108,62,9,2174,71,144,71,144,215,2389,86,5,3,6,3,0,0,6,91,9,3,6
19,Iowa/IA,1901900,"Northwest Central Iowa--Storm Lake, Denison & Cherokee Region PUMA, Iowa/IA",3069,831,1825,213,524,474,3282,1355,2299,998,2656,3654,6936,44,3,14,38,8,12,7,26,47,53,20,33
19,Iowa/IA,1902000,"Woodbury & Plymouth Counties--Sioux City PUMA, Iowa/IA",2208,978,855,407,303,507,2615,1281,1362,810,1833,2643,5258,42,8,15,35,6,19,10,16,50,50,24,26
19,Iowa/IA,1902100,"Southwest Iowa--Council Bluffs City PUMA, Iowa/IA",2497,131,544,73,27,58,2570,158,602,85,675,760,3330,75,2,3,20,1,4,2,16,77,23,5,18
19,Iowa/IA,1902200,"Wapello, Mahaska, Washington, Jefferson, Keokuk, Davis & Van Buren Counties PUMA, Iowa/IA",2578,491,313,141,60,133,2719,551,446,193,804,997,3716,69,4,5,22,2,13,4,8,73,27,15,12
19,Iowa/IA,1902300,"Des Moines, Lee, Henry & Louisa Counties PUMA, Iowa/IA",1857,64,199,180,59,34,2037,123,233,93,263,356,2393,78,8,4,11,2,3,1,8,85,15,5,10
20,Kansas/KS,2000100,"Northwest Kansas PUMA, Kansas/KS",1663,44,275,271,0,13,1934,44,288,13,319,332,2266,73,12,1,14,0,2,1,12,85,15,2,13
20,Kansas/KS,2000200,"North Central Kansas--Salina City PUMA, Kansas/KS",2033,26,113,48,133,71,2081,159,184,204,139,343,2424,84,2,8,6,5,1,3,5,86,14,7,8
20,Kansas/KS,2000300,"Riley, Geary & Pottawatomie Counties--Manhattan City PUMA, Kansas/KS",524,58,37,183,48,0,707,106,37,48,95,143,850,62,22,6,11,6,7,0,4,83,17,12,4
20,Kansas/KS,2000400,"Northeast Kansas PUMA, Kansas/KS",505,0,0,18,3,0,523,3,0,3,0,3,526,96,3,1,0,1,0,0,0,99,1,1,0
20,Kansas/KS,2000500,"Wyandotte County--Kansas City PUMA, Kansas/KS",611,172,325,148,138,158,759,310,483,296,497,793,1552,39,10,19,32,9,11,10,21,49,51,20,31
20,Kansas/KS,2000601,"Johnson County (Northwest)--Shawnee, Lenexa & De Soto Cities PUMA, Kansas/KS",75,0,30,23,27,0,98,27,30,27,30,57,155,48,15,17,19,17,0,0,19,63,37,17,19
20,Kansas/KS,2000602,"Johnson County (Northeast)--Overland Park (North), Prairie Village & Merriam Cities PUMA, Kansas/KS",97,0,53,0,43,0,97,43,53,43,53,96,193,50,0,22,27,22,0,0,27,50,50,22,27
20,Kansas/KS,2000603,"Johnson County (Southwest)--Olathe, Gardner, Spring Hill & Edgerton Cities PUMA, Kansas/KS",329,65,165,76,23,127,405,88,292,150,230,380,785,42,10,19,29,3,8,16,21,52,48,11,37
20,Kansas/KS,2000604,"Johnson County (Southeast)--Blue Valley Region PUMA, Kansas/KS",76,0,0,34,26,0,110,26,0,26,0,26,136,56,25,19,0,19,0,0,0,81,19,19,0
20,Kansas/KS,2000700,"Douglas County--Lawrence City PUMA, Kansas/KS",431,0,0,8,0,0,439,0,0,0,0,0,439,98,2,0,0,0,0,0,0,100,0,0,0
20,Kansas/KS,2000801,"Shawnee County (Central)--Topeka City PUMA, Kansas/KS",964,16,271,640,15,20,1604,31,291,35,287,322,1926,50,33,2,15,1,1,1,14,83,17,2,15
20,Kansas/KS,2000802,"Shawnee (Outside Topeka City), Osage, Jackson, Brown & Wabaunsee Counties PUMA, Kansas/KS",978,0,40,4,6,41,982,6,81,47,40,87,1069,91,0,4,4,1,0,4,4,92,8,1,8
20,Kansas/KS,2000900,"Flint Hills Region--Emporia City PUMA, Kansas/KS",1685,225,362,271,18,0,1956,243,362,18,587,605,2561,66,11,1,23,1,9,0,14,76,24,9,14
20,Kansas/KS,2001000,"Central Kansas--Hutchinson City PUMA, Kansas/KS",1432,13,20,49,0,0,1481,13,20,0,33,33,1514,95,3,0,2,0,1,0,1,98,2,1,1
20,Kansas/KS,2001100,"South Central Kansas PUMA, Kansas/KS",1284,259,220,217,5,16,1501,264,236,21,479,500,2001,64,11,1,24,0,13,1,11,75,25,13,12
20,Kansas/KS,2001200,"Southwest Kansas--Dodge City, Garden City & Liberal City PUMA, Kansas/KS",1537,1904,4109,1280,408,706,2817,2312,4815,1114,6013,7127,9944,15,13,11,60,4,19,7,41,28,72,23,48
20,Kansas/KS,2001301,"Sedgwick (Northwest) & Harvey Counties--Wichita (Northwest) & Newton Cities PUMA, Kansas/KS",422,72,110,0,0,0,422,72,110,0,182,182,604,70,0,0,30,0,12,0,18,70,30,12,18
20,Kansas/KS,2001302,"Sedgwick (Northeast) & Butler (North & East) Counties--Wichita City (Northeast) PUMA, Kansas/KS",455,0,29,0,0,30,455,0,59,30,29,59,514,89,0,6,6,0,0,6,6,89,11,0,11
20,Kansas/KS,2001303,"Sedgwick County (Central)--Wichita City (Central) PUMA, Kansas/KS",162,0,154,0,0,28,162,0,182,28,154,182,344,47,0,8,45,0,0,8,45,47,53,0,53
20,Kansas/KS,2001304,"Sedgwick (South) & Butler (Southwest) Counties--Wichita (South) & Derby Cities PUMA, Kansas/KS",423,40,126,86,53,135,509,93,261,188,166,354,863,49,10,22,19,6,5,16,15,59,41,11,30
20,Kansas/KS,2001400,"East Central Kansas PUMA, Kansas/KS",572,0,0,0,11,0,572,11,0,11,0,11,583,98,0,2,0,2,0,0,0,98,2,2,0
20,Kansas/KS,2001500,"Southeast Kansas PUMA, Kansas/KS",789,0,29,77,0,0,866,0,29,0,29,29,895,88,9,0,3,0,0,0,3,97,3,0,3
21,Kentucky/KY,2100100,"Purchase Area Development District PUMA, Kentucky/KY",1629,27,159,0,117,69,1629,144,228,186,186,372,2001,81,0,9,9,6,1,3,8,81,19,7,11
21,Kentucky/KY,2100200,"Pennyrile Area Development District (North) PUMA, Kentucky/KY",716,0,0,0,0,21,716,0,21,21,0,21,737,97,0,3,0,0,0,3,0,97,3,0,3
21,Kentucky/KY,2100300,"Pennyrile Area Development District (South) PUMA, Kentucky/KY",537,0,165,3,0,0,540,0,165,0,165,165,705,76,0,0,23,0,0,0,23,77,23,0,23
21,Kentucky/KY,2100400,"Barren River Area Development District (Outer) PUMA, Kentucky/KY",1874,74,272,67,37,7,1941,111,279,44,346,390,2331,80,3,2,15,2,3,0,12,83,17,5,12
21,Kentucky/KY,2100500,"Barren River Area Development District (Central)--Warren County PUMA, Kentucky/KY",360,37,203,0,44,353,360,81,556,397,240,637,997,36,0,40,24,4,4,35,20,36,64,8,56
21,Kentucky/KY,2100600,"Lake Cumberland Area Development District (West) PUMA, Kentucky/KY",695,0,0,0,0,0,695,0,0,0,0,0,695,100,0,0,0,0,0,0,0,100,0,0,0
21,Kentucky/KY,2100700,"Lake Cumberland Area Development District (East) PUMA, Kentucky/KY",666,0,26,76,0,35,742,0,61,35,26,61,803,83,9,4,3,0,0,4,3,92,8,0,8
21,Kentucky/KY,2100800,"Cumberland Valley Area Development District (North) PUMA, Kentucky/KY",1377,0,0,0,0,0,1377,0,0,0,0,0,1377,100,0,0,0,0,0,0,0,100,0,0,0
21,Kentucky/KY,2100900,"Cumberland Valley Area Development District (South) PUMA, Kentucky/KY",486,0,0,0,0,0,486,0,0,0,0,0,486,100,0,0,0,0,0,0,0,100,0,0,0
21,Kentucky/KY,2101000,"Kentucky River Area Development District PUMA, Kentucky/KY",195,0,0,11,0,0,206,0,0,0,0,0,206,95,5,0,0,0,0,0,0,100,0,0,0
21,Kentucky/KY,2101100,"Big Sandy Area Development District PUMA, Kentucky/KY",595,0,0,0,0,0,595,0,0,0,0,0,595,100,0,0,0,0,0,0,0,100,0,0,0
21,Kentucky/KY,2101200,"Lincoln Trail Area Development District (East) PUMA, Kentucky/KY",425,0,184,0,0,0,425,0,184,0,184,184,609,70,0,0,30,0,0,0,30,70,30,0,30
21,Kentucky/KY,2101300,"Lincoln Trail Area Development District (West) PUMA, Kentucky/KY",1269,0,25,0,0,0,1269,0,25,0,25,25,1294,98,0,0,2,0,0,0,2,98,2,0,2
21,Kentucky/KY,2101400,"Green River Area Development District (Southwest) PUMA, Kentucky/KY",1401,22,96,50,0,1,1451,22,97,1,118,119,1570,89,3,0,8,0,1,0,6,92,8,1,6
21,Kentucky/KY,2101500,"Green River Area Development District (Northeast)--Daviess & Hancock Counties PUMA, Kentucky/KY",863,31,239,0,20,100,863,51,339,120,270,390,1253,69,0,10,22,2,2,8,19,69,31,4,27
21,Kentucky/KY,2101600,"KIPDA Area Development District (Southeast) PUMA, Kentucky/KY",362,0,289,0,0,0,362,0,289,0,289,289,651,56,0,0,44,0,0,0,44,56,44,0,44
21,Kentucky/KY,2101701,"KIPDA Area Development District (West)--Louisville/Jefferson County (Northwest) PUMA, Kentucky/KY",451,29,89,10,0,14,461,29,103,14,118,132,593,76,2,2,20,0,5,2,15,78,22,5,17
21,Kentucky/KY,2101702,"KIPDA Area Development District (West)--Louisville/Jefferson County (North Central) PUMA, Kentucky/KY",168,0,28,19,18,38,187,18,66,56,28,84,271,62,7,21,10,7,0,14,10,69,31,7,24
21,Kentucky/KY,2101703,"KIPDA Area Development District (West)--Louisville/Jefferson County (Northeast) PUMA, Kentucky/KY",90,3,0,11,0,19,101,3,19,19,3,22,123,73,9,15,2,0,2,15,0,82,18,2,15
21,Kentucky/KY,2101704,"KIPDA Area Development District (West)--Louisville/Jefferson County (Southeast) PUMA, Kentucky/KY",201,0,180,8,75,74,209,75,254,149,180,329,538,37,1,28,33,14,0,14,33,39,61,14,47
21,Kentucky/KY,2101705,"KIPDA Area Development District (West)--Louisville/Jefferson County (South Central) PUMA, Kentucky/KY",378,84,209,8,21,89,386,105,298,110,293,403,789,48,1,14,37,3,11,11,26,49,51,13,38
21,Kentucky/KY,2101706,"KIPDA Area Development District (West)--Louisville/Jefferson County (Southwest) PUMA, Kentucky/KY",568,0,191,94,0,230,662,0,421,230,191,421,1083,52,9,21,18,0,0,21,18,61,39,0,39
21,Kentucky/KY,2101800,"KIPDA Area Development District (Northeast) PUMA, Kentucky/KY",511,0,69,0,0,0,511,0,69,0,69,69,580,88,0,0,12,0,0,0,12,88,12,0,12
21,Kentucky/KY,2101901,"Bluegrass Area Development District (Central)--Lexington-Fayette County (Central) PUMA, Kentucky/KY",188,57,521,0,0,115,188,57,636,115,578,693,881,21,0,13,66,0,6,13,59,21,79,6,72
21,Kentucky/KY,2101902,"Bluegrass Area Development District (Central)--Lexington-Fayette County (Outer) PUMA, Kentucky/KY",488,31,495,14,15,34,502,46,529,49,526,575,1077,45,1,5,49,1,3,3,46,47,53,4,49
21,Kentucky/KY,2102000,"Bluegrass Area Development District (West) PUMA, Kentucky/KY",587,0,365,9,30,94,596,30,459,124,365,489,1085,54,1,11,34,3,0,9,34,55,45,3,42
21,Kentucky/KY,2102100,"Bluegrass Area Development District (South) PUMA, Kentucky/KY",362,0,239,27,0,25,389,0,264,25,239,264,653,55,4,4,37,0,0,4,37,60,40,0,40
21,Kentucky/KY,2102200,"Bluegrass Area Development District (Southeast) PUMA, Kentucky/KY",527,35,21,0,0,0,527,35,21,0,56,56,583,90,0,0,10,0,6,0,4,90,10,6,4
21,Kentucky/KY,2102300,"Bluegrass Area Development District (Northeast) PUMA, Kentucky/KY",392,0,230,25,0,0,417,0,230,0,230,230,647,61,4,0,36,0,0,0,36,64,36,0,36
21,Kentucky/KY,2102400,"Northern Kentucky Area Development District (North Central)--Kenton County PUMA, Kentucky/KY",457,17,0,0,0,0,457,17,0,0,17,17,474,96,0,0,4,0,4,0,0,96,4,4,0
21,Kentucky/KY,2102500,"Northern Kentucky Area Development District (Northwest)--Boone County PUMA, Kentucky/KY",390,119,18,27,0,0,417,119,18,0,137,137,554,70,5,0,25,0,21,0,3,75,25,21,3
21,Kentucky/KY,2102600,"Northern Kentucky Area Development District (Southeast) PUMA, Kentucky/KY",735,0,16,0,0,0,735,0,16,0,16,16,751,98,0,0,2,0,0,0,2,98,2,0,2
21,Kentucky/KY,2102700,"Buffalo Trace & Gateway Area Development Districts PUMA, Kentucky/KY",1620,0,20,0,0,0,1620,0,20,0,20,20,1640,99,0,0,1,0,0,0,1,99,1,0,1
21,Kentucky/KY,2102800,"FIVCO Area Development District PUMA, Kentucky/KY",402,0,0,0,0,0,402,0,0,0,0,0,402,100,0,0,0,0,0,0,0,100,0,0,0
22,Louisiana/LA,2200100,"Coordinating & Development Corporation 1--Shreveport City (North) PUMA, Louisiana/LA",168,0,0,33,12,0,201,12,0,12,0,12,213,79,15,6,0,6,0,0,0,94,6,6,0
22,Louisiana/LA,2200101,"Coordinating & Development Corporation 2--Shreveport City (South) PUMA, Louisiana/LA",109,0,0,0,0,0,109,0,0,0,0,0,109,100,0,0,0,0,0,0,0,100,0,0,0
22,Louisiana/LA,2200200,"Coordinating & Development Corporation 3--Bossier & Webster Parishes PUMA, Louisiana/LA",187,0,0,0,0,0,187,0,0,0,0,0,187,100,0,0,0,0,0,0,0,100,0,0,0
22,Louisiana/LA,2200300,"Coordinating & Development Corporation 4--Northwest Louisiana PUMA, Louisiana/LA",1687,0,63,14,0,0,1701,0,63,0,63,63,1764,96,1,0,4,0,0,0,4,96,4,0,4
22,Louisiana/LA,2200400,"North Delta Regional Planning & Development District 1--Ouachita Parish PUMA, Louisiana/LA",171,0,0,0,0,0,171,0,0,0,0,0,171,100,0,0,0,0,0,0,0,100,0,0,0
22,Louisiana/LA,2200500,"North Delta Regional Planning & Development District 2--Northeast Louisiana PUMA, Louisiana/LA",1985,0,112,131,0,0,2116,0,112,0,112,112,2228,89,6,0,5,0,0,0,5,95,5,0,5
22,Louisiana/LA,2200600,"Kisatchie Delta Regional Planning & Development District 1 PUMA, Louisiana/LA",242,0,37,4,0,0,246,0,37,0,37,37,283,86,1,0,13,0,0,0,13,87,13,0,13
22,Louisiana/LA,2200700,"Kisatchie Delta Regional Planning & Development District 2--Rapides & Vernon Parishes PUMA, Louisiana/LA",305,29,116,60,0,15,365,29,131,15,145,160,525,58,11,3,28,0,6,3,22,70,30,6,25
22,Louisiana/LA,2200800,"Imperial Calcasieu Regional Planning & Development District 1 (North) PUMA, Louisiana/LA",176,0,1,0,0,0,176,0,1,0,1,1,177,99,0,0,1,0,0,0,1,99,1,0,1
22,Louisiana/LA,2200900,"Imperial Calcasieu Regional Planning & Development District 2 (South) PUMA, Louisiana/LA",225,0,8,23,8,0,248,8,8,8,8,16,264,85,9,3,3,3,0,0,3,94,6,3,3
22,Louisiana/LA,2201000,"Acadiana Regional Development District 1--St. Landry & Evangeline Parishes PUMA, Louisiana/LA",271,0,5,0,0,0,271,0,5,0,5,5,276,98,0,0,2,0,0,0,2,98,2,0,2
22,Louisiana/LA,2201100,"Acadiana Regional Development District 2--Acadia & Vermilion Parishes PUMA, Louisiana/LA",259,0,35,13,0,0,272,0,35,0,35,35,307,84,4,0,11,0,0,0,11,89,11,0,11
22,Louisiana/LA,2201200,"Acadiana Regional Development District 3--Lafayette Parish (North) PUMA, Louisiana/LA",159,0,77,0,0,0,159,0,77,0,77,77,236,67,0,0,33,0,0,0,33,67,33,0,33
22,Louisiana/LA,2201201,"Acadiana Regional Development District 4--Lafayette Parish (South) PUMA, Louisiana/LA",52,0,6,0,0,0,52,0,6,0,6,6,58,90,0,0,10,0,0,0,10,90,10,0,10
22,Louisiana/LA,2201300,"Acadiana Regional Development District 5--Iberia, St. Mary & St. Martin Parishes PUMA, Louisiana/LA",837,39,127,13,0,0,850,39,127,0,166,166,1016,82,1,0,16,0,4,0,12,84,16,4,12
22,Louisiana/LA,2201400,"Capital Region Planning Commission 1--Baton Rouge Metropolitan Area (West) PUMA, Louisiana/LA",136,0,276,0,0,0,136,0,276,0,276,276,412,33,0,0,67,0,0,0,67,33,67,0,67
22,Louisiana/LA,2201500,"Capital Region Planning Commission 2--East Baton Rouge Parish (South) PUMA, Louisiana/LA",129,0,0,0,15,0,129,15,0,15,0,15,144,90,0,10,0,10,0,0,0,90,10,10,0
22,Louisiana/LA,2201501,"Capital Region Planning Commission 3--Baton Rouge City PUMA, Louisiana/LA",187,0,9,0,18,0,187,18,9,18,9,27,214,87,0,8,4,8,0,0,4,87,13,8,4
22,Louisiana/LA,2201502,"Capital Region Planning Commission 4--East Baton Rouge Parish (North) PUMA, Louisiana/LA",273,0,0,0,19,0,273,19,0,19,0,19,292,93,0,7,0,7,0,0,0,93,7,7,0
22,Louisiana/LA,2201600,"Capital Region Planning Commission 5--Ascension Parish PUMA, Louisiana/LA",312,0,0,0,0,20,312,0,20,20,0,20,332,94,0,6,0,0,0,6,0,94,6,0,6
22,Louisiana/LA,2201700,"Capital Region Planning Commission 6--Livingston & St. Helena Parishes PUMA, Louisiana/LA",120,0,22,0,0,0,120,0,22,0,22,22,142,85,0,0,15,0,0,0,15,85,15,0,15
22,Louisiana/LA,2201800,"Capital Region Planning Commission 7--Tangipahoa & Washington Parishes PUMA, Louisiana/LA",422,0,334,0,0,0,422,0,334,0,334,334,756,56,0,0,44,0,0,0,44,56,44,0,44
22,Louisiana/LA,2201900,"South Central Planning & Development Commission 1--River Parishes PUMA, Louisiana/LA",346,0,3,12,0,0,358,0,3,0,3,3,361,96,3,0,1,0,0,0,1,99,1,0,1
22,Louisiana/LA,2202000,"South Central Planning & Development Commission 2--Lafourche & Assumption Parishes PUMA, Louisiana/LA",297,0,123,0,0,0,297,0,123,0,123,123,420,71,0,0,29,0,0,0,29,71,29,0,29
22,Louisiana/LA,2202100,"South Central Planning & Development Commission 3--Terrebonne Parish PUMA, Louisiana/LA",239,0,0,0,0,0,239,0,0,0,0,0,239,100,0,0,0,0,0,0,0,100,0,0,0
22,Louisiana/LA,2202200,"Regional Planning Commission 1--St. Tammany Parish (Northwest) PUMA, Louisiana/LA",187,2,1,0,0,57,187,2,58,57,3,60,247,76,0,23,1,0,1,23,0,76,24,1,23
22,Louisiana/LA,2202201,"Regional Planning Commission 2--St. Tammany Parish (Southeast) PUMA, Louisiana/LA",201,0,71,0,0,0,201,0,71,0,71,71,272,74,0,0,26,0,0,0,26,74,26,0,26
22,Louisiana/LA,2202300,"Regional Planning Commission 3--Jefferson Parish (North) PUMA, Louisiana/LA",51,0,0,0,0,52,51,0,52,52,0,52,103,50,0,50,0,0,0,50,0,50,50,0,50
22,Louisiana/LA,2202301,"Regional Planning Commission 4--Jefferson Parish (Central) PUMA, Louisiana/LA",231,0,34,0,0,0,231,0,34,0,34,34,265,87,0,0,13,0,0,0,13,87,13,0,13
22,Louisiana/LA,2202302,"Regional Planning Commission 5--Jefferson Parish (West Bank) PUMA, Louisiana/LA",114,0,0,0,57,0,114,57,0,57,0,57,171,67,0,33,0,33,0,0,0,67,33,33,0
22,Louisiana/LA,2202400,"Regional Planning Commission 6--New Orleans City (Northeast) PUMA, Louisiana/LA",278,0,20,0,26,12,278,26,32,38,20,58,336,83,0,11,6,8,0,4,6,83,17,8,10
22,Louisiana/LA,2202401,"Regional Planning Commission 7--New Orleans City (Central) PUMA, Louisiana/LA",134,13,6,10,0,0,144,13,6,0,19,19,163,82,6,0,12,0,8,0,4,88,12,8,4
22,Louisiana/LA,2202402,"Regional Planning Commission 8--New Orleans City (South) PUMA, Louisiana/LA",150,0,10,0,0,0,150,0,10,0,10,10,160,94,0,0,6,0,0,0,6,94,6,0,6
22,Louisiana/LA,2202500,"Regional Planning Commission 9--St. Bernard, Jefferson (South) & Plaquemines Parishes PUMA, Louisiana/LA",375,0,174,6,0,0,381,0,174,0,174,174,555,68,1,0,31,0,0,0,31,69,31,0,31
23,Maine/ME,2300100,"Northeast Maine--Aroostook & Washington Counties PUMA, Maine/ME",1035,0,62,18,5,32,1053,5,94,37,62,99,1152,90,2,3,5,0,0,3,5,91,9,0,8
23,Maine/ME,2300200,"Northwest Maine--Oxford, Somerset, Franklin & Piscataquis Counties PUMA, Maine/ME",873,0,0,0,0,5,873,0,5,5,0,5,878,99,0,1,0,0,0,1,0,99,1,0,1
23,Maine/ME,2300300,"Penobscot County PUMA, Maine/ME",380,0,0,76,0,0,456,0,0,0,0,0,456,83,17,0,0,0,0,0,0,100,0,0,0
23,Maine/ME,2300400,"Kennebec County PUMA, Maine/ME",182,0,0,0,0,77,182,0,77,77,0,77,259,70,0,30,0,0,0,30,0,70,30,0,30
23,Maine/ME,2300500,"Coastal Maine Region--Hancock, Knox, Waldo & Lincoln Counties PUMA, Maine/ME",860,0,0,0,9,31,860,9,31,40,0,40,900,96,0,4,0,1,0,3,0,96,4,1,3
23,Maine/ME,2300600,"Androscoggin County PUMA, Maine/ME",353,0,0,90,0,13,443,0,13,13,0,13,456,77,20,3,0,0,0,3,0,97,3,0,3
23,Maine/ME,2300700,"Sagadahoc & Cumberland (North) Counties--Bath City & Brunswick PUMA, Maine/ME",299,0,0,0,0,0,299,0,0,0,0,0,299,100,0,0,0,0,0,0,0,100,0,0,0
23,Maine/ME,2300800,"South Maine--York (West) & Cumberland (West) Counties PUMA, Maine/ME",188,0,0,0,0,0,188,0,0,0,0,0,188,100,0,0,0,0,0,0,0,100,0,0,0
23,Maine/ME,2300900,"Cumberland (Outside Portland) & York (East) Counties--Biddeford & Saco Cities PUMA, Maine/ME",403,0,0,68,0,85,471,0,85,85,0,85,556,72,12,15,0,0,0,15,0,85,15,0,15
23,Maine/ME,2301000,"Cumberland County (Southeast)--Portland, South Portland & Westbrook Cities PUMA, Maine/ME",134,0,0,0,45,41,134,45,41,86,0,86,220,61,0,39,0,20,0,19,0,61,39,20,19
24,Maryland/MD,2400100,"Allegany & Garrett Counties--Cumberland City PUMA, Maryland/MD",144,0,0,0,0,0,144,0,0,0,0,0,144,100,0,0,0,0,0,0,0,100,0,0,0
24,Maryland/MD,2400200,"Washington County--Hagerstown City PUMA, Maryland/MD",530,0,24,0,0,0,530,0,24,0,24,24,554,96,0,0,4,0,0,0,4,96,4,0,4
24,Maryland/MD,2400301,"Frederick County (Outside Greater Frederick City) PUMA, Maryland/MD",250,0,4,0,0,0,250,0,4,0,4,4,254,98,0,0,2,0,0,0,2,98,2,0,2
24,Maryland/MD,2400302,"Frederick County (Central)--Greater Frederick City PUMA, Maryland/MD",330,0,112,0,41,0,330,41,112,41,112,153,483,68,0,8,23,8,0,0,23,68,32,8,23
24,Maryland/MD,2400400,"Carroll County PUMA, Maryland/MD",165,0,50,0,36,0,165,36,50,36,50,86,251,66,0,14,20,14,0,0,20,66,34,14,20
24,Maryland/MD,2400501,"Baltimore County (Outer) PUMA, Maryland/MD",271,0,4,18,0,0,289,0,4,0,4,4,293,92,6,0,1,0,0,0,1,99,1,0,1
24,Maryland/MD,2400502,"Baltimore County--Randallstown (East), Owings Mills, Milford Mill & Reisterstown PUMA, Maryland/MD",209,0,17,0,0,0,209,0,17,0,17,17,226,92,0,0,8,0,0,0,8,92,8,0,8
24,Maryland/MD,2400503,"Baltimore County--Pikesville (South), Lochearn, Cockeysville & Mays Chapel PUMA, Maryland/MD",56,0,0,0,0,0,56,0,0,0,0,0,56,100,0,0,0,0,0,0,0,100,0,0,0
24,Maryland/MD,2400504,"Baltimore County--Towson (East & Central), Parkville & Carney PUMA, Maryland/MD",166,0,1,0,0,0,166,0,1,0,1,1,167,99,0,0,1,0,0,0,1,99,1,0,1
24,Maryland/MD,2400505,"Baltimore County--Perry Hall, Middle River & Rosedale PUMA, Maryland/MD",161,0,41,0,0,9,161,0,50,9,41,50,211,76,0,4,19,0,0,4,19,76,24,0,24
24,Maryland/MD,2400506,"Baltimore County--Dundalk, Essex & Edgemere PUMA, Maryland/MD",239,0,6,0,0,18,239,0,24,18,6,24,263,91,0,7,2,0,0,7,2,91,9,0,9
24,Maryland/MD,2400507,"Baltimore County--Catonsville, Woodlawn & Arbutus PUMA, Maryland/MD",166,0,187,0,0,157,166,0,344,157,187,344,510,33,0,31,37,0,0,31,37,33,67,0,67
24,Maryland/MD,2400601,"Harford County (North & West)--Bel Air Town, Fallston & Jarrettsville PUMA, Maryland/MD",148,0,8,0,0,20,148,0,28,20,8,28,176,84,0,11,5,0,0,11,5,84,16,0,16
24,Maryland/MD,2400602,"Harford County (South & East)--Aberdeen & Havre de Grace Cities PUMA, Maryland/MD",329,0,4,50,0,0,379,0,4,0,4,4,383,86,13,0,1,0,0,0,1,99,1,0,1
24,Maryland/MD,2400700,"Cecil County PUMA, Maryland/MD",351,0,74,0,17,0,351,17,74,17,74,91,442,79,0,4,17,4,0,0,17,79,21,4,17
24,Maryland/MD,2400801,"Baltimore City--Sandtown-Winchester, Ashburton & Mount Washington PUMA, Maryland/MD",414,0,0,0,32,0,414,32,0,32,0,32,446,93,0,7,0,7,0,0,0,93,7,7,0
24,Maryland/MD,2400802,"Baltimore City--Guilford, Roland Park & Druid Lake PUMA, Maryland/MD",139,0,0,0,0,0,139,0,0,0,0,0,139,100,0,0,0,0,0,0,0,100,0,0,0
24,Maryland/MD,2400803,"Baltimore City--Frankford, Belair-Edison & Loch Raven PUMA, Maryland/MD",398,0,4,0,0,6,398,0,10,6,4,10,408,98,0,1,1,0,0,1,1,98,2,0,2
24,Maryland/MD,2400804,"Baltimore City--Inner Harbor, Canton & Bayview PUMA, Maryland/MD",172,0,33,0,9,64,172,9,97,73,33,106,278,62,0,26,12,3,0,23,12,62,38,3,35
24,Maryland/MD,2400805,"Baltimore City--Irvington, Ten Hills & Cherry Hill PUMA, Maryland/MD",182,0,7,7,0,0,189,0,7,0,7,7,196,93,4,0,4,0,0,0,4,96,4,0,4
24,Maryland/MD,2400901,"Howard County (West)--Columbia (West) & Ellicott City (Northwest) PUMA, Maryland/MD",463,0,9,0,0,0,463,0,9,0,9,9,472,98,0,0,2,0,0,0,2,98,2,0,2
24,Maryland/MD,2400902,"Howard County (East)--Columbia (East), Ellicott City (Southeast) & Elkridge PUMA, Maryland/MD",63,0,0,0,0,0,63,0,0,0,0,0,63,100,0,0,0,0,0,0,0,100,0,0,0
24,Maryland/MD,2401001,"Montgomery County (North & West)--Olney, Damascus, Clarksburg & Darnestown PUMA, Maryland/MD",122,0,79,107,0,0,229,0,79,0,79,79,308,40,35,0,26,0,0,0,26,74,26,0,26
24,Maryland/MD,2401002,"Montgomery County (West Central)--Germantown & Montgomery Village PUMA, Maryland/MD",0,9,25,30,0,0,30,9,25,0,34,34,64,0,47,0,53,0,14,0,39,47,53,14,39
24,Maryland/MD,2401003,"Montgomery County (Central)--Rockville, Gaithersburg Cities & North Potomac PUMA, Maryland/MD",142,0,50,0,25,24,142,25,74,49,50,99,241,59,0,20,21,10,0,10,21,59,41,10,31
24,Maryland/MD,2401004,"Montgomery County (South)--Bethesda, Potomac & North Bethesda PUMA, Maryland/MD",34,0,0,0,0,0,34,0,0,0,0,0,34,100,0,0,0,0,0,0,0,100,0,0,0
24,Maryland/MD,2401005,"Montgomery County (East Central)--Wheaton, Aspen Hill & Glenmont PUMA, Maryland/MD",0,23,0,36,0,53,36,23,53,53,23,76,112,0,32,47,21,0,21,47,0,32,68,21,47
24,Maryland/MD,2401006,"Montgomery County (East)--Fairland, Calverton, White Oak & Burtonsville PUMA, Maryland/MD",38,0,55,0,24,75,38,24,130,99,55,154,192,20,0,52,29,12,0,39,29,20,80,12,68
24,Maryland/MD,2401007,"Montgomery County (Southeast)--Takoma Park City & Silver Spring PUMA, Maryland/MD",45,34,84,0,0,169,45,34,253,169,118,287,332,14,0,51,36,0,10,51,25,14,86,10,76
24,Maryland/MD,2401101,"Prince George's County (Northwest)--College Park City & Langley Park PUMA, Maryland/MD",54,0,272,0,0,44,54,0,316,44,272,316,370,15,0,12,74,0,0,12,74,15,85,0,85
24,Maryland/MD,2401102,"Prince George's County (North)--Laurel, Greenbelt (North & East) Cities & Beltsville PUMA, Maryland/MD",0,14,34,0,34,14,0,48,48,48,48,96,96,0,0,50,50,35,15,15,35,0,100,50,50
24,Maryland/MD,2401103,"Prince George's County (Northwest)--New Carrollton & Hyattsville (Southeast) Cities PUMA, Maryland/MD",0,0,84,20,20,14,20,20,98,34,84,118,138,0,14,25,61,14,0,10,61,14,86,14,71
24,Maryland/MD,2401104,"Prince George's County (Central)--Seat Pleasant City, Capitol Heights Town & Landover PUMA, Maryland/MD",33,0,0,0,1,51,33,1,51,52,0,52,85,39,0,61,0,1,0,60,0,39,61,1,60
24,Maryland/MD,2401105,"Prince George's County (East)--Bowie City, Kettering, Largo, Mitchellville & Lanham PUMA, Maryland/MD",56,0,2,0,0,16,56,0,18,16,2,18,74,76,0,22,3,0,0,22,3,76,24,0,24
24,Maryland/MD,2401106,"Prince George's County (South)--Clinton, Fort Washington (South), Rosaryville & Croom PUMA, Maryland/MD",0,0,3,12,0,0,12,0,3,0,3,3,15,0,80,0,20,0,0,0,20,80,20,0,20
24,Maryland/MD,2401107,"Prince George's County (Southwest)--Oxon Hill, Hillcrest Heights & Temple Hills PUMA, Maryland/MD",29,0,5,0,0,0,29,0,5,0,5,5,34,85,0,0,15,0,0,0,15,85,15,0,15
24,Maryland/MD,2401201,"Anne Arundel County (Northwest)--Severn, Odenton, Crofton, Maryland City & Fort Meade PUMA, Maryland/MD",220,0,4,41,0,0,261,0,4,0,4,4,265,83,15,0,2,0,0,0,2,98,2,0,2
24,Maryland/MD,2401202,"Anne Arundel County (North)--Glen Burnie, Pasadena, Ferndale & Brooklyn Park PUMA, Maryland/MD",177,0,11,0,0,62,177,0,73,62,11,73,250,71,0,25,4,0,0,25,4,71,29,0,29
24,Maryland/MD,2401203,"Anne Arundel County (Central)--Severna Park, Arnold & Lake Shore PUMA, Maryland/MD",127,0,2,0,0,0,127,0,2,0,2,2,129,98,0,0,2,0,0,0,2,98,2,0,2
24,Maryland/MD,2401204,"Anne Arundel County (Southeast)--Annapolis City, Parole, Annapolis Neck & Edgewater PUMA, Maryland/MD",143,0,4,16,0,0,159,0,4,0,4,4,163,88,10,0,2,0,0,0,2,98,2,0,2
24,Maryland/MD,2401300,"Queen Anne's, Talbot, Caroline, Dorchester & Kent Counties PUMA, Maryland/MD",1331,15,424,16,37,38,1347,52,462,75,439,514,1861,72,1,4,24,2,1,2,23,72,28,3,25
24,Maryland/MD,2401400,"Wicomico, Worcester & Somerset Counties--Salisbury City PUMA, Maryland/MD",1138,0,38,0,242,645,1138,242,683,887,38,925,2063,55,0,43,2,12,0,31,2,55,45,12,33
24,Maryland/MD,2401500,"St. Mary's & Calvert Counties PUMA, Maryland/MD",199,0,0,35,0,0,234,0,0,0,0,0,234,85,15,0,0,0,0,0,0,100,0,0,0
24,Maryland/MD,2401600,"Charles County--La Plata Town & Waldorf PUMA, Maryland/MD",59,0,0,0,0,0,59,0,0,0,0,0,59,100,0,0,0,0,0,0,0,100,0,0,0
25,Massachusetts/MA,2500100,"Berkshire County--Pittsfield City PUMA, Massachusetts/MA",108,0,0,23,22,86,131,22,86,108,0,108,239,45,10,45,0,9,0,36,0,55,45,9,36
25,Massachusetts/MA,2500200,"Franklin & Hampshire (North) Counties PUMA, Massachusetts/MA",381,7,34,53,101,12,434,108,46,113,41,154,588,65,9,19,7,17,1,2,6,74,26,18,8
25,Massachusetts/MA,2500300,"Worcester County (Central)--Worcester City PUMA, Massachusetts/MA",39,0,77,74,15,164,113,15,241,179,77,256,369,11,20,49,21,4,0,44,21,31,69,4,65
25,Massachusetts/MA,2500301,"Worcester County (Northeast)--Leominster, Fitchburg & Gardner Cities PUMA, Massachusetts/MA",159,0,61,36,12,23,195,12,84,35,61,96,291,55,12,12,21,4,0,8,21,67,33,4,29
25,Massachusetts/MA,2500302,"Worcester County (West Central) PUMA, Massachusetts/MA",311,0,0,0,0,0,311,0,0,0,0,0,311,100,0,0,0,0,0,0,0,100,0,0,0
25,Massachusetts/MA,2500303,"Worcester County (East Central) PUMA, Massachusetts/MA",63,86,0,65,10,0,128,96,0,10,86,96,224,28,29,4,38,4,38,0,0,57,43,43,0
25,Massachusetts/MA,2500304,"Worcester County (South) PUMA, Massachusetts/MA",109,0,0,98,31,18,207,31,18,49,0,49,256,43,38,19,0,12,0,7,0,81,19,12,7
25,Massachusetts/MA,2500400,"Worcester & Middlesex Counties (Outside Leominster, Fitchburg & Gardner Cities) PUMA, Massachusetts/MA",62,0,0,32,0,0,94,0,0,0,0,0,94,66,34,0,0,0,0,0,0,100,0,0,0
25,Massachusetts/MA,2500501,"Middlesex County (Outside Lowell City) PUMA, Massachusetts/MA",13,0,0,0,0,27,13,0,27,27,0,27,40,32,0,68,0,0,0,68,0,32,68,0,68
25,Massachusetts/MA,2500502,"Middlesex County (Far Northeast)--Lowell City PUMA, Massachusetts/MA",74,0,28,14,19,168,88,19,196,187,28,215,303,24,5,62,9,6,0,55,9,29,71,6,65
25,Massachusetts/MA,2500503,"Middlesex County--Waltham City, Lexington, Burlington, Bedford & Lincoln Towns PUMA, Massachusetts/MA",64,0,0,0,18,7,64,18,7,25,0,25,89,72,0,28,0,20,0,8,0,72,28,20,8
25,Massachusetts/MA,2500504,"Middlesex County (South)--Framingham Town, Marlborough City & Natick Town PUMA, Massachusetts/MA",172,0,0,82,44,0,254,44,0,44,0,44,298,58,28,15,0,15,0,0,0,85,15,15,0
25,Massachusetts/MA,2500505,"Middlesex County--Watertown Town City, Arlington, Belmont & Winchester Towns PUMA, Massachusetts/MA",27,0,0,0,14,12,27,14,12,26,0,26,53,51,0,49,0,26,0,23,0,51,49,26,23
25,Massachusetts/MA,2500506,"Middlesex County (East)--Cambridge City PUMA, Massachusetts/MA",15,0,0,0,19,18,15,19,18,37,0,37,52,29,0,71,0,37,0,35,0,29,71,37,35
25,Massachusetts/MA,2500507,"Middlesex County (East)--Somerville & Everett Cities PUMA, Massachusetts/MA",13,20,120,72,97,12,85,117,132,109,140,249,334,4,22,33,42,29,6,4,36,25,75,35,40
25,Massachusetts/MA,2500508,"Middlesex County (East)--Malden & Medford Cities PUMA, Massachusetts/MA",41,31,25,0,0,136,41,31,161,136,56,192,233,18,0,58,24,0,13,58,11,18,82,13,69
25,Massachusetts/MA,2500701,"Essex County (Northwest)--Lawrence, Haverhill & Methuen Town Cities PUMA, Massachusetts/MA",201,226,473,465,26,0,666,252,473,26,699,725,1391,14,33,2,50,2,16,0,34,48,52,18,34
25,Massachusetts/MA,2500702,"Essex County (Central)--Amesbury Town City PUMA, Massachusetts/MA",135,0,0,0,0,0,135,0,0,0,0,0,135,100,0,0,0,0,0,0,0,100,0,0,0
25,Massachusetts/MA,2500703,"Essex County (East)--Salem, Beverly, Gloucester & Newburyport Cities PUMA, Massachusetts/MA",362,19,0,14,21,90,376,40,90,111,19,130,506,72,3,22,4,4,4,18,0,74,26,8,18
25,Massachusetts/MA,2500704,"Essex County (South)--Lynn City, Swampscott & Nahant Towns PUMA, Massachusetts/MA",167,204,145,25,68,0,192,272,145,68,349,417,609,27,4,11,57,11,33,0,24,32,68,45,24
25,Massachusetts/MA,2501000,"Peabody City, Danvers, Reading, North Reading & Lynnfield Towns PUMA, Massachusetts/MA",41,19,19,0,47,0,41,66,19,47,38,85,126,33,0,37,30,37,15,0,15,33,67,52,15
25,Massachusetts/MA,2501300,"Billerica, Andover, Tewksbury & Wilmington Towns PUMA, Massachusetts/MA",145,0,0,13,14,0,158,14,0,14,0,14,172,84,8,8,0,8,0,0,0,92,8,8,0
25,Massachusetts/MA,2501400,"Middlesex (West Central) & Worcester (East) Counties PUMA, Massachusetts/MA",100,0,80,0,0,0,100,0,80,0,80,80,180,56,0,0,44,0,0,0,44,56,44,0,44
25,Massachusetts/MA,2501600,"Hampden (West & East) & Hampshire (South) Counties--Northampton City PUMA, Massachusetts/MA",230,0,0,0,5,0,230,5,0,5,0,5,235,98,0,2,0,2,0,0,0,98,2,2,0
25,Massachusetts/MA,2501900,"Hampden County (Central)--Springfield City PUMA, Massachusetts/MA",75,0,213,388,38,0,463,38,213,38,213,251,714,11,54,5,30,5,0,0,30,65,35,5,30
25,Massachusetts/MA,2501901,"Hampden County (West of Springfield City)--Westfield & Holyoke Cities PUMA, Massachusetts/MA",66,0,0,86,0,0,152,0,0,0,0,0,152,43,57,0,0,0,0,0,0,100,0,0,0
25,Massachusetts/MA,2501902,"Hampden County (East of Springfield City)--Chicopee City PUMA, Massachusetts/MA",146,0,0,0,40,0,146,40,0,40,0,40,186,78,0,22,0,22,0,0,0,78,22,22,0
25,Massachusetts/MA,2502400,"Middlesex (Far Southwest), Norfolk (Northwest) & Worcester (Far East) Counties PUMA, Massachusetts/MA",85,0,0,24,0,0,109,0,0,0,0,0,109,78,22,0,0,0,0,0,0,100,0,0,0
25,Massachusetts/MA,2502800,"Woburn, Melrose Cities, Saugus, Wakefield & Stoneham Towns PUMA, Massachusetts/MA",119,25,0,33,0,0,152,25,0,0,25,25,177,67,19,0,14,0,14,0,0,86,14,14,0
25,Massachusetts/MA,2503301,"Boston City--Allston, Brighton & Fenway PUMA, Massachusetts/MA",47,0,0,0,0,12,47,0,12,12,0,12,59,80,0,20,0,0,0,20,0,80,20,0,20
25,Massachusetts/MA,2503302,"Boston City--Back Bay, Beacon Hill, Charlestown, East Boston, Central & South End PUMA, Massachusetts/MA",22,18,238,26,28,97,48,46,335,125,256,381,429,5,6,29,60,7,4,23,55,11,89,11,78
25,Massachusetts/MA,2503303,"Boston City--Dorchester & South Boston PUMA, Massachusetts/MA",100,0,0,15,0,0,115,0,0,0,0,0,115,87,13,0,0,0,0,0,0,100,0,0,0
25,Massachusetts/MA,2503304,"Boston City--Mattapan & Roxbury PUMA, Massachusetts/MA",101,15,56,101,14,78,202,29,134,92,71,163,365,28,28,25,19,4,4,21,15,55,45,8,37
25,Massachusetts/MA,2503305,"Boston City--Hyde Park, Jamaica Plain, Roslindale & West Roxbury PUMA, Massachusetts/MA",81,0,75,0,61,0,81,61,75,61,75,136,217,37,0,28,35,28,0,0,35,37,63,28,35
25,Massachusetts/MA,2503306,"Suffolk County (North)--Revere, Chelsea & Winthrop Town Cities PUMA, Massachusetts/MA",39,117,203,61,0,0,100,117,203,0,320,320,420,9,15,0,76,0,28,0,48,24,76,28,48
25,Massachusetts/MA,2503400,"Middlesex (Southeast) & Norfolk (Northeast) Counties--Newton City & Brookline Town PUMA, Massachusetts/MA",0,0,0,0,22,0,0,22,0,22,0,22,22,0,0,100,0,100,0,0,0,0,100,100,0
25,Massachusetts/MA,2503500,"Norfolk (Northeast) & Middlesex (Southeast) Counties (West of Boston City) PUMA, Massachusetts/MA",50,0,0,0,0,0,50,0,0,0,0,0,50,100,0,0,0,0,0,0,0,100,0,0,0
25,Massachusetts/MA,2503601,"Norfolk County (Southwest)--Greater Franklin Town City PUMA, Massachusetts/MA",93,0,0,0,0,0,93,0,0,0,0,0,93,100,0,0,0,0,0,0,0,100,0,0,0
25,Massachusetts/MA,2503602,"Norfolk County (Central)--Randolph, Norwood, Dedham, Canton & Holbrook Towns PUMA, Massachusetts/MA",61,0,26,49,8,28,110,8,54,36,26,62,172,35,28,21,15,5,0,16,15,64,36,5,31
25,Massachusetts/MA,2503603,"Norfolk County (Northeast)--Quincy City & Milton Town PUMA, Massachusetts/MA",0,0,20,0,12,163,0,12,183,175,20,195,195,0,0,90,10,6,0,84,10,0,100,6,94
25,Massachusetts/MA,2503900,"Weymouth Town, Braintree Town Cities, Hingham, Hull & Cohasset Towns PUMA, Massachusetts/MA",54,0,0,0,0,0,54,0,0,0,0,0,54,100,0,0,0,0,0,0,0,100,0,0,0
25,Massachusetts/MA,2504000,"Plymouth & Norfolk Counties--Brockton City, Stoughton & Avon Towns PUMA, Massachusetts/MA",145,0,0,0,108,106,145,108,106,214,0,214,359,40,0,60,0,30,0,30,0,40,60,30,30
25,Massachusetts/MA,2504200,"Attleboro City, North Attleborough, Swansea, Seekonk, Rehoboth & Plainville Towns PUMA, Massachusetts/MA",44,0,0,16,0,0,60,0,0,0,0,0,60,73,27,0,0,0,0,0,0,100,0,0,0
25,Massachusetts/MA,2504301,"Bristol (Outside New Bedford City) & Plymouth (South) Counties PUMA, Massachusetts/MA",188,0,0,0,11,0,188,11,0,11,0,11,199,94,0,6,0,6,0,0,0,94,6,6,0
25,Massachusetts/MA,2504302,"Bristol County (Central)--Fall River City & Somerset Town PUMA, Massachusetts/MA",206,0,57,0,81,92,206,81,149,173,57,230,436,47,0,40,13,19,0,21,13,47,53,19,34
25,Massachusetts/MA,2504303,"Bristol County--Taunton City, Mansfield, Norton, Raynam, Dighton & Berkley Towns PUMA, Massachusetts/MA",66,0,0,0,0,0,66,0,0,0,0,0,66,100,0,0,0,0,0,0,0,100,0,0,0
25,Massachusetts/MA,2504500,"Bristol County (South)--New Bedford City & Fairhaven Town PUMA, Massachusetts/MA",97,48,102,47,36,0,144,84,102,36,150,186,330,29,14,11,45,11,15,0,31,44,56,25,31
25,Massachusetts/MA,2504700,"Barnstable County (West)--Inner Cape Cod Towns & Barnstable Town City PUMA, Massachusetts/MA",78,0,0,0,78,0,78,78,0,78,0,78,156,50,0,50,0,50,0,0,0,50,50,50,0
25,Massachusetts/MA,2504800,"Barnstable (East), Dukes & Nantucket Counties--Outer Cape Cod Towns PUMA, Massachusetts/MA",72,0,0,5,0,96,77,0,96,96,0,96,173,42,3,55,0,0,0,55,0,45,55,0,55
25,Massachusetts/MA,2504901,"Plymouth & Bristol Counties (Outside Brockton City) PUMA, Massachusetts/MA",101,0,0,0,10,0,101,10,0,10,0,10,111,91,0,9,0,9,0,0,0,91,9,9,0
25,Massachusetts/MA,2504902,"Plymouth County (Central) PUMA, Massachusetts/MA",194,0,0,0,0,0,194,0,0,0,0,0,194,100,0,0,0,0,0,0,0,100,0,0,0
25,Massachusetts/MA,2504903,"Plymouth County (East)--Plymouth, Marshfield, Scituate, Duxbury & Kingston Towns PUMA, Massachusetts/MA",255,0,0,0,0,0,255,0,0,0,0,0,255,100,0,0,0,0,0,0,0,100,0,0,0
26,Michigan/MI,2600100,"Western Upper Peninsula PUMA, Michigan/MI",207,0,0,14,0,0,221,0,0,0,0,0,221,94,6,0,0,0,0,0,0,100,0,0,0
26,Michigan/MI,2600200,"Eastern Upper Peninsula PUMA, Michigan/MI",318,25,22,5,0,0,323,25,22,0,47,47,370,86,1,0,13,0,7,0,6,87,13,7,6
26,Michigan/MI,2600300,"Northeast Lower Peninsula PUMA, Michigan/MI",401,33,138,0,0,0,401,33,138,0,171,171,572,70,0,0,30,0,6,0,24,70,30,6,24
26,Michigan/MI,2600400,"Northwest Lower Peninsula (East) PUMA, Michigan/MI",996,0,120,83,0,23,1079,0,143,23,120,143,1222,82,7,2,10,0,0,2,10,88,12,0,12
26,Michigan/MI,2600500,"Northwest Lower Peninsula (West) PUMA, Michigan/MI",827,77,39,98,0,57,925,77,96,57,116,173,1098,75,9,5,11,0,7,5,4,84,16,7,9
26,Michigan/MI,2600600,"Newaygo, Mason, Oceana & Lake Counties PUMA, Michigan/MI",1502,44,309,203,0,101,1705,44,410,101,353,454,2159,70,9,5,16,0,2,5,14,79,21,2,19
26,Michigan/MI,2600700,"Muskegon County PUMA, Michigan/MI",978,0,35,0,0,0,978,0,35,0,35,35,1013,97,0,0,3,0,0,0,3,97,3,0,3
26,Michigan/MI,2600801,"Ottawa County (West) PUMA, Michigan/MI",615,274,937,316,160,201,931,434,1138,361,1211,1572,2503,25,13,14,48,6,11,8,37,37,63,17,45
26,Michigan/MI,2600802,"Ottawa County (East) PUMA, Michigan/MI",608,120,104,161,0,0,769,120,104,0,224,224,993,61,16,0,23,0,12,0,10,77,23,12,10
26,Michigan/MI,2600900,"Allegan County PUMA, Michigan/MI",807,38,320,26,0,0,833,38,320,0,358,358,1191,68,2,0,30,0,3,0,27,70,30,3,27
26,Michigan/MI,2601001,"Kent County (Southwest) PUMA, Michigan/MI",994,97,549,18,0,38,1012,97,587,38,646,684,1696,59,1,2,38,0,6,2,32,60,40,6,35
26,Michigan/MI,2601002,"Kent County (Central)--Grand Rapids City Area PUMA, Michigan/MI",521,243,864,104,78,380,625,321,1244,458,1107,1565,2190,24,5,21,51,4,11,17,39,29,71,15,57
26,Michigan/MI,2601003,"Kent County (Southeast) PUMA, Michigan/MI",336,0,334,129,18,212,465,18,546,230,334,564,1029,33,13,22,32,2,0,21,32,45,55,2,53
26,Michigan/MI,2601004,"Kent County (North) PUMA, Michigan/MI",910,58,38,0,0,17,910,58,55,17,96,113,1023,89,0,2,9,0,6,2,4,89,11,6,5
26,Michigan/MI,2601100,"Ionia, Montcalm, Mecosta & Osceola Counties PUMA, Michigan/MI",1945,32,84,77,0,0,2022,32,84,0,116,116,2138,91,4,0,5,0,1,0,4,95,5,1,4
26,Michigan/MI,2601200,"Isabella, Gratiot & Clare Counties PUMA, Michigan/MI",873,0,23,62,0,0,935,0,23,0,23,23,958,91,6,0,2,0,0,0,2,98,2,0,2
26,Michigan/MI,2601300,"Iosco, Gladwin, Roscommon, Ogemaw & Arenac Counties PUMA, Michigan/MI",382,0,8,10,0,7,392,0,15,7,8,15,407,94,2,2,2,0,0,2,2,96,4,0,4
26,Michigan/MI,2601400,"Bay & Midland Counties PUMA, Michigan/MI",369,5,32,99,0,0,468,5,32,0,37,37,505,73,20,0,7,0,1,0,6,93,7,1,6
26,Michigan/MI,2601500,"Saginaw County PUMA, Michigan/MI",697,0,112,174,0,0,871,0,112,0,112,112,983,71,18,0,11,0,0,0,11,89,11,0,11
26,Michigan/MI,2601600,"Tuscola, Sanilac & Huron Counties PUMA, Michigan/MI",1972,22,101,106,0,0,2078,22,101,0,123,123,2201,90,5,0,6,0,1,0,5,94,6,1,5
26,Michigan/MI,2601701,"Genesee (East) & Lapeer Counties PUMA, Michigan/MI",501,0,413,42,0,36,543,0,449,36,413,449,992,51,4,4,42,0,0,4,42,55,45,0,45
26,Michigan/MI,2601702,"Genesee County (Central, Outside Flint City) PUMA, Michigan/MI",106,0,0,0,0,20,106,0,20,20,0,20,126,84,0,16,0,0,0,16,0,84,16,0,16
26,Michigan/MI,2601703,"Genesee County (Central)--Flint City Area PUMA, Michigan/MI",166,32,0,31,0,0,197,32,0,0,32,32,229,72,14,0,14,0,14,0,0,86,14,14,0
26,Michigan/MI,2601704,"Genesee (West) & Shiawassee Counties PUMA, Michigan/MI",597,0,3,11,0,0,608,0,3,0,3,3,611,98,2,0,0,0,0,0,0,100,0,0,0
26,Michigan/MI,2601801,"Ingham County (South & East) PUMA, Michigan/MI",407,25,28,18,135,0,425,160,28,135,53,188,613,66,3,22,9,22,4,0,5,69,31,26,5
26,Michigan/MI,2601802,"Ingham County (Northwest) PUMA, Michigan/MI",101,0,0,0,0,0,101,0,0,0,0,0,101,100,0,0,0,0,0,0,0,100,0,0,0
26,Michigan/MI,2601900,"Eaton & Clinton Counties PUMA, Michigan/MI",630,27,168,87,0,30,717,27,198,30,195,225,942,67,9,3,21,0,3,3,18,76,24,3,21
26,Michigan/MI,2602000,"Calhoun & Barry Counties PUMA, Michigan/MI",1098,59,37,32,30,75,1130,89,112,105,96,201,1331,82,2,8,7,2,4,6,3,85,15,7,8
26,Michigan/MI,2602101,"Kalamazoo County (Outer) PUMA, Michigan/MI",378,0,81,99,0,0,477,0,81,0,81,81,558,68,18,0,15,0,0,0,15,85,15,0,15
26,Michigan/MI,2602102,"Kalamazoo County (Central)--Kalamazoo & Portage Cities Area PUMA, Michigan/MI",396,0,25,132,0,0,528,0,25,0,25,25,553,72,24,0,5,0,0,0,5,95,5,0,5
26,Michigan/MI,2602200,"St. Joseph & Branch Counties PUMA, Michigan/MI",649,94,169,126,0,0,775,94,169,0,263,263,1038,63,12,0,25,0,9,0,16,75,25,9,16
26,Michigan/MI,2602300,"Van Buren & Cass Counties PUMA, Michigan/MI",875,28,655,81,16,36,956,44,691,52,683,735,1691,52,5,3,40,1,2,2,39,57,43,3,41
26,Michigan/MI,2602400,"Berrien County PUMA, Michigan/MI",288,43,377,70,26,12,358,69,389,38,420,458,816,35,9,5,51,3,5,1,46,44,56,8,48
26,Michigan/MI,2602500,"Lenawee & Hillsdale Counties PUMA, Michigan/MI",997,8,215,46,0,0,1043,8,215,0,223,223,1266,79,4,0,18,0,1,0,17,82,18,1,17
26,Michigan/MI,2602600,"Jackson County PUMA, Michigan/MI",422,0,0,32,0,0,454,0,0,0,0,0,454,93,7,0,0,0,0,0,0,100,0,0,0
26,Michigan/MI,2602701,"Washtenaw County (West, Northeast & Southeast) PUMA, Michigan/MI",169,0,0,0,0,0,169,0,0,0,0,0,169,100,0,0,0,0,0,0,0,100,0,0,0
26,Michigan/MI,2602702,"Washtenaw County (East Central)--Ann Arbor City Area PUMA, Michigan/MI",69,0,6,0,19,19,69,19,25,38,6,44,113,61,0,34,5,17,0,17,5,61,39,17,22
26,Michigan/MI,2602703,"Washtenaw County (East Central, Outside Ann Arbor City) PUMA, Michigan/MI",197,0,0,31,0,51,228,0,51,51,0,51,279,71,11,18,0,0,0,18,0,82,18,0,18
26,Michigan/MI,2602800,"Livingston County PUMA, Michigan/MI",182,0,13,2,17,0,184,17,13,17,13,30,214,85,1,8,6,8,0,0,6,86,14,8,6
26,Michigan/MI,2602901,"Oakland County (West) PUMA, Michigan/MI",19,0,0,0,0,0,19,0,0,0,0,0,19,100,0,0,0,0,0,0,0,100,0,0,0
26,Michigan/MI,2602902,"Oakland County (Northeast) PUMA, Michigan/MI",155,0,27,0,0,0,155,0,27,0,27,27,182,85,0,0,15,0,0,0,15,85,15,0,15
26,Michigan/MI,2602903,"Oakland County (East Central)--Troy & Rochester Area PUMA, Michigan/MI",23,0,33,0,0,0,23,0,33,0,33,33,56,41,0,0,59,0,0,0,59,41,59,0,59
26,Michigan/MI,2602904,"Oakland County (Central) PUMA, Michigan/MI",47,0,0,21,0,0,68,0,0,0,0,0,68,69,31,0,0,0,0,0,0,100,0,0,0
26,Michigan/MI,2602905,"Oakland County (Southwest) PUMA, Michigan/MI",31,0,0,0,0,0,31,0,0,0,0,0,31,100,0,0,0,0,0,0,0,100,0,0,0
26,Michigan/MI,2602907,"Oakland County (South Central)--Farmington & Southfield Area PUMA, Michigan/MI",16,12,0,84,0,32,100,12,32,32,12,44,144,11,58,22,8,0,8,22,0,69,31,8,22
26,Michigan/MI,2602908,"Oakland County (Southeast) PUMA, Michigan/MI",242,0,0,0,0,0,242,0,0,0,0,0,242,100,0,0,0,0,0,0,0,100,0,0,0
26,Michigan/MI,2603001,"Macomb County (North) PUMA, Michigan/MI",147,0,6,0,0,0,147,0,6,0,6,6,153,96,0,0,4,0,0,0,4,96,4,0,4
26,Michigan/MI,2603002,"Macomb County (Central) PUMA, Michigan/MI",21,0,3,0,31,0,21,31,3,31,3,34,55,38,0,56,5,56,0,0,5,38,62,56,5
26,Michigan/MI,2603003,"Macomb County (Southwest)--Sterling Heights City PUMA, Michigan/MI",86,0,24,0,149,0,86,149,24,149,24,173,259,33,0,58,9,58,0,0,9,33,67,58,9
26,Michigan/MI,2603004,"Macomb County (Southeast)--Mount Clemens & Fraser Area PUMA, Michigan/MI",117,0,12,31,0,29,148,0,41,29,12,41,189,62,16,15,6,0,0,15,6,78,22,0,22
26,Michigan/MI,2603005,"Macomb County (Southeast)--St. Clair Shores, Roseville & Eastpointe Area PUMA, Michigan/MI",209,0,22,0,0,0,209,0,22,0,22,22,231,90,0,0,10,0,0,0,10,90,10,0,10
26,Michigan/MI,2603006,"Macomb County (Southwest)--Warren & Center Line Cities PUMA, Michigan/MI",142,0,3,9,0,83,151,0,86,83,3,86,237,60,4,35,1,0,0,35,1,64,36,0,36
26,Michigan/MI,2603100,"St. Clair County PUMA, Michigan/MI",400,47,40,47,0,0,447,47,40,0,87,87,534,75,9,0,16,0,9,0,7,84,16,9,7
26,Michigan/MI,2603201,"Wayne County (Northwest) PUMA, Michigan/MI",137,0,0,17,44,0,154,44,0,44,0,44,198,69,9,22,0,22,0,0,0,78,22,22,0
26,Michigan/MI,2603202,"Wayne County (North Central)--Livonia City & Redford Charter Township PUMA, Michigan/MI",38,0,0,0,32,0,38,32,0,32,0,32,70,54,0,46,0,46,0,0,0,54,46,46,0
26,Michigan/MI,2603203,"Wayne County (Central)--Dearborn & Dearborn Heights Cities PUMA, Michigan/MI",142,58,0,0,16,0,142,74,0,16,58,74,216,66,0,7,27,7,27,0,0,66,34,34,0
26,Michigan/MI,2603204,"Wayne County (Central)--Westland, Garden City, Inkster & Wayne Cities PUMA, Michigan/MI",126,0,0,0,0,0,126,0,0,0,0,0,126,100,0,0,0,0,0,0,0,100,0,0,0
26,Michigan/MI,2603205,"Wayne County (Southwest) PUMA, Michigan/MI",230,0,61,28,0,0,258,0,61,0,61,61,319,72,9,0,19,0,0,0,19,81,19,0,19
26,Michigan/MI,2603206,"Wayne County (Southeast)--Downriver Area (South) PUMA, Michigan/MI",115,0,0,17,0,0,132,0,0,0,0,0,132,87,13,0,0,0,0,0,0,100,0,0,0
26,Michigan/MI,2603207,"Wayne County (Southeast)--Downriver Area (North) PUMA, Michigan/MI",159,66,107,81,0,0,240,66,107,0,173,173,413,38,20,0,42,0,16,0,26,58,42,16,26
26,Michigan/MI,2603208,"Detroit City (Northwest) PUMA, Michigan/MI",223,0,69,25,0,0,248,0,69,0,69,69,317,70,8,0,22,0,0,0,22,78,22,0,22
26,Michigan/MI,2603209,"Detroit City (North Central) PUMA, Michigan/MI",520,0,35,0,0,0,520,0,35,0,35,35,555,94,0,0,6,0,0,0,6,94,6,0,6
26,Michigan/MI,2603210,"Detroit City (Northeast) PUMA, Michigan/MI",225,0,0,0,0,0,225,0,0,0,0,0,225,100,0,0,0,0,0,0,0,100,0,0,0
26,Michigan/MI,2603211,"Detroit City (South Central & Southeast) PUMA, Michigan/MI",62,0,19,37,0,0,99,0,19,0,19,19,118,53,31,0,16,0,0,0,16,84,16,0,16
26,Michigan/MI,2603212,"Detroit City (Southwest) PUMA, Michigan/MI",12,28,503,255,0,0,267,28,503,0,531,531,798,2,32,0,67,0,4,0,63,33,67,4,63
26,Michigan/MI,2603213,"Wayne County (Northeast)--I-94 Corridor PUMA, Michigan/MI",50,0,0,0,0,41,50,0,41,41,0,41,91,55,0,45,0,0,0,45,0,55,45,0,45
26,Michigan/MI,2603300,"Monroe County PUMA, Michigan/MI",330,47,66,5,0,14,335,47,80,14,113,127,462,71,1,3,24,0,10,3,14,73,27,10,17
27,Minnesota/MN,2700100,"Clay, Polk, Roseau, Pennington, Marshall, Norman, Kittson & Red Lake Counties PUMA, Minnesota/MN",1851,7,38,114,0,6,1965,7,44,6,45,51,2016,92,6,0,2,0,0,0,2,97,3,0,2
27,Minnesota/MN,2700200,"Beltrami, Becker, Hubbard, Clearwater, Mahnomen & Lake of the Woods Counties PUMA, Minnesota/MN",1273,0,98,53,0,79,1326,0,177,79,98,177,1503,85,4,5,7,0,0,5,7,88,12,0,12
27,Minnesota/MN,2700300,"Itasca, Carlton (South), Cass & Aitkin Counties--Grand Rapids City PUMA, Minnesota/MN",273,2,15,10,0,0,283,2,15,0,17,17,300,91,3,0,6,0,1,0,5,94,6,1,5
27,Minnesota/MN,2700400,"St. Louis (North), Koochiching, Lake & Cook Counties--Hibbing & Cloquet Cities PUMA, Minnesota/MN",194,0,0,18,0,2,212,0,2,2,0,2,214,91,8,1,0,0,0,1,0,99,1,0,1
27,Minnesota/MN,2700500,"St. Louis County (Southeast)--Duluth, Hermantown & Proctor Cities PUMA, Minnesota/MN",73,0,0,1,0,0,74,0,0,0,0,0,74,99,1,0,0,0,0,0,0,100,0,0,0
27,Minnesota/MN,2700600,"Chisago, Isanti, Pine, Mille Lacs & Kanabec Counties PUMA, Minnesota/MN",712,0,34,73,9,0,785,9,34,9,34,43,828,86,9,1,4,1,0,0,4,95,5,1,4
27,Minnesota/MN,2700700,"Crow Wing, Morrison, Todd & Wadena Counties PUMA, Minnesota/MN",1984,0,239,7,9,0,1991,9,239,9,239,248,2239,89,0,0,11,0,0,0,11,89,11,0,11
27,Minnesota/MN,2700800,"West Central Minnesota PUMA, Minnesota/MN",2226,86,400,54,67,118,2280,153,518,185,486,671,2951,75,2,6,16,2,3,4,14,77,23,5,18
27,Minnesota/MN,2700900,"Stearns County--St. Cloud City PUMA, Minnesota/MN",1631,105,344,131,0,134,1762,105,478,134,449,583,2345,70,6,6,19,0,4,6,15,75,25,4,20
27,Minnesota/MN,2701000,"Sherburne & Benton Counties PUMA, Minnesota/MN",588,0,0,0,0,0,588,0,0,0,0,0,588,100,0,0,0,0,0,0,0,100,0,0,0
27,Minnesota/MN,2701101,"Anoka County (Northwest)--Andover, Ramsey, Anoka & East Bethel Cities PUMA, Minnesota/MN",239,0,0,76,0,0,315,0,0,0,0,0,315,76,24,0,0,0,0,0,0,100,0,0,0
27,Minnesota/MN,2701102,"Anoka County (Southwest)--Coon Rapids, Fridley & Columbia Heights Cities PUMA, Minnesota/MN",254,15,18,0,23,123,254,38,141,146,33,179,433,59,0,34,8,5,3,28,4,59,41,9,33
27,Minnesota/MN,2701103,"Anoka County (East)--Blaine, Lino Lakes & Ham Lake Cities PUMA, Minnesota/MN",246,0,0,25,146,113,271,146,113,259,0,259,530,46,5,49,0,28,0,21,0,51,49,28,21
27,Minnesota/MN,2701201,"Washington County (North)--Oakdale, Forest Lake, Stillwater & Hugo Cities PUMA, Minnesota/MN",309,0,55,0,0,0,309,0,55,0,55,55,364,85,0,0,15,0,0,0,15,85,15,0,15
27,Minnesota/MN,2701202,"Washington County (South)--Woodbury & Cottage Grove Cities PUMA, Minnesota/MN",204,0,19,0,0,46,204,0,65,46,19,65,269,76,0,17,7,0,0,17,7,76,24,0,24
27,Minnesota/MN,2701301,"Ramsey County (North)--Shoreview, White Bear Lake & New Brighton Cities PUMA, Minnesota/MN",187,0,88,0,56,0,187,56,88,56,88,144,331,56,0,17,27,17,0,0,27,56,44,17,27
27,Minnesota/MN,2701302,"Ramsey County (Central & Far Southeast)--Maplewood, Roseville & North St. Paul Cities PUMA, Minnesota/MN",186,0,105,0,23,0,186,23,105,23,105,128,314,59,0,7,33,7,0,0,33,59,41,7,33
27,Minnesota/MN,2701303,"Ramsey County (Southeast)--St. Paul City (East) PUMA, Minnesota/MN",157,53,10,39,99,318,196,152,328,417,63,480,676,23,6,62,9,15,8,47,1,29,71,22,49
27,Minnesota/MN,2701304,"Ramsey County (Southwest)--St. Paul City (West) PUMA, Minnesota/MN",33,11,33,0,51,427,33,62,460,478,44,522,555,6,0,86,8,9,2,77,6,6,94,11,83
27,Minnesota/MN,2701401,"Hennepin County (West)--Champlin, Rogers Cities & Lake Minnetonka PUMA, Minnesota/MN",187,0,0,0,0,0,187,0,0,0,0,0,187,100,0,0,0,0,0,0,0,100,0,0,0
27,Minnesota/MN,2701402,"Hennepin County--Plymouth, Maple Grove (West) & Medicine Lake Cities PUMA, Minnesota/MN",303,0,0,52,0,0,355,0,0,0,0,0,355,85,15,0,0,0,0,0,0,100,0,0,0
27,Minnesota/MN,2701403,"Hennepin County--Brooklyn Park, Maple Grove (East) & Osseo Cities PUMA, Minnesota/MN",199,0,42,0,0,51,199,0,93,51,42,93,292,68,0,17,14,0,0,17,14,68,32,0,32
27,Minnesota/MN,2701404,"Hennepin County--Brooklyn Center, Golden Valley, New Hope & Robbinsdale Cities PUMA, Minnesota/MN",101,0,107,145,28,53,246,28,160,81,107,188,434,23,33,19,25,6,0,12,25,57,43,6,37
27,Minnesota/MN,2701405,"Hennepin County--Minneapolis (North) & St. Anthony Cities PUMA, Minnesota/MN",191,0,40,44,161,49,235,161,89,210,40,250,485,39,9,43,8,33,0,10,8,48,52,33,18
27,Minnesota/MN,2701406,"Hennepin County--Minneapolis City (Southeast) PUMA, Minnesota/MN",324,0,257,0,86,49,324,86,306,135,257,392,716,45,0,19,36,12,0,7,36,45,55,12,43
27,Minnesota/MN,2701407,"Hennepin County--Minneapolis City (Southwest) PUMA, Minnesota/MN",213,0,31,0,0,0,213,0,31,0,31,31,244,87,0,0,13,0,0,0,13,87,13,0,13
27,Minnesota/MN,2701408,"Hennepin County--Edina, St. Louis Park & Hopkins Cities PUMA, Minnesota/MN",84,41,0,0,0,0,84,41,0,0,41,41,125,67,0,0,33,0,33,0,0,67,33,33,0
27,Minnesota/MN,2701409,"Hennepin County--Eden Prairie & Minnetonka Cities PUMA, Minnesota/MN",41,0,31,0,58,0,41,58,31,58,31,89,130,32,0,45,24,45,0,0,24,32,68,45,24
27,Minnesota/MN,2701410,"Hennepin County--Bloomington & Richfield Cities PUMA, Minnesota/MN",21,12,80,0,0,0,21,12,80,0,92,92,113,19,0,0,81,0,11,0,71,19,81,11,71
27,Minnesota/MN,2701501,"Dakota County (North)--Eagan, Inver Grove Heights & South St. Paul Cities PUMA, Minnesota/MN",318,0,0,12,30,20,330,30,20,50,0,50,380,84,3,13,0,8,0,5,0,87,13,8,5
27,Minnesota/MN,2701502,"Dakota County (South)--Lakeville, Hastings, Rosemount & Farmington Cities PUMA, Minnesota/MN",845,0,19,43,414,57,888,414,76,471,19,490,1378,61,3,34,1,30,0,4,1,64,36,30,6
27,Minnesota/MN,2701503,"Dakota County (West)--Burnsville & Apple Valley Cities PUMA, Minnesota/MN",161,0,51,0,0,5,161,0,56,5,51,56,217,74,0,2,24,0,0,2,24,74,26,0,26
27,Minnesota/MN,2701600,"Scott County (East)--Shakopee, Savage & Prior Lake Cities PUMA, Minnesota/MN",392,0,3,80,0,70,472,0,73,70,3,73,545,72,15,13,1,0,0,13,1,87,13,0,13
27,Minnesota/MN,2701700,"Carver & Scott (West) Counties PUMA, Minnesota/MN",225,0,42,0,20,0,225,20,42,20,42,62,287,78,0,7,15,7,0,0,15,78,22,7,15
27,Minnesota/MN,2701800,"Wright County PUMA, Minnesota/MN",709,0,96,61,60,14,770,60,110,74,96,170,940,75,6,8,10,6,0,1,10,82,18,6,12
27,Minnesota/MN,2701900,"Kandiyohi, McLeod, Meeker, Renville & Sibley Counties PUMA, Minnesota/MN",1924,67,685,163,88,176,2087,155,861,264,752,1016,3103,62,5,9,24,3,2,6,22,67,33,5,28
27,Minnesota/MN,2702000,"Brown, Lyon, Redwood, Chippewa, Yellow Medicine, Lac qui Parle & Lincoln Counties PUMA, Minnesota/MN",2079,50,95,74,17,88,2153,67,183,105,145,250,2403,87,3,4,6,1,2,4,4,90,10,3,8
27,Minnesota/MN,2702100,"Southwest Minnesota PUMA, Minnesota/MN",2690,212,1218,181,429,429,2871,641,1647,858,1430,2288,5159,52,4,17,28,8,4,8,24,56,44,12,32
27,Minnesota/MN,2702200,"Blue Earth, Nicollet & Waseca Counties--Mankato City PUMA, Minnesota/MN",1086,0,186,73,139,2,1159,139,188,141,186,327,1486,73,5,9,13,9,0,0,13,78,22,9,13
27,Minnesota/MN,2702300,"Rice, Goodhue & Le Sueur Counties PUMA, Minnesota/MN",1916,53,300,86,101,156,2002,154,456,257,353,610,2612,73,3,10,14,4,2,6,11,77,23,6,17
27,Minnesota/MN,2702400,"Mower, Steele, Freeborn & Dodge Counties PUMA, Minnesota/MN",2145,627,702,148,67,434,2293,694,1136,501,1329,1830,4123,52,4,12,32,2,15,11,17,56,44,17,28
27,Minnesota/MN,2702500,"Olmsted County--Rochester City PUMA, Minnesota/MN",759,29,29,70,93,47,829,122,76,140,58,198,1027,74,7,14,6,9,3,5,3,81,19,12,7
27,Minnesota/MN,2702600,"Winona, Wabasha, Fillmore & Houston Counties--Winona City PUMA, Minnesota/MN",1846,54,311,57,0,0,1903,54,311,0,365,365,2268,81,3,0,16,0,2,0,14,84,16,2,14
28,Mississippi/MS,2800100,"North Delta Region--DeSoto County--Southaven City PUMA, Mississippi/MS",325,0,43,29,0,0,354,0,43,0,43,43,397,82,7,0,11,0,0,0,11,89,11,0,11
28,Mississippi/MS,2800200,"Northeast Region--Marshall, Alcorn, Prentiss, Tippah, Tishomingo & Benton Counties PUMA, Mississippi/MS",550,23,4,7,0,0,557,23,4,0,27,27,584,94,1,0,5,0,4,0,1,95,5,4,1
28,Mississippi/MS,2800300,"North Delta Region--Panola, Tate, Coahoma, Tallahatchie, Tunica & Quitman Counties PUMA, Mississippi/MS",1095,0,25,0,9,0,1095,9,25,9,25,34,1129,97,0,1,2,1,0,0,2,97,3,1,2
28,Mississippi/MS,2800400,"Three Rivers Region--Lafayette, Monroe, Itawamba, Chickasaw & Calhoun Counties PUMA, Mississippi/MS",634,31,63,0,3,0,634,34,63,3,94,97,731,87,0,0,13,0,4,0,9,87,13,5,9
28,Mississippi/MS,2800500,"Three Rivers Region--Lee, Pontotoc & Union Counties--Tupelo City PUMA, Mississippi/MS",249,0,54,59,0,0,308,0,54,0,54,54,362,69,16,0,15,0,0,0,15,85,15,0,15
28,Mississippi/MS,2800600,"Golden Triangle Region--Starkville, Columbus & West Point Cities PUMA, Mississippi/MS",974,0,0,2,0,0,976,0,0,0,0,0,976,100,0,0,0,0,0,0,0,100,0,0,0
28,Mississippi/MS,2800700,"North Central Region PUMA, Mississippi/MS",1044,0,89,0,0,0,1044,0,89,0,89,89,1133,92,0,0,8,0,0,0,8,92,8,0,8
28,Mississippi/MS,2800800,"South Delta Region PUMA, Mississippi/MS",1165,0,33,40,0,0,1205,0,33,0,33,33,1238,94,3,0,3,0,0,0,3,97,3,0,3
28,Mississippi/MS,2800900,"Central Region--Madison & Yazoo Counties PUMA, Mississippi/MS",709,0,69,0,0,0,709,0,69,0,69,69,778,91,0,0,9,0,0,0,9,91,9,0,9
28,Mississippi/MS,2801000,"Central Region--Jackson (West & South) & Clinton (South & East) Cities PUMA, Mississippi/MS",181,0,0,5,0,0,186,0,0,0,0,0,186,97,3,0,0,0,0,0,0,100,0,0,0
28,Mississippi/MS,2801100,"Central Region--Jackson City (East & Central) PUMA, Mississippi/MS",405,0,0,0,0,0,405,0,0,0,0,0,405,100,0,0,0,0,0,0,0,100,0,0,0
28,Mississippi/MS,2801200,"Central Region--Hinds (West), Warren & Copiah Counties--Vicksburg City PUMA, Mississippi/MS",693,0,0,26,0,0,719,0,0,0,0,0,719,96,4,0,0,0,0,0,0,100,0,0,0
28,Mississippi/MS,2801300,"Central Region--Rankin & Simpson Counties PUMA, Mississippi/MS",753,0,0,0,6,0,753,6,0,6,0,6,759,99,0,1,0,1,0,0,0,99,1,1,0
28,Mississippi/MS,2801400,"East Central Region--Neshoba, Scott, Leake, Jasper, Smith & Kemper Counties PUMA, Mississippi/MS",3147,102,397,52,0,0,3199,102,397,0,499,499,3698,85,1,0,13,0,3,0,11,87,13,3,11
28,Mississippi/MS,2801500,"East Central Region--Lauderdale, Newton & Clarke Counties--Meridian City PUMA, Mississippi/MS",759,0,10,0,0,0,759,0,10,0,10,10,769,99,0,0,1,0,0,0,1,99,1,0,1
28,Mississippi/MS,2801600,"Southwest Region PUMA, Mississippi/MS",1295,0,0,0,0,0,1295,0,0,0,0,0,1295,100,0,0,0,0,0,0,0,100,0,0,0
28,Mississippi/MS,2801700,"South Region--Jones, Wayne, Covington, Greene & Jefferson Davis Counties PUMA, Mississippi/MS",1313,37,141,24,0,0,1337,37,141,0,178,178,1515,87,2,0,12,0,2,0,9,88,12,2,9
28,Mississippi/MS,2801800,"South Region--Forrest, Lamar, Marion & Perry Counties--Hattiesburg City PUMA, Mississippi/MS",1360,0,38,14,0,0,1374,0,38,0,38,38,1412,96,1,0,3,0,0,0,3,97,3,0,3
28,Mississippi/MS,2801900,"South Region--Pearl River, Hancock, George & Stone Counties PUMA, Mississippi/MS",269,0,0,64,0,0,333,0,0,0,0,0,333,81,19,0,0,0,0,0,0,100,0,0,0
28,Mississippi/MS,2802000,"South Region--Harrison County--Gulfport & Biloxi Cities PUMA, Mississippi/MS",251,0,0,22,0,20,273,0,20,20,0,20,293,86,8,7,0,0,0,7,0,93,7,0,7
28,Mississippi/MS,2802100,"South Region--Jackson County PUMA, Mississippi/MS",30,0,0,0,0,0,30,0,0,0,0,0,30,100,0,0,0,0,0,0,0,100,0,0,0
29,Missouri/MO,2900100,"Northwest Missouri PUMA, Missouri/MO",2274,114,133,113,101,7,2387,215,140,108,247,355,2742,83,4,4,9,4,4,0,5,87,13,8,5
29,Missouri/MO,2900200,"Buchanan, Andrew & DeKalb Counties PUMA, Missouri/MO",1754,174,826,85,64,451,1839,238,1277,515,1000,1515,3354,52,3,15,30,2,5,13,25,55,45,7,38
29,Missouri/MO,2900300,"Northeast Missouri PUMA, Missouri/MO",2740,5,49,52,0,107,2792,5,156,107,54,161,2953,93,2,4,2,0,0,4,2,95,5,0,5
29,Missouri/MO,2900400,"Lincoln, Warren, Audrain, Pike & Montgomery Counties PUMA, Missouri/MO",1480,0,42,175,84,0,1655,84,42,84,42,126,1781,83,10,5,2,5,0,0,2,93,7,5,2
29,Missouri/MO,2900500,"Cole, Callaway, Moniteau & Osage Counties PUMA, Missouri/MO",1029,0,0,139,18,0,1168,18,0,18,0,18,1186,87,12,2,0,2,0,0,0,98,2,2,0
29,Missouri/MO,2900600,"Boone County PUMA, Missouri/MO",646,0,85,0,74,0,646,74,85,74,85,159,805,80,0,9,11,9,0,0,11,80,20,9,11
29,Missouri/MO,2900700,"Pettis, Randolph, Saline, Cooper, Howard, Carroll & Chariton Counties PUMA, Missouri/MO",1711,224,469,10,61,91,1721,285,560,152,693,845,2566,67,0,6,27,2,9,4,18,67,33,11,22
29,Missouri/MO,2900800,"Johnson, Lafayette, Ray, Clinton & Caldwell Counties PUMA, Missouri/MO",1241,0,45,0,0,0,1241,0,45,0,45,45,1286,97,0,0,3,0,0,0,3,97,3,0,3
29,Missouri/MO,2900901,"Clay County (Northeast) PUMA, Missouri/MO",312,0,13,25,0,0,337,0,13,0,13,13,350,89,7,0,4,0,0,0,4,96,4,0,4
29,Missouri/MO,2900902,"Kansas City (North Central), Gladstone City & North Kansas City PUMA, Missouri/MO",164,0,0,36,36,0,200,36,0,36,0,36,236,69,15,15,0,15,0,0,0,85,15,15,0
29,Missouri/MO,2900903,"Platte County PUMA, Missouri/MO",191,0,0,0,0,0,191,0,0,0,0,0,191,100,0,0,0,0,0,0,0,100,0,0,0
29,Missouri/MO,2901001,"Jackson County--Kansas City (Central) PUMA, Missouri/MO",331,58,141,142,57,0,473,115,141,57,199,256,729,45,19,8,27,8,8,0,19,65,35,16,19
29,Missouri/MO,2901002,"Jackson County (North Central) PUMA, Missouri/MO",309,0,23,0,0,0,309,0,23,0,23,23,332,93,0,0,7,0,0,0,7,93,7,0,7
29,Missouri/MO,2901003,"Jackson County (East) PUMA, Missouri/MO",163,0,162,0,0,0,163,0,162,0,162,162,325,50,0,0,50,0,0,0,50,50,50,0,50
29,Missouri/MO,2901004,"Jackson County (South Central) PUMA, Missouri/MO",183,0,77,0,0,0,183,0,77,0,77,77,260,70,0,0,30,0,0,0,30,70,30,0,30
29,Missouri/MO,2901005,"Jackson County--Kansas City (South) PUMA, Missouri/MO",423,0,119,88,34,0,511,34,119,34,119,153,664,64,13,5,18,5,0,0,18,77,23,5,18
29,Missouri/MO,2901100,"Cass & Bates Counties PUMA, Missouri/MO",625,9,52,67,0,0,692,9,52,0,61,61,753,83,9,0,8,0,1,0,7,92,8,1,7
29,Missouri/MO,2901200,"Lawrence, Henry, Vernon, Cedar, Barton, St. Clair & Dade Counties PUMA, Missouri/MO",1737,13,125,62,0,0,1799,13,125,0,138,138,1937,90,3,0,7,0,1,0,6,93,7,1,6
29,Missouri/MO,2901300,"Laclede, Polk, Benton, Dallas & Hickory Counties PUMA, Missouri/MO",763,0,0,0,0,0,763,0,0,0,0,0,763,100,0,0,0,0,0,0,0,100,0,0,0
29,Missouri/MO,2901400,"Pulaski, Camden, Miller & Morgan Counties PUMA, Missouri/MO",567,52,9,9,18,0,576,70,9,18,61,79,655,87,1,3,9,3,8,0,1,88,12,11,1
29,Missouri/MO,2901500,"Phelps, Crawford, Dent, Gasconade & Maries Counties PUMA, Missouri/MO",548,4,0,0,0,0,548,4,0,0,4,4,552,99,0,0,1,0,1,0,0,99,1,1,0
29,Missouri/MO,2901600,"Franklin County PUMA, Missouri/MO",743,0,0,53,0,0,796,0,0,0,0,0,796,93,7,0,0,0,0,0,0,100,0,0,0
29,Missouri/MO,2901701,"St. Charles County (South) PUMA, Missouri/MO",97,0,0,0,0,0,97,0,0,0,0,0,97,100,0,0,0,0,0,0,0,100,0,0,0
29,Missouri/MO,2901702,"St. Charles County (Northwest) PUMA, Missouri/MO",220,0,0,31,0,0,251,0,0,0,0,0,251,88,12,0,0,0,0,0,0,100,0,0,0
29,Missouri/MO,2901703,"St. Charles County (Northeast) PUMA, Missouri/MO",296,0,25,0,29,48,296,29,73,77,25,102,398,74,0,19,6,7,0,12,6,74,26,7,18
29,Missouri/MO,2901801,"St. Louis County (Northeast) PUMA, Missouri/MO",286,0,0,0,0,0,286,0,0,0,0,0,286,100,0,0,0,0,0,0,0,100,0,0,0
29,Missouri/MO,2901802,"St. Louis County (Northwest) PUMA, Missouri/MO",276,0,108,0,30,43,276,30,151,73,108,181,457,60,0,16,24,7,0,9,24,60,40,7,33
29,Missouri/MO,2901803,"St. Louis County (Inner Ring North) PUMA, Missouri/MO",151,33,119,4,0,0,155,33,119,0,152,152,307,49,1,0,50,0,11,0,39,50,50,11,39
29,Missouri/MO,2901804,"St. Louis County (West) PUMA, Missouri/MO",142,0,0,0,38,0,142,38,0,38,0,38,180,79,0,21,0,21,0,0,0,79,21,21,0
29,Missouri/MO,2901806,"St. Louis County (Central West) PUMA, Missouri/MO",24,0,0,0,0,0,24,0,0,0,0,0,24,100,0,0,0,0,0,0,0,100,0,0,0
29,Missouri/MO,2901807,"St. Louis County (Inner Ring South) PUMA, Missouri/MO",218,0,46,23,57,36,241,57,82,93,46,139,380,57,6,24,12,15,0,9,12,63,37,15,22
29,Missouri/MO,2901808,"St. Louis County (South) PUMA, Missouri/MO",158,0,0,5,48,80,163,48,80,128,0,128,291,54,2,44,0,16,0,27,0,56,44,16,27
29,Missouri/MO,2901901,"St. Louis City (North) PUMA, Missouri/MO",305,0,4,0,0,0,305,0,4,0,4,4,309,99,0,0,1,0,0,0,1,99,1,0,1
29,Missouri/MO,2901902,"St. Louis City (South) PUMA, Missouri/MO",699,0,73,122,66,73,821,66,146,139,73,212,1033,68,12,13,7,6,0,7,7,79,21,6,14
29,Missouri/MO,2902001,"Jefferson County (North) PUMA, Missouri/MO",245,0,0,0,0,0,245,0,0,0,0,0,245,100,0,0,0,0,0,0,0,100,0,0,0
29,Missouri/MO,2902002,"Jefferson County (South) PUMA, Missouri/MO",110,0,0,0,0,0,110,0,0,0,0,0,110,100,0,0,0,0,0,0,0,100,0,0,0
29,Missouri/MO,2902100,"St. Francois, Washington, Perry & Ste. Genevieve Counties PUMA, Missouri/MO",980,0,0,1,0,0,981,0,0,0,0,0,981,100,0,0,0,0,0,0,0,100,0,0,0
29,Missouri/MO,2902200,"Cape Girardeau, Scott & Bollinger Counties PUMA, Missouri/MO",936,0,7,78,0,0,1014,0,7,0,7,7,1021,92,8,0,1,0,0,0,1,99,1,0,1
29,Missouri/MO,2902300,"Dunklin, Stoddard, New Madrid, Pemiscot & Mississippi Counties PUMA, Missouri/MO",1931,0,132,68,0,0,1999,0,132,0,132,132,2131,91,3,0,6,0,0,0,6,94,6,0,6
29,Missouri/MO,2902400,"Butler, Ripley, Wayne, Madison, Iron, Reynolds & Carter Counties PUMA, Missouri/MO",962,0,0,0,4,0,962,4,0,4,0,4,966,100,0,0,0,0,0,0,0,100,0,0,0
29,Missouri/MO,2902500,"Howell, Texas, Wright, Douglas, Oregon, Ozark & Shannon Counties PUMA, Missouri/MO",1366,0,0,0,0,0,1366,0,0,0,0,0,1366,100,0,0,0,0,0,0,0,100,0,0,0
29,Missouri/MO,2902601,"Christian, Greene (Outside Springfield City) & Webster Counties PUMA, Missouri/MO",801,0,39,0,0,0,801,0,39,0,39,39,840,95,0,0,5,0,0,0,5,95,5,0,5
29,Missouri/MO,2902602,"Greene County--Springfield City (North) PUMA, Missouri/MO",386,0,0,0,0,55,386,0,55,55,0,55,441,88,0,12,0,0,0,12,0,88,12,0,12
29,Missouri/MO,2902603,"Greene County--Springfield City (South) PUMA, Missouri/MO",476,0,0,48,67,0,524,67,0,67,0,67,591,81,8,11,0,11,0,0,0,89,11,11,0
29,Missouri/MO,2902700,"Taney, Barry, Stone & McDonald Counties PUMA, Missouri/MO",2046,134,718,524,35,326,2570,169,1044,361,852,1213,3783,54,14,10,23,1,4,9,19,68,32,4,28
29,Missouri/MO,2902800,"Jasper & Newton Counties PUMA, Missouri/MO",3113,291,389,260,38,69,3373,329,458,107,680,787,4160,75,6,3,16,1,7,2,9,81,19,8,11
30,Montana/MT,3000100,"Northwest Montana--Kalispell City PUMA, Montana/MT",555,0,58,0,0,0,555,0,58,0,58,58,613,91,0,0,9,0,0,0,9,91,9,0,9
30,Montana/MT,3000200,"West Montana--Missoula City PUMA, Montana/MT",701,0,0,8,0,3,709,0,3,3,0,3,712,98,1,0,0,0,0,0,0,100,0,0,0
30,Montana/MT,3000300,"Southwest Montana--Butte-Silver Bow & Helena City PUMA, Montana/MT",650,40,205,15,0,0,665,40,205,0,245,245,910,71,2,0,27,0,4,0,23,73,27,4,23
30,Montana/MT,3000400,"North Central Montana--Great Falls City PUMA, Montana/MT",1997,0,46,81,6,47,2078,6,93,53,46,99,2177,92,4,2,2,0,0,2,2,95,5,0,4
30,Montana/MT,3000500,"South Central Montana--Bozeman City PUMA, Montana/MT",1298,103,6,7,42,0,1305,145,6,42,109,151,1456,89,0,3,7,3,7,0,0,90,10,10,0
30,Montana/MT,3000600,"East Montana (Outside Billings City) PUMA, Montana/MT",2184,2,23,54,3,16,2238,5,39,19,25,44,2282,96,2,1,1,0,0,1,1,98,2,0,2
30,Montana/MT,3000700,"Billings City PUMA, Montana/MT",229,0,0,27,0,0,256,0,0,0,0,0,256,89,11,0,0,0,0,0,0,100,0,0,0
31,Nebraska/NE,3100100,"North Central & Northwest Nebraska PUMA, Nebraska/NE",2287,21,26,195,0,30,2482,21,56,30,47,77,2559,89,8,1,2,0,1,1,1,97,3,1,2
31,Nebraska/NE,3100200,"Northeast Nebraska PUMA, Nebraska/NE",3333,1535,2570,566,164,162,3899,1699,2732,326,4105,4431,8330,40,7,4,49,2,18,2,31,47,53,20,33
31,Nebraska/NE,3100300,"Central Nebraska PUMA, Nebraska/NE",2289,641,1439,392,0,132,2681,641,1571,132,2080,2212,4893,47,8,3,43,0,13,3,29,55,45,13,32
31,Nebraska/NE,3100400,"Southwest Nebraska PUMA, Nebraska/NE",1594,719,872,289,0,758,1883,719,1630,758,1591,2349,4232,38,7,18,38,0,17,18,21,44,56,17,39
31,Nebraska/NE,3100500,"South Central Nebraska PUMA, Nebraska/NE",1709,256,454,53,0,45,1762,256,499,45,710,755,2517,68,2,2,28,0,10,2,18,70,30,10,20
31,Nebraska/NE,3100600,"Southeast Nebraska PUMA, Nebraska/NE",2326,157,453,238,58,11,2564,215,464,69,610,679,3243,72,7,2,19,2,5,0,14,79,21,7,14
31,Nebraska/NE,3100701,"Dodge, Cass, Saunders & Washington Counties PUMA, Nebraska/NE",1503,110,171,110,97,0,1613,207,171,97,281,378,1991,75,6,5,14,5,6,0,9,81,19,10,9
31,Nebraska/NE,3100702,"Sarpy County--Bellevue City PUMA, Nebraska/NE",629,33,222,68,172,13,697,205,235,185,255,440,1137,55,6,16,22,15,3,1,20,61,39,18,21
31,Nebraska/NE,3100801,"Lancaster County--Lincoln City (North) PUMA, Nebraska/NE",353,0,99,241,308,195,594,308,294,503,99,602,1196,30,20,42,8,26,0,16,8,50,50,26,25
31,Nebraska/NE,3100802,"Lancaster County--Lincoln City (South) PUMA, Nebraska/NE",349,91,156,2,387,42,351,478,198,429,247,676,1027,34,0,42,24,38,9,4,15,34,66,47,19
31,Nebraska/NE,3100901,"Douglas County--Omaha City (Northwest) PUMA, Nebraska/NE",308,0,252,24,0,185,332,0,437,185,252,437,769,40,3,24,33,0,0,24,33,43,57,0,57
31,Nebraska/NE,3100902,"Douglas County--Omaha City (Southwest) PUMA, Nebraska/NE",689,26,76,92,129,17,781,155,93,146,102,248,1029,67,9,14,10,13,3,2,7,76,24,15,9
31,Nebraska/NE,3100903,"Douglas County--Omaha City (Northeast) PUMA, Nebraska/NE",489,44,218,55,238,979,544,282,1197,1217,262,1479,2023,24,3,60,13,12,2,48,11,27,73,14,59
31,Nebraska/NE,3100904,"Douglas County--Omaha City (Southeast) PUMA, Nebraska/NE",530,675,1371,537,0,14,1067,675,1385,14,2046,2060,3127,17,17,0,65,0,22,0,44,34,66,22,44
32,Nevada/NV,3200101,"Washoe County (South Central)--Reno City PUMA, Nevada/NV",207,0,81,193,42,42,400,42,123,84,81,165,565,37,34,15,14,7,0,7,14,71,29,7,22
32,Nevada/NV,3200102,"Washoe County (South) PUMA, Nevada/NV",54,0,113,50,0,0,104,0,113,0,113,113,217,25,23,0,52,0,0,0,52,48,52,0,52
32,Nevada/NV,3200103,"Washoe County (North)--Sparks City PUMA, Nevada/NV",201,0,261,103,0,0,304,0,261,0,261,261,565,36,18,0,46,0,0,0,46,54,46,0,46
32,Nevada/NV,3200200,"Carson City, Lyon, Douglas & Storey Counties PUMA, Nevada/NV",303,19,195,78,0,0,381,19,195,0,214,214,595,51,13,0,36,0,3,0,33,64,36,3,33
32,Nevada/NV,3200300,"Rural Nevada PUMA, Nevada/NV",502,40,949,113,9,53,615,49,1002,62,989,1051,1666,30,7,4,59,1,2,3,57,37,63,3,60
32,Nevada/NV,3200401,"Clark County (Northwest Central)--Northwest Las Vegas Valley PUMA, Nevada/NV",155,0,0,0,0,0,155,0,0,0,0,0,155,100,0,0,0,0,0,0,0,100,0,0,0
32,Nevada/NV,3200402,"Clark County (North)--Las Vegas (Northeast) & North Las Vegas (Outer) Cities PUMA, Nevada/NV",24,0,94,0,0,0,24,0,94,0,94,94,118,20,0,0,80,0,0,0,80,20,80,0,80
32,Nevada/NV,3200403,"Clark County (Central)--Greater North Las Vegas City PUMA, Nevada/NV",72,13,196,19,0,0,91,13,196,0,209,209,300,24,6,0,70,0,4,0,65,30,70,4,65
32,Nevada/NV,3200404,"Clark County (East)--Mesquite City, Sunrise Manor (North), Moapa Valley & Nellis AFB PUMA, Nevada/NV",189,0,44,17,0,0,206,0,44,0,44,44,250,76,7,0,18,0,0,0,18,82,18,0,18
32,Nevada/NV,3200405,"Las Vegas City (Southeast) PUMA, Nevada/NV",56,11,136,87,0,0,143,11,136,0,147,147,290,19,30,0,51,0,4,0,47,49,51,4,47
32,Nevada/NV,3200406,"Las Vegas City (South Central) PUMA, Nevada/NV",29,13,38,48,11,15,77,24,53,26,51,77,154,19,31,17,33,7,8,10,25,50,50,16,34
32,Nevada/NV,3200407,"Clark County (West)--Las Vegas City (Southwest) PUMA, Nevada/NV",18,0,0,0,20,0,18,20,0,20,0,20,38,47,0,53,0,53,0,0,0,47,53,53,0
32,Nevada/NV,3200408,"Clark County (Central)--Spring Valley & Summerlin South PUMA, Nevada/NV",0,26,41,0,0,0,0,26,41,0,67,67,67,0,0,0,100,0,39,0,61,0,100,39,61
32,Nevada/NV,3200409,"Clark County (Central)--Paradise (Northwest) & Winchester PUMA, Nevada/NV",16,15,32,24,0,18,40,15,50,18,47,65,105,15,23,17,45,0,14,17,30,38,62,14,48
32,Nevada/NV,3200410,"Clark County (Central)--Whitney, Sunrise Manor (South) & Paradise (Northeast) PUMA, Nevada/NV",70,56,38,49,0,25,119,56,63,25,94,119,238,29,21,11,39,0,24,11,16,50,50,24,26
32,Nevada/NV,3200411,"Clark County (Central)--Henderson City (West) PUMA, Nevada/NV",117,17,0,14,0,0,131,17,0,0,17,17,148,79,9,0,11,0,11,0,0,89,11,11,0
32,Nevada/NV,3200412,"Clark County (South)--Henderson (East) & Boulder Cities PUMA, Nevada/NV",146,15,7,96,0,0,242,15,7,0,22,22,264,55,36,0,8,0,6,0,3,92,8,6,3
32,Nevada/NV,3200413,"Clark County (Central)--Paradise (South) & Enterprise PUMA, Nevada/NV",18,38,7,37,0,76,55,38,83,76,45,121,176,10,21,43,26,0,22,43,4,31,69,22,47
33,New Hampshire/NH,3300100,"Northern New Hampshire--Grafton & Coos Counties PUMA, New Hampshire/NH",312,0,0,0,74,0,312,74,0,74,0,74,386,81,0,19,0,19,0,0,0,81,19,19,0
33,New Hampshire/NH,3300200,"Lakes Region--Belknap, Carroll & Merrimack (Northern) Counties PUMA, New Hampshire/NH",183,0,0,2,0,0,185,0,0,0,0,0,185,99,1,0,0,0,0,0,0,100,0,0,0
33,New Hampshire/NH,3300300,"Strafford Region--Strafford, Rockingham (Northern) & Carroll (Southeastern) Counties PUMA, New Hampshire/NH",313,0,0,0,0,0,313,0,0,0,0,0,313,100,0,0,0,0,0,0,0,100,0,0,0
33,New Hampshire/NH,3300400,"Central New Hampshire--Merrimack County (Central)--Concord City PUMA, New Hampshire/NH",271,0,0,0,16,94,271,16,94,110,0,110,381,71,0,29,0,4,0,25,0,71,29,4,25
33,New Hampshire/NH,3300500,"Southwestern New Hampshire--Cheshire & Sullivan Counties PUMA, New Hampshire/NH",224,0,0,0,13,0,224,13,0,13,0,13,237,95,0,5,0,5,0,0,0,95,5,5,0
33,New Hampshire/NH,3300600,"Hillsborough County (Western) PUMA, New Hampshire/NH",143,0,0,0,0,0,143,0,0,0,0,0,143,100,0,0,0,0,0,0,0,100,0,0,0
33,New Hampshire/NH,3300700,"Outer Manchester City PUMA, New Hampshire/NH",246,0,56,0,0,0,246,0,56,0,56,56,302,81,0,0,19,0,0,0,19,81,19,0,19
33,New Hampshire/NH,3300800,"Manchester City PUMA, New Hampshire/NH",181,9,137,16,0,141,197,9,278,141,146,287,484,37,3,29,30,0,2,29,28,41,59,2,57
33,New Hampshire/NH,3300900,"Hillsborough County (Southeastern)--Greater Nashua City PUMA, New Hampshire/NH",34,0,0,33,0,0,67,0,0,0,0,0,67,51,49,0,0,0,0,0,0,100,0,0,0
33,New Hampshire/NH,3301000,"Seacoast Region--Rockingham County (Southern)--Portsmouth City PUMA, New Hampshire/NH",119,57,0,0,35,30,119,92,30,65,57,122,241,49,0,27,24,15,24,12,0,49,51,38,12
34,New Jersey/NJ,3400101,"Atlantic County (East)--Atlantic City & Ventnor City PUMA, New Jersey/NJ",37,32,36,108,0,25,145,32,61,25,68,93,238,16,45,11,29,0,13,11,15,61,39,13,26
34,New Jersey/NJ,3400102,"Atlantic County (Outside Somers Point City)--Pleasantville City & Hammonton Town PUMA, New Jersey/NJ",283,19,85,13,0,0,296,19,85,0,104,104,400,71,3,0,26,0,5,0,21,74,26,5,21
34,New Jersey/NJ,3400301,"Bergen County (South Central)--Hackensack & Englewood (West) Cities PUMA, New Jersey/NJ",44,0,203,81,0,20,125,0,223,20,203,223,348,13,23,6,58,0,0,6,58,36,64,0,64
34,New Jersey/NJ,3400302,"Bergen County (Southwest)--Rutherford, North Arlington & Hasbrouck Heights Boroughs PUMA, New Jersey/NJ",39,8,86,0,87,21,39,95,107,108,94,202,241,16,0,45,39,36,3,9,36,16,84,39,44
34,New Jersey/NJ,3400303,"Bergen County (Southeast)--Fort Lee, Cliffside Park & Palisades Park Boroughs PUMA, New Jersey/NJ",40,0,313,0,31,63,40,31,376,94,313,407,447,9,0,21,70,7,0,14,70,9,91,7,84
34,New Jersey/NJ,3400304,"Bergen County (West Central)--Fair Lawn Borough, Garfield City & Lodi Borough PUMA, New Jersey/NJ",37,23,34,11,17,12,48,40,46,29,57,86,134,28,8,22,43,13,17,9,25,36,64,30,34
34,New Jersey/NJ,3400305,"Bergen County (East)--Tenafly, Park Ridge & Cresskill Boroughs PUMA, New Jersey/NJ",21,0,0,0,0,0,21,0,0,0,0,0,21,100,0,0,0,0,0,0,0,100,0,0,0
34,New Jersey/NJ,3400306,"Bergen County (Northwest)--Ramsey, Oakland & Franklin Lakes Boroughs PUMA, New Jersey/NJ",0,0,0,0,21,0,0,21,0,21,0,21,21,0,0,100,0,100,0,0,0,0,100,100,0
34,New Jersey/NJ,3400307,"Bergen County (North Central)--Bergenfield, Paramus, Dumont & New Milford Boroughs PUMA, New Jersey/NJ",32,12,84,0,20,0,32,32,84,20,96,116,148,22,0,14,65,14,8,0,57,22,78,22,57
34,New Jersey/NJ,3400308,"Bergen County (Central)--Ridgewood Village, Glen Rock & Westwood Boroughs PUMA, New Jersey/NJ",83,0,0,14,13,0,97,13,0,13,0,13,110,75,13,12,0,12,0,0,0,88,12,12,0
34,New Jersey/NJ,3400400,"Passaic County (Southeast)--Paterson City PUMA, New Jersey/NJ",63,96,582,88,0,54,151,96,636,54,678,732,883,7,10,6,77,0,11,6,66,17,83,11,72
34,New Jersey/NJ,3400501,"Passaic County (South)--Passaic & Clifton (Southeast) Cities PUMA, New Jersey/NJ",160,102,572,32,78,0,192,180,572,78,674,752,944,17,3,8,71,8,11,0,61,20,80,19,61
34,New Jersey/NJ,3400502,"Passaic County (Central)--Hawthorne Borough & Clifton City (Northwest) PUMA, New Jersey/NJ",79,35,0,28,33,0,107,68,0,33,35,68,175,45,16,19,20,19,20,0,0,61,39,39,0
34,New Jersey/NJ,3400503,"Passaic County (North)--Ringwood, Wanaque & Pompton Lakes Boroughs PUMA, New Jersey/NJ",20,0,16,0,0,0,20,0,16,0,16,16,36,56,0,0,44,0,0,0,44,56,44,0,44
34,New Jersey/NJ,3400601,"Hudson County (Central)--Jersey City (North) PUMA, New Jersey/NJ",87,35,100,11,0,17,98,35,117,17,135,152,250,35,4,7,54,0,14,7,40,39,61,14,47
34,New Jersey/NJ,3400602,"Hudson County (Central)--Jersey City (South) PUMA, New Jersey/NJ",76,0,131,24,0,29,100,0,160,29,131,160,260,29,9,11,50,0,0,11,50,38,62,0,62
34,New Jersey/NJ,3400701,"Hudson County (North)--West New York, Secaucus & Guttenberg Towns PUMA, New Jersey/NJ",34,45,322,29,0,0,63,45,322,0,367,367,430,8,7,0,85,0,10,0,75,15,85,10,75
34,New Jersey/NJ,3400702,"Hudson County (Northeast)--Union City & Hoboken Cities PUMA, New Jersey/NJ",0,140,181,34,18,0,34,158,181,18,321,339,373,0,9,5,86,5,38,0,49,9,91,42,49
34,New Jersey/NJ,3400703,"Hudson County (South & West)--Bayonne City, Kearney & Harrison Towns PUMA, New Jersey/NJ",8,91,205,0,68,56,8,159,261,124,296,420,428,2,0,29,69,16,21,13,48,2,98,37,61
34,New Jersey/NJ,3400800,"Hunterdon County PUMA, New Jersey/NJ",297,0,60,7,51,41,304,51,101,92,60,152,456,65,2,20,13,11,0,9,13,67,33,11,22
34,New Jersey/NJ,3400901,"Middlesex County (Southeast) PUMA, New Jersey/NJ",75,0,0,0,0,0,75,0,0,0,0,0,75,100,0,0,0,0,0,0,0,100,0,0,0
34,New Jersey/NJ,3400902,"Middlesex County (Southwest) PUMA, New Jersey/NJ",25,0,34,0,0,0,25,0,34,0,34,34,59,42,0,0,58,0,0,0,58,42,58,0,58
34,New Jersey/NJ,3400903,"Middlesex County (Northwest)--South Plainfield & Middlesex Boroughs PUMA, New Jersey/NJ",37,17,0,0,15,0,37,32,0,15,17,32,69,54,0,22,25,22,25,0,0,54,46,46,0
34,New Jersey/NJ,3400904,"Middlesex County (North Central)--Metuchen Borough PUMA, New Jersey/NJ",43,16,11,0,40,7,43,56,18,47,27,74,117,37,0,40,23,34,14,6,9,37,63,48,15
34,New Jersey/NJ,3400905,"Middlesex County (Northeast)--Carteret Borough PUMA, New Jersey/NJ",43,0,29,53,9,8,96,9,37,17,29,46,142,30,37,12,20,6,0,6,20,68,32,6,26
34,New Jersey/NJ,3400906,"Middlesex County (Central)--New Brunswick City, South River & Highland Park Boroughs PUMA, New Jersey/NJ",48,16,125,16,0,0,64,16,125,0,141,141,205,23,8,0,69,0,8,0,61,31,69,8,61
34,New Jersey/NJ,3400907,"Middlesex County (East Central)--Perth Amboy City & Sayreville Borough PUMA, New Jersey/NJ",75,131,104,75,0,0,150,131,104,0,235,235,385,19,19,0,61,0,34,0,27,39,61,34,27
34,New Jersey/NJ,3401001,"Somerset County (North & West) PUMA, New Jersey/NJ",26,0,38,0,11,0,26,11,38,11,38,49,75,35,0,15,51,15,0,0,51,35,65,15,51
34,New Jersey/NJ,3401002,"Somerset County (South) PUMA, New Jersey/NJ",37,0,0,0,50,0,37,50,0,50,0,50,87,43,0,57,0,57,0,0,0,43,57,57,0
34,New Jersey/NJ,3401003,"Somerset County (Central)--North Plainfield & Somerville Boroughs PUMA, New Jersey/NJ",32,0,0,0,96,37,32,96,37,133,0,133,165,19,0,81,0,58,0,22,0,19,81,58,22
34,New Jersey/NJ,3401101,"Monmouth County (Southeast)--Tinton Falls Borough (South) PUMA, New Jersey/NJ",11,0,14,0,0,0,11,0,14,0,14,14,25,44,0,0,56,0,0,0,56,44,56,0,56
34,New Jersey/NJ,3401102,"Monmouth County (Southwest)--Freehold Borough PUMA, New Jersey/NJ",43,12,101,0,0,0,43,12,101,0,113,113,156,28,0,0,72,0,8,0,65,28,72,8,65
34,New Jersey/NJ,3401103,"Monmouth County (East Central)--Long Branch, Asbury Park Cities & Eatontown Borough PUMA, New Jersey/NJ",0,0,18,0,0,73,0,0,91,73,18,91,91,0,0,80,20,0,0,80,20,0,100,0,100
34,New Jersey/NJ,3401104,"Monmouth County (Northeast)--Red Bank & Tinton Falls (North) Boroughs PUMA, New Jersey/NJ",19,0,108,11,0,0,30,0,108,0,108,108,138,14,8,0,78,0,0,0,78,22,78,0,78
34,New Jersey/NJ,3401105,"Monmouth County (Northwest)--Keansburg Borough PUMA, New Jersey/NJ",36,0,13,0,0,0,36,0,13,0,13,13,49,73,0,0,27,0,0,0,27,73,27,0,27
34,New Jersey/NJ,3401106,"Monmouth County (Central) PUMA, New Jersey/NJ",11,0,0,0,12,17,11,12,17,29,0,29,40,28,0,72,0,30,0,42,0,28,72,30,42
34,New Jersey/NJ,3401201,"Ocean County (South) PUMA, New Jersey/NJ",42,0,1,0,0,0,42,0,1,0,1,1,43,98,0,0,2,0,0,0,2,98,2,0,2
34,New Jersey/NJ,3401202,"Ocean County (Central)--Beachwood Borough PUMA, New Jersey/NJ",17,0,57,48,0,0,65,0,57,0,57,57,122,14,39,0,47,0,0,0,47,53,47,0,47
34,New Jersey/NJ,3401203,"Ocean County (North Central) PUMA, New Jersey/NJ",30,0,201,17,0,0,47,0,201,0,201,201,248,12,7,0,81,0,0,0,81,19,81,0,81
34,New Jersey/NJ,3401204,"Ocean County (Northwest) PUMA, New Jersey/NJ",224,0,20,0,37,0,224,37,20,37,20,57,281,80,0,13,7,13,0,0,7,80,20,13,7
34,New Jersey/NJ,3401205,"Ocean County (Northeast)--Point Pleasant Borough PUMA, New Jersey/NJ",51,0,0,0,0,0,51,0,0,0,0,0,51,100,0,0,0,0,0,0,0,100,0,0,0
34,New Jersey/NJ,3401301,"Essex County (Southeast)--Newark City (North & East) PUMA, New Jersey/NJ",105,116,262,97,12,80,202,128,342,92,378,470,672,16,14,14,56,2,17,12,39,30,70,19,51
34,New Jersey/NJ,3401302,"Essex County (Southeast)--Newark City (Southwest) PUMA, New Jersey/NJ",129,119,3,26,0,0,155,119,3,0,122,122,277,47,9,0,44,0,43,0,1,56,44,43,1
34,New Jersey/NJ,3401401,"Essex County (Northeast) PUMA, New Jersey/NJ",64,145,36,35,28,0,99,173,36,28,181,209,308,21,11,9,59,9,47,0,12,32,68,56,12
34,New Jersey/NJ,3401402,"Essex County (South Central)--East Orange City PUMA, New Jersey/NJ",138,0,51,0,65,0,138,65,51,65,51,116,254,54,0,26,20,26,0,0,20,54,46,26,20
34,New Jersey/NJ,3401403,"Essex County (Northwest) PUMA, New Jersey/NJ",17,0,0,0,0,0,17,0,0,0,0,0,17,100,0,0,0,0,0,0,0,100,0,0,0
34,New Jersey/NJ,3401404,"Essex County (Southwest) PUMA, New Jersey/NJ",36,0,0,0,23,0,36,23,0,23,0,23,59,61,0,39,0,39,0,0,0,61,39,39,0
34,New Jersey/NJ,3401501,"Morris County (North)--Dover Town & Kinnelon Borough PUMA, New Jersey/NJ",46,108,149,0,0,0,46,108,149,0,257,257,303,15,0,0,85,0,36,0,49,15,85,36,49
34,New Jersey/NJ,3401502,"Morris County (West) PUMA, New Jersey/NJ",227,21,29,26,0,43,253,21,72,43,50,93,346,66,8,12,14,0,6,12,8,73,27,6,21
34,New Jersey/NJ,3401503,"Morris County (East)--Lincoln Park Borough PUMA, New Jersey/NJ",3,53,0,0,0,13,3,53,13,13,53,66,69,4,0,19,77,0,77,19,0,4,96,77,19
34,New Jersey/NJ,3401504,"Morris County (South)--Morristown Town, Madison & Florham Park Boroughs PUMA, New Jersey/NJ",30,0,30,0,19,0,30,19,30,19,30,49,79,38,0,24,38,24,0,0,38,38,62,24,38
34,New Jersey/NJ,3401600,"Sussex County PUMA, New Jersey/NJ",204,0,80,0,0,16,204,0,96,16,80,96,300,68,0,5,27,0,0,5,27,68,32,0,32
34,New Jersey/NJ,3401700,"Warren County PUMA, New Jersey/NJ",317,0,191,36,0,0,353,0,191,0,191,191,544,58,7,0,35,0,0,0,35,65,35,0,35
34,New Jersey/NJ,3401800,"Union County (Northeast)--Elizabeth City PUMA, New Jersey/NJ",10,55,606,66,26,0,76,81,606,26,661,687,763,1,9,3,87,3,7,0,79,10,90,11,79
34,New Jersey/NJ,3401901,"Union County (North Central)--Roselle Park Borough PUMA, New Jersey/NJ",58,35,120,21,0,0,79,35,120,0,155,155,234,25,9,0,66,0,15,0,51,34,66,15,51
34,New Jersey/NJ,3401903,"Union County (Southwest)--Plainfield City & Westfield Town (South) PUMA, New Jersey/NJ",52,11,128,0,18,0,52,29,128,18,139,157,209,25,0,9,67,9,5,0,61,25,75,14,61
34,New Jersey/NJ,3401904,"Union County (Southeast)--Linden, Rahway Cities & Roselle Borough (South) PUMA, New Jersey/NJ",0,9,35,56,0,0,56,9,35,0,44,44,100,0,56,0,44,0,9,0,35,56,44,9,35
34,New Jersey/NJ,3402001,"Burlington County (North)--Burlington City PUMA, New Jersey/NJ",140,0,0,9,65,26,149,65,26,91,0,91,240,58,4,38,0,27,0,11,0,62,38,27,11
34,New Jersey/NJ,3402002,"Burlington County (West Central) PUMA, New Jersey/NJ",104,0,58,0,0,0,104,0,58,0,58,58,162,64,0,0,36,0,0,0,36,64,36,0,36
34,New Jersey/NJ,3402003,"Burlington County (South & East) PUMA, New Jersey/NJ",326,0,9,8,0,43,334,0,52,43,9,52,386,84,2,11,2,0,0,11,2,87,13,0,13
34,New Jersey/NJ,3402101,"Camden County (North)--Camden & Gloucester Cities PUMA, New Jersey/NJ",150,67,220,326,96,53,476,163,273,149,287,436,912,16,36,16,31,11,7,6,24,52,48,18,30
34,New Jersey/NJ,3402102,"Camden County (Central)--Lindenwold & Collingswood Boroughs PUMA, New Jersey/NJ",85,0,0,0,6,0,85,6,0,6,0,6,91,93,0,7,0,7,0,0,0,93,7,7,0
34,New Jersey/NJ,3402103,"Camden County (South & West)--Bellmawr & Pine Hill Boroughs PUMA, New Jersey/NJ",229,38,0,2,17,23,231,55,23,40,38,78,309,74,1,13,12,6,12,7,0,75,25,18,7
34,New Jersey/NJ,3402104,"Camden County (East Central)--Haddonfield Borough PUMA, New Jersey/NJ",126,0,1,0,37,45,126,37,46,82,1,83,209,60,0,39,0,18,0,22,0,60,40,18,22
34,New Jersey/NJ,3402201,"Gloucester County (Northeast)--Woodbury City PUMA, New Jersey/NJ",191,0,11,0,90,0,191,90,11,90,11,101,292,65,0,31,4,31,0,0,4,65,35,31,4
34,New Jersey/NJ,3402202,"Gloucester County (South & West)--Glassboro Borough PUMA, New Jersey/NJ",384,0,231,5,0,19,389,0,250,19,231,250,639,60,1,3,36,0,0,3,36,61,39,0,39
34,New Jersey/NJ,3402301,"Mercer County (West Central)--Trenton City PUMA, New Jersey/NJ",43,0,55,125,37,14,168,37,69,51,55,106,274,16,46,19,20,14,0,5,20,61,39,14,25
34,New Jersey/NJ,3402302,"Mercer County (North)--Princeton Borough PUMA, New Jersey/NJ",91,0,14,0,0,0,91,0,14,0,14,14,105,87,0,0,13,0,0,0,13,87,13,0,13
34,New Jersey/NJ,3402303,"Mercer County (South) PUMA, New Jersey/NJ",64,0,22,0,38,0,64,38,22,38,22,60,124,52,0,31,18,31,0,0,18,52,48,31,18
34,New Jersey/NJ,3402400,"Cumberland County (South)--Vineland & Millville Cities PUMA, New Jersey/NJ",706,49,770,422,158,54,1128,207,824,212,819,1031,2159,33,20,10,38,7,2,3,36,52,48,10,38
34,New Jersey/NJ,3402500,"Salem & Cumberland (North) Counties--Bridgeton City PUMA, New Jersey/NJ",503,115,1162,207,0,23,710,115,1185,23,1277,1300,2010,25,10,1,64,0,6,1,58,35,65,6,59
34,New Jersey/NJ,3402600,"Cape May & Atlantic (South Central) Counties--Ocean City & Somers Point City PUMA, New Jersey/NJ",32,0,10,7,0,24,39,0,34,24,10,34,73,44,10,33,14,0,0,33,14,53,47,0,47
35,New Mexico/NM,3500100,"Northwest New Mexico--Navajo Nation PUMA, New Mexico/NM",396,0,0,22,0,0,418,0,0,0,0,0,418,95,5,0,0,0,0,0,0,100,0,0,0
35,New Mexico/NM,3500200,"San Juan County (Northeast)--Farmington, Bloomfield & Aztec Cities PUMA, New Mexico/NM",112,0,0,35,0,0,147,0,0,0,0,0,147,76,24,0,0,0,0,0,0,100,0,0,0
35,New Mexico/NM,3500300,"North Central New Mexico PUMA, New Mexico/NM",108,54,23,57,0,0,165,54,23,0,77,77,242,45,24,0,32,0,22,0,10,68,32,22,10
35,New Mexico/NM,3500400,"Eastern Plains New Mexico PUMA, New Mexico/NM",684,437,1564,287,0,15,971,437,1579,15,2001,2016,2987,23,10,1,67,0,15,1,52,33,67,15,53
35,New Mexico/NM,3500500,"Santa Fe County PUMA, New Mexico/NM",33,0,90,232,26,0,265,26,90,26,90,116,381,9,61,7,24,7,0,0,24,70,30,7,24
35,New Mexico/NM,3500600,"Sandoval County PUMA, New Mexico/NM",95,0,4,9,0,0,104,0,4,0,4,4,108,88,8,0,4,0,0,0,4,96,4,0,4
35,New Mexico/NM,3500700,"Valencia, Bernalillo (East Mountains) Counties & Isleta Pueblo PUMA, New Mexico/NM",129,187,36,47,0,0,176,187,36,0,223,223,399,32,12,0,56,0,47,0,9,44,56,47,9
35,New Mexico/NM,3500801,"Albuquerque City (Far Northeast Heights) PUMA, New Mexico/NM",0,0,0,5,0,0,5,0,0,0,0,0,5,0,100,0,0,0,0,0,0,100,0,0,0
35,New Mexico/NM,3500802,"Albuquerque City (Near Northeast Heights) PUMA, New Mexico/NM",27,0,0,48,0,0,75,0,0,0,0,0,75,36,64,0,0,0,0,0,0,100,0,0,0
35,New Mexico/NM,3500803,"Albuquerque City (Southeast Heights) PUMA, New Mexico/NM",112,13,109,51,0,0,163,13,109,0,122,122,285,39,18,0,43,0,5,0,38,57,43,5,38
35,New Mexico/NM,3500804,"Albuquerque City (Central) & Bernalillo County (North Valley) PUMA, New Mexico/NM",46,0,44,51,0,0,97,0,44,0,44,44,141,33,36,0,31,0,0,0,31,69,31,0,31
35,New Mexico/NM,3500805,"Albuquerque City (Northwest Mesa), Paradise Hills & Navajo Nation-Tohajiilee Chapter PUMA, New Mexico/NM",26,0,20,108,0,0,134,0,20,0,20,20,154,17,70,0,13,0,0,0,13,87,13,0,13
35,New Mexico/NM,3500806,"Albuquerque City (Southwest Mesa) & Bernalillo County (Southwest Mesa & South Valley) PUMA, New Mexico/NM",15,41,27,96,0,0,111,41,27,0,68,68,179,8,54,0,38,0,23,0,15,62,38,23,15
35,New Mexico/NM,3500900,"Southwest New Mexico PUMA, New Mexico/NM",425,93,329,191,23,0,616,116,329,23,422,445,1061,40,18,2,40,2,9,0,31,58,42,11,31
35,New Mexico/NM,3501001,"DoÃ±a Ana County (Outer) PUMA, New Mexico/NM",15,225,866,407,0,0,422,225,866,0,1091,1091,1513,1,27,0,72,0,15,0,57,28,72,15,57
35,New Mexico/NM,3501002,"DoÃ±a Ana County (Central)--Las Cruces, Mesilla Cities & University Park PUMA, New Mexico/NM",26,0,16,321,0,0,347,0,16,0,16,16,363,7,88,0,4,0,0,0,4,96,4,0,4
35,New Mexico/NM,3501100,"Central Southeast New Mexico PUMA, New Mexico/NM",500,112,509,390,0,0,890,112,509,0,621,621,1511,33,26,0,41,0,7,0,34,59,41,7,34
35,New Mexico/NM,3501200,"Far Southeast New Mexico PUMA, New Mexico/NM",169,34,303,126,0,0,295,34,303,0,337,337,632,27,20,0,53,0,5,0,48,47,53,5,48
36,New York/NY,3600100,"St. Lawrence County PUMA, New York/NY",786,0,14,8,0,0,794,0,14,0,14,14,808,97,1,0,2,0,0,0,2,98,2,0,2
36,New York/NY,3600200,"Clinton, Franklin, Essex & Hamilton Counties PUMA, New York/NY",799,0,73,0,50,53,799,50,126,103,73,176,975,82,0,11,7,5,0,5,7,82,18,5,13
36,New York/NY,3600300,"Warren & Washington Counties PUMA, New York/NY",640,12,6,0,0,0,640,12,6,0,18,18,658,97,0,0,3,0,2,0,1,97,3,2,1
36,New York/NY,3600401,"Herkimer (North & Central) & Oneida (Outer) Counties PUMA, New York/NY",749,0,2,0,28,32,749,28,34,60,2,62,811,92,0,7,0,3,0,4,0,92,8,3,4
36,New York/NY,3600402,"Oneida County (Central)--Greater Utica & Rome Cities PUMA, New York/NY",262,39,0,59,137,209,321,176,209,346,39,385,706,37,8,49,6,19,6,30,0,45,55,25,30
36,New York/NY,3600403,"Otsego, Schoharie, Oneida (South) & Herkimer (South) Counties PUMA, New York/NY",1084,0,10,1,26,0,1085,26,10,26,10,36,1121,97,0,2,1,2,0,0,1,97,3,2,1
36,New York/NY,3600500,"Jefferson & Lewis Counties PUMA, New York/NY",1298,17,16,0,0,3,1298,17,19,3,33,36,1334,97,0,0,2,0,1,0,1,97,3,1,1
36,New York/NY,3600600,"Oswego County PUMA, New York/NY",458,16,14,0,8,0,458,24,14,8,30,38,496,92,0,2,6,2,3,0,3,92,8,5,3
36,New York/NY,3600701,"Onondaga County (Central)--Syracuse City PUMA, New York/NY",115,0,13,75,15,151,190,15,164,166,13,179,369,31,20,45,4,4,0,41,4,51,49,4,44
36,New York/NY,3600702,"Onondaga County (North) PUMA, New York/NY",232,0,0,0,0,0,232,0,0,0,0,0,232,100,0,0,0,0,0,0,0,100,0,0,0
36,New York/NY,3600703,"Onondaga County (Central)--Syracuse City (Outer) PUMA, New York/NY",317,0,0,0,0,0,317,0,0,0,0,0,317,100,0,0,0,0,0,0,0,100,0,0,0
36,New York/NY,3600704,"Cayuga & Onondaga (South) Counties PUMA, New York/NY",762,5,100,0,35,8,762,40,108,43,105,148,910,84,0,5,12,4,1,1,11,84,16,4,12
36,New York/NY,3600800,"Wayne & Seneca Counties PUMA, New York/NY",1009,88,129,0,0,0,1009,88,129,0,217,217,1226,82,0,0,18,0,7,0,11,82,18,7,11
36,New York/NY,3600901,"Monroe County (East) PUMA, New York/NY",99,0,0,22,0,0,121,0,0,0,0,0,121,82,18,0,0,0,0,0,0,100,0,0,0
36,New York/NY,3600902,"Monroe County (Central)--Rochester City (East) PUMA, New York/NY",157,0,27,46,6,0,203,6,27,6,27,33,236,67,19,3,11,3,0,0,11,86,14,3,11
36,New York/NY,3600903,"Monroe County (Central)--Rochester City (West) PUMA, New York/NY",120,0,22,30,34,15,150,34,37,49,22,71,221,54,14,22,10,15,0,7,10,68,32,15,17
36,New York/NY,3600904,"Monroe County (Central)--Greece & Gates Towns PUMA, New York/NY",254,0,0,21,20,0,275,20,0,20,0,20,295,86,7,7,0,7,0,0,0,93,7,7,0
36,New York/NY,3600905,"Monroe County (North & West) PUMA, New York/NY",89,0,19,0,0,0,89,0,19,0,19,19,108,82,0,0,18,0,0,0,18,82,18,0,18
36,New York/NY,3600906,"Monroe County (South) PUMA, New York/NY",154,0,0,48,0,0,202,0,0,0,0,0,202,76,24,0,0,0,0,0,0,100,0,0,0
36,New York/NY,3601000,"Genesee & Orleans Counties PUMA, New York/NY",957,62,282,40,27,0,997,89,282,27,344,371,1368,70,3,2,25,2,5,0,21,73,27,7,21
36,New York/NY,3601101,"Niagara County (Southwest)--Greater Niagara Falls & North Tonawanda Area PUMA, New York/NY",152,0,0,20,17,0,172,17,0,17,0,17,189,80,11,9,0,9,0,0,0,91,9,9,0
36,New York/NY,3601102,"Niagara County (North & East) PUMA, New York/NY",476,0,13,42,19,0,518,19,13,19,13,32,550,87,8,3,2,3,0,0,2,94,6,3,2
36,New York/NY,3601201,"Erie County (Northwest) PUMA, New York/NY",213,0,5,0,0,0,213,0,5,0,5,5,218,98,0,0,2,0,0,0,2,98,2,0,2
36,New York/NY,3601202,"Erie County (North Central) PUMA, New York/NY",198,0,0,0,0,0,198,0,0,0,0,0,198,100,0,0,0,0,0,0,0,100,0,0,0
36,New York/NY,3601203,"Erie County (Northeast) PUMA, New York/NY",341,0,0,21,0,0,362,0,0,0,0,0,362,94,6,0,0,0,0,0,0,100,0,0,0
36,New York/NY,3601204,"Erie County (Central) PUMA, New York/NY",580,0,3,31,69,8,611,69,11,77,3,80,691,84,4,11,0,10,0,1,0,88,12,10,2
36,New York/NY,3601205,"Erie County (West Central)--Buffalo City (East) PUMA, New York/NY",313,0,9,75,0,43,388,0,52,43,9,52,440,71,17,10,2,0,0,10,2,88,12,0,12
36,New York/NY,3601206,"Erie County (West Central)--Buffalo City (West) PUMA, New York/NY",96,0,2,58,138,57,154,138,59,195,2,197,351,27,17,56,1,39,0,16,1,44,56,39,17
36,New York/NY,3601207,"Erie County (South) PUMA, New York/NY",638,0,33,0,78,0,638,78,33,78,33,111,749,85,0,10,4,10,0,0,4,85,15,10,4
36,New York/NY,3601300,"Livingston & Wyoming Counties PUMA, New York/NY",1198,0,212,62,9,0,1260,9,212,9,212,221,1481,81,4,1,14,1,0,0,14,85,15,1,14
36,New York/NY,3601400,"Ontario & Yates Counties PUMA, New York/NY",888,0,131,57,0,0,945,0,131,0,131,131,1076,83,5,0,12,0,0,0,12,88,12,0,12
36,New York/NY,3601500,"Madison & Cortland Counties PUMA, New York/NY",968,0,0,0,0,0,968,0,0,0,0,0,968,100,0,0,0,0,0,0,0,100,0,0,0
36,New York/NY,3601600,"Fulton & Montgomery Counties PUMA, New York/NY",635,0,0,24,15,0,659,15,0,15,0,15,674,94,4,2,0,2,0,0,0,98,2,2,0
36,New York/NY,3601700,"Schenectady County--Schenectady City PUMA, New York/NY",185,0,0,0,0,0,185,0,0,0,0,0,185,100,0,0,0,0,0,0,0,100,0,0,0
36,New York/NY,3601801,"Saratoga County (South & Central) PUMA, New York/NY",238,0,24,0,0,0,238,0,24,0,24,24,262,91,0,0,9,0,0,0,9,91,9,0,9
36,New York/NY,3601802,"Saratoga County (Outer) PUMA, New York/NY",196,9,13,0,0,0,196,9,13,0,22,22,218,90,0,0,10,0,4,0,6,90,10,4,6
36,New York/NY,3601900,"Rensselaer County--Troy City PUMA, New York/NY",287,4,0,17,0,0,304,4,0,0,4,4,308,93,6,0,1,0,1,0,0,99,1,1,0
36,New York/NY,3602001,"Albany County (East Central)--Albany City PUMA, New York/NY",147,0,34,0,0,0,147,0,34,0,34,34,181,81,0,0,19,0,0,0,19,81,19,0,19
36,New York/NY,3602002,"Albany County (Outside Albany City) PUMA, New York/NY",333,0,0,14,10,0,347,10,0,10,0,10,357,93,4,3,0,3,0,0,0,97,3,3,0
36,New York/NY,3602100,"Columbia & Greene Counties PUMA, New York/NY",388,45,148,0,23,7,388,68,155,30,193,223,611,64,0,5,32,4,7,1,24,64,36,11,25
36,New York/NY,3602201,"Broome County (West Central)--Greater Binghamton City & Greater Johnson City Village PUMA, New York/NY",190,0,0,23,12,16,213,12,16,28,0,28,241,79,10,12,0,5,0,7,0,88,12,5,7
36,New York/NY,3602202,"Broome (Outer West) & Tioga Counties PUMA, New York/NY",345,0,0,0,0,0,345,0,0,0,0,0,345,100,0,0,0,0,0,0,0,100,0,0,0
36,New York/NY,3602203,"Chenango, Delaware & Broome (East) Counties PUMA, New York/NY",1027,11,0,0,10,15,1027,21,15,25,11,36,1063,97,0,2,1,1,1,1,0,97,3,2,1
36,New York/NY,3602300,"Tompkins County PUMA, New York/NY",402,0,13,37,82,0,439,82,13,82,13,95,534,75,7,15,2,15,0,0,2,82,18,15,2
36,New York/NY,3602401,"Chemung (South) & Steuben (East) Counties--Greater Elmira & Greater Corning Cities PUMA, New York/NY",250,0,0,0,0,18,250,0,18,18,0,18,268,93,0,7,0,0,0,7,0,93,7,0,7
36,New York/NY,3602402,"Steuben (North & West), Schuyler & Chemung (North) Counties PUMA, New York/NY",1050,11,40,20,0,0,1070,11,40,0,51,51,1121,94,2,0,5,0,1,0,4,95,5,1,4
36,New York/NY,3602500,"Cattaraugus & Allegany Counties PUMA, New York/NY",1108,0,0,3,0,0,1111,0,0,0,0,0,1111,100,0,0,0,0,0,0,0,100,0,0,0
36,New York/NY,3602600,"Chautauqua County PUMA, New York/NY",1188,0,114,370,0,0,1558,0,114,0,114,114,1672,71,22,0,7,0,0,0,7,93,7,0,7
36,New York/NY,3602701,"Sullivan & Ulster (West) Counties PUMA, New York/NY",309,0,199,33,0,0,342,0,199,0,199,199,541,57,6,0,37,0,0,0,37,63,37,0,37
36,New York/NY,3602702,"Ulster County (East) PUMA, New York/NY",114,0,146,0,0,0,114,0,146,0,146,146,260,44,0,0,56,0,0,0,56,44,56,0,56
36,New York/NY,3602801,"Dutchess County (North & East) PUMA, New York/NY",175,52,184,0,13,43,175,65,227,56,236,292,467,37,0,12,51,3,11,9,39,37,63,14,49
36,New York/NY,3602802,"Dutchess County (Southwest) PUMA, New York/NY",127,0,27,0,0,0,127,0,27,0,27,27,154,82,0,0,18,0,0,0,18,82,18,0,18
36,New York/NY,3602901,"Orange County (Northeast)--Greater Newburgh City PUMA, New York/NY",85,71,80,100,0,0,185,71,80,0,151,151,336,25,30,0,45,0,21,0,24,55,45,21,24
36,New York/NY,3602902,"Orange County (Northwest) PUMA, New York/NY",462,0,132,29,0,0,491,0,132,0,132,132,623,74,5,0,21,0,0,0,21,79,21,0,21
36,New York/NY,3602903,"Orange County (Southeast) PUMA, New York/NY",125,14,0,0,9,0,125,23,0,9,14,23,148,84,0,6,9,6,9,0,0,84,16,16,0
36,New York/NY,3603001,"Rockland County (North)--New City & Congers PUMA, New York/NY",64,12,149,0,59,0,64,71,149,59,161,220,284,23,0,21,57,21,4,0,52,23,77,25,52
36,New York/NY,3603002,"Rockland County (South)--Orangetown, Clarkstown (South) & Ramapo (Southeast) Towns PUMA, New York/NY",8,0,89,0,0,0,8,0,89,0,89,89,97,8,0,0,92,0,0,0,92,8,92,0,92
36,New York/NY,3603003,"Rockland County (West)--Spring Valley, Suffern Villages & Monsey PUMA, New York/NY",77,0,69,0,24,15,77,24,84,39,69,108,185,42,0,21,37,13,0,8,37,42,58,13,45
36,New York/NY,3603101,"Putnam County PUMA, New York/NY",83,0,0,0,0,7,83,0,7,7,0,7,90,92,0,8,0,0,0,8,0,92,8,0,8
36,New York/NY,3603102,"Westchester County (Northwest) PUMA, New York/NY",225,13,1,0,0,57,225,13,58,57,14,71,296,76,0,19,5,0,4,19,0,76,24,4,20
36,New York/NY,3603103,"Westchester County (Northeast) PUMA, New York/NY",55,0,4,0,0,0,55,0,4,0,4,4,59,93,0,0,7,0,0,0,7,93,7,0,7
36,New York/NY,3603104,"Westchester County (Southeast) PUMA, New York/NY",42,0,95,62,0,15,104,0,110,15,95,110,214,20,29,7,44,0,0,7,44,49,51,0,51
36,New York/NY,3603105,"Westchester County (Central)--White Plains City PUMA, New York/NY",15,0,64,0,8,0,15,8,64,8,64,72,87,17,0,9,74,9,0,0,74,17,83,9,74
36,New York/NY,3603106,"Westchester County (Southwest)--Yonkers City PUMA, New York/NY",40,38,87,178,0,0,218,38,87,0,125,125,343,12,52,0,36,0,11,0,25,64,36,11,25
36,New York/NY,3603107,"Westchester County (South Central)--New Rochelle & Mount Vernon Cities PUMA, New York/NY",98,19,107,0,0,0,98,19,107,0,126,126,224,44,0,0,56,0,8,0,48,44,56,8,48
36,New York/NY,3603201,"Nassau County (Northwest)--North Hempstead Town (North) PUMA, New York/NY",46,0,6,0,0,0,46,0,6,0,6,6,52,88,0,0,12,0,0,0,12,88,12,0,12
36,New York/NY,3603202,"Nassau County (Northeast)--Oyster Bay Town (North) & Glen Cove City PUMA, New York/NY",32,23,49,12,0,0,44,23,49,0,72,72,116,28,10,0,62,0,20,0,42,38,62,20,42
36,New York/NY,3603203,"Nassau County (East Central)--Oyster Bay Town (Central) PUMA, New York/NY",0,0,137,0,0,0,0,0,137,0,137,137,137,0,0,0,100,0,0,0,100,0,100,0,100
36,New York/NY,3603204,"Nassau County (West Central)--North Hempstead Town (South) PUMA, New York/NY",73,0,158,0,13,0,73,13,158,13,158,171,244,30,0,5,65,5,0,0,65,30,70,5,65
36,New York/NY,3603205,"Nassau County (West Central)--Hempstead Town (Northwest) PUMA, New York/NY",71,0,28,0,0,42,71,0,70,42,28,70,141,50,0,30,20,0,0,30,20,50,50,0,50
36,New York/NY,3603206,"Nassau County (Central)--Hempstead Town (North Central)--Meadowbrook Corridor PUMA, New York/NY",0,0,207,0,0,19,0,0,226,19,207,226,226,0,0,8,92,0,0,8,92,0,100,0,100
36,New York/NY,3603207,"Nassau County (Central)--Hempstead Town (Northeast) PUMA, New York/NY",14,0,0,22,0,0,36,0,0,0,0,0,36,39,61,0,0,0,0,0,0,100,0,0,0
36,New York/NY,3603208,"Nassau County (Southeast)--Oyster Bay Town (South) PUMA, New York/NY",26,0,0,0,0,0,26,0,0,0,0,0,26,100,0,0,0,0,0,0,0,100,0,0,0
36,New York/NY,3603209,"Nassau County (Central)--Hempstead Town (East Central) PUMA, New York/NY",31,0,0,0,0,0,31,0,0,0,0,0,31,100,0,0,0,0,0,0,0,100,0,0,0
36,New York/NY,3603210,"Nassau County (South Central)--Hempstead Town (Southeast) PUMA, New York/NY",31,0,0,0,0,0,31,0,0,0,0,0,31,100,0,0,0,0,0,0,0,100,0,0,0
36,New York/NY,3603211,"Nassau County (West Central)--Hempstead Town (West Central) PUMA, New York/NY",0,11,17,0,0,0,0,11,17,0,28,28,28,0,0,0,100,0,39,0,61,0,100,39,61
36,New York/NY,3603301,"Suffolk County (Northwest)--Huntington Town (North) PUMA, New York/NY",47,0,14,0,0,0,47,0,14,0,14,14,61,77,0,0,23,0,0,0,23,77,23,0,23
36,New York/NY,3603302,"Suffolk County (Northwest)--Huntington Town (South) PUMA, New York/NY",132,0,27,0,24,45,132,24,72,69,27,96,228,58,0,30,12,11,0,20,12,58,42,11,32
36,New York/NY,3603303,"Suffolk County (Northwest)--Smithtown Town PUMA, New York/NY",42,0,0,0,27,0,42,27,0,27,0,27,69,61,0,39,0,39,0,0,0,61,39,39,0
36,New York/NY,3603304,"Suffolk County (North Central)--Brookhaven Town (North) PUMA, New York/NY",130,13,0,0,0,0,130,13,0,0,13,13,143,91,0,0,9,0,9,0,0,91,9,9,0
36,New York/NY,3603305,"Suffolk County (East) PUMA, New York/NY",97,76,212,0,0,8,97,76,220,8,288,296,393,25,0,2,73,0,19,2,54,25,75,19,56
36,New York/NY,3603306,"Suffolk County (South Central)--Brookhaven Town (South) PUMA, New York/NY",300,11,42,0,0,0,300,11,42,0,53,53,353,85,0,0,15,0,3,0,12,85,15,3,12
36,New York/NY,3603307,"Suffolk County (Central)--Brookhaven Town (Central) PUMA, New York/NY",156,0,30,63,63,22,219,63,52,85,30,115,334,47,19,25,9,19,0,7,9,66,34,19,16
36,New York/NY,3603308,"Suffolk County (Central)--Brookhaven Town (West Central) PUMA, New York/NY",61,0,3,16,22,16,77,22,19,38,3,41,118,52,14,32,3,19,0,14,3,65,35,19,16
36,New York/NY,3603310,"Suffolk County (Central)--Islip Town (Northwest) PUMA, New York/NY",37,87,151,94,0,0,131,87,151,0,238,238,369,10,25,0,64,0,24,0,41,36,64,24,41
36,New York/NY,3603311,"Suffolk County (Southwest)--Islip Town (South) PUMA, New York/NY",0,0,88,0,0,0,0,0,88,0,88,88,88,0,0,0,100,0,0,0,100,0,100,0,100
36,New York/NY,3603312,"Suffolk County (Southwest)--Babylon Town (Southeast) PUMA, New York/NY",41,0,0,0,9,0,41,9,0,9,0,9,50,82,0,18,0,18,0,0,0,82,18,18,0
36,New York/NY,3603313,"Suffolk County (West Central)--Babylon Town (Northwest) PUMA, New York/NY",23,0,31,75,0,0,98,0,31,0,31,31,129,18,58,0,24,0,0,0,24,76,24,0,24
36,New York/NY,3603701,"NYC-Bronx Community District 8--Riverdale, Fieldston & Kingsbridge PUMA, New York/NY",56,0,0,28,0,0,84,0,0,0,0,0,84,67,33,0,0,0,0,0,0,100,0,0,0
36,New York/NY,3603702,"NYC-Bronx Community District 12--Wakefield, Williamsbridge & Woodlawn PUMA, New York/NY",63,0,29,41,128,0,104,128,29,128,29,157,261,24,16,49,11,49,0,0,11,40,60,49,11
36,New York/NY,3603703,"NYC-Bronx Community District 10--Co-op City, Pelham Bay & Schuylerville PUMA, New York/NY",59,24,0,0,0,15,59,24,15,15,24,39,98,60,0,15,24,0,24,15,0,60,40,24,15
36,New York/NY,3603704,"NYC-Bronx Community District 11--Pelham Parkway, Morris Park & Laconia PUMA, New York/NY",0,21,120,104,132,0,104,153,120,132,141,273,377,0,28,35,37,35,6,0,32,28,72,41,32
36,New York/NY,3603705,"NYC-Bronx Community District 3 & 6--Belmont, Crotona Park East & East Tremont PUMA, New York/NY",44,16,186,21,0,46,65,16,232,46,202,248,313,14,7,15,65,0,5,15,59,21,79,5,74
36,New York/NY,3603706,"NYC-Bronx Community District 7--Bedford Park, Fordham North & Norwood PUMA, New York/NY",0,0,87,0,15,0,0,15,87,15,87,102,102,0,0,15,85,15,0,0,85,0,100,15,85
36,New York/NY,3603707,"NYC-Bronx Community District 5--Morris Heights, Fordham South & Mount Hope PUMA, New York/NY",25,29,93,56,0,0,81,29,93,0,122,122,203,12,28,0,60,0,14,0,46,40,60,14,46
36,New York/NY,3603708,"NYC-Bronx Community District 4--Concourse, Highbridge & Mount Eden PUMA, New York/NY",0,23,96,41,0,0,41,23,96,0,119,119,160,0,26,0,74,0,14,0,60,26,74,14,60
36,New York/NY,3603709,"NYC-Bronx Community District 9--Castle Hill, Clason Point & Parkchester PUMA, New York/NY",0,44,98,103,50,26,103,94,124,76,142,218,321,0,32,24,44,16,14,8,31,32,68,29,39
36,New York/NY,3603710,"NYC-Bronx Community District 1 & 2--Hunts Point, Longwood & Melrose PUMA, New York/NY",0,0,143,64,0,0,64,0,143,0,143,143,207,0,31,0,69,0,0,0,69,31,69,0,69
36,New York/NY,3603801,"NYC-Manhattan Community District 12--Washington Heights, Inwood & Marble Hill PUMA, New York/NY",78,133,252,15,0,0,93,133,252,0,385,385,478,16,3,0,81,0,28,0,53,19,81,28,53
36,New York/NY,3603802,"NYC-Manhattan Community District 9--Hamilton Heights, Manhattanville & West Harlem PUMA, New York/NY",36,0,0,15,0,3,51,0,3,3,0,3,54,67,28,6,0,0,0,6,0,94,6,0,6
36,New York/NY,3603803,"NYC-Manhattan Community District 10--Central Harlem PUMA, New York/NY",0,0,14,29,0,0,29,0,14,0,14,14,43,0,67,0,33,0,0,0,33,67,33,0,33
36,New York/NY,3603804,"NYC-Manhattan Community District 11--East Harlem PUMA, New York/NY",0,42,54,130,22,27,130,64,81,49,96,145,275,0,47,18,35,8,15,10,20,47,53,23,29
36,New York/NY,3603805,"NYC-Manhattan Community District 8--Upper East Side PUMA, New York/NY",100,0,0,0,0,0,100,0,0,0,0,0,100,100,0,0,0,0,0,0,0,100,0,0,0
36,New York/NY,3603806,"NYC-Manhattan Community District 7--Upper West Side & West Side PUMA, New York/NY",44,0,0,157,39,3,201,39,3,42,0,42,243,18,65,17,0,16,0,1,0,83,17,16,1
36,New York/NY,3603807,"NYC-Manhattan Community District 4 & 5--Chelsea, Clinton & Midtown Business District PUMA, New York/NY",0,0,22,0,0,0,0,0,22,0,22,22,22,0,0,0,100,0,0,0,100,0,100,0,100
36,New York/NY,3603808,"NYC-Manhattan Community District 6--Murray Hill, Gramercy & Stuyvesant Town PUMA, New York/NY",0,0,0,0,0,4,0,0,4,4,0,4,4,0,0,100,0,0,0,100,0,0,100,0,100
36,New York/NY,3603809,"NYC-Manhattan Community District 3--Chinatown & Lower East Side PUMA, New York/NY",36,0,0,19,33,17,55,33,17,50,0,50,105,34,18,48,0,31,0,16,0,52,48,31,16
36,New York/NY,3603810,"NYC-Manhattan Community District 1 & 2--Battery Park City, Greenwich Village & Soho PUMA, New York/NY",0,0,0,0,0,2,0,0,2,2,0,2,2,0,0,100,0,0,0,100,0,0,100,0,100
36,New York/NY,3603901,"NYC-Staten Island Community District 3--Tottenville, Great Kills & Annadale PUMA, New York/NY",56,0,0,0,0,9,56,0,9,9,0,9,65,86,0,14,0,0,0,14,0,86,14,0,14
36,New York/NY,3603902,"NYC-Staten Island Community District 2--New Springville & South Beach PUMA, New York/NY",45,0,0,0,0,0,45,0,0,0,0,0,45,100,0,0,0,0,0,0,0,100,0,0,0
36,New York/NY,3603903,"NYC-Staten Island Community District 1--Port Richmond, Stapleton & Mariner's Harbor PUMA, New York/NY",112,7,59,0,62,0,112,69,59,62,66,128,240,47,0,26,28,26,3,0,25,47,53,29,25
36,New York/NY,3604001,"NYC-Brooklyn Community District 1--Greenpoint & Williamsburg PUMA, New York/NY",0,56,32,0,68,42,0,124,74,110,88,198,198,0,0,56,44,34,28,21,16,0,100,63,37
36,New York/NY,3604002,"NYC-Brooklyn Community District 4--Bushwick PUMA, New York/NY",76,56,266,78,0,0,154,56,266,0,322,322,476,16,16,0,68,0,12,0,56,32,68,12,56
36,New York/NY,3604003,"NYC-Brooklyn Community District 3--Bedford-Stuyvesant PUMA, New York/NY",100,0,15,70,0,0,170,0,15,0,15,15,185,54,38,0,8,0,0,0,8,92,8,0,8
36,New York/NY,3604004,"NYC-Brooklyn Community District 2--Brooklyn Heights & Fort Greene PUMA, New York/NY",46,0,0,18,0,0,64,0,0,0,0,0,64,72,28,0,0,0,0,0,0,100,0,0,0
36,New York/NY,3604005,"NYC-Brooklyn Community District 6--Park Slope, Carroll Gardens & Red Hook PUMA, New York/NY",10,0,64,0,18,25,10,18,89,43,64,107,117,9,0,37,55,15,0,21,55,9,91,15,76
36,New York/NY,3604006,"NYC-Brooklyn Community District 8--Crown Heights North & Prospect Heights PUMA, New York/NY",56,0,94,5,0,0,61,0,94,0,94,94,155,36,3,0,61,0,0,0,61,39,61,0,61
36,New York/NY,3604007,"NYC-Brooklyn Community District 16--Brownsville & Ocean Hill PUMA, New York/NY",110,0,39,3,17,0,113,17,39,17,39,56,169,65,2,10,23,10,0,0,23,67,33,10,23
36,New York/NY,3604008,"NYC-Brooklyn Community District 5--East New York & Starrett City PUMA, New York/NY",29,46,0,18,13,27,47,59,27,40,46,86,133,22,14,30,35,10,35,20,0,35,65,44,20
36,New York/NY,3604009,"NYC-Brooklyn Community District 18--Canarsie & Flatlands PUMA, New York/NY",42,0,0,0,10,19,42,10,19,29,0,29,71,59,0,41,0,14,0,27,0,59,41,14,27
36,New York/NY,3604010,"NYC-Brooklyn Community District 17--East Flatbush, Farragut & Rugby PUMA, New York/NY",0,53,0,0,11,17,0,64,17,28,53,81,81,0,0,35,65,14,65,21,0,0,100,79,21
36,New York/NY,3604012,"NYC-Brooklyn Community District 7--Sunset Park & Windsor Terrace PUMA, New York/NY",48,42,250,31,62,116,79,104,366,178,292,470,549,9,6,32,53,11,8,21,46,14,86,19,67
36,New York/NY,3604013,"NYC-Brooklyn Community District 10--Bay Ridge & Dyker Heights PUMA, New York/NY",31,0,44,0,27,39,31,27,83,66,44,110,141,22,0,47,31,19,0,28,31,22,78,19,59
36,New York/NY,3604014,"NYC-Brooklyn Community District 12--Borough Park, Kensington & Ocean Parkway PUMA, New York/NY",72,0,0,0,0,65,72,0,65,65,0,65,137,53,0,47,0,0,0,47,0,53,47,0,47
36,New York/NY,3604015,"NYC-Brooklyn Community District 14--Flatbush & Midwood PUMA, New York/NY",30,0,0,0,11,41,30,11,41,52,0,52,82,37,0,63,0,13,0,50,0,37,63,13,50
36,New York/NY,3604016,"NYC-Brooklyn Community District 15--Sheepshead Bay, Gerritsen Beach & Homecrest PUMA, New York/NY",0,0,0,0,29,23,0,29,23,52,0,52,52,0,0,100,0,56,0,44,0,0,100,56,44
36,New York/NY,3604017,"NYC-Brooklyn Community District 11--Bensonhurst & Bath Beach PUMA, New York/NY",77,15,115,0,123,158,77,138,273,281,130,411,488,16,0,58,27,25,3,32,24,16,84,28,56
36,New York/NY,3604018,"NYC-Brooklyn Community District 13--Brighton Beach & Coney Island PUMA, New York/NY",8,0,44,0,65,24,8,65,68,89,44,133,141,6,0,63,31,46,0,17,31,6,94,46,48
36,New York/NY,3604101,"NYC-Queens Community District 1--Astoria & Long Island City PUMA, New York/NY",39,15,18,32,68,8,71,83,26,76,33,109,180,22,18,42,18,38,8,4,10,39,61,46,14
36,New York/NY,3604102,"NYC-Queens Community District 3--Jackson Heights & North Corona PUMA, New York/NY",110,60,264,50,72,17,160,132,281,89,324,413,573,19,9,16,57,13,10,3,46,28,72,23,49
36,New York/NY,3604103,"NYC-Queens Community District 7--Flushing, Murray Hill & Whitestone PUMA, New York/NY",60,10,23,21,12,99,81,22,122,111,33,144,225,27,9,49,15,5,4,44,10,36,64,10,54
36,New York/NY,3604104,"NYC-Queens Community District 11--Bayside, Douglaston & Little Neck PUMA, New York/NY",0,0,0,0,35,17,0,35,17,52,0,52,52,0,0,100,0,67,0,33,0,0,100,67,33
36,New York/NY,3604105,"NYC-Queens Community District 13--Queens Village, Cambria Heights & Rosedale PUMA, New York/NY",0,18,0,0,0,0,0,18,0,0,18,18,18,0,0,0,100,0,100,0,0,0,100,100,0
36,New York/NY,3604106,"NYC-Queens Community District 8--Briarwood, Fresh Meadows & Hillcrest PUMA, New York/NY",8,0,32,55,83,69,63,83,101,152,32,184,247,3,22,62,13,34,0,28,13,26,74,34,41
36,New York/NY,3604107,"NYC-Queens Community District 4--Elmhurst & South Corona PUMA, New York/NY",0,18,147,0,35,16,0,53,163,51,165,216,216,0,0,24,76,16,8,7,68,0,100,25,75
36,New York/NY,3604108,"NYC-Queens Community District 6--Forest Hills & Rego Park PUMA, New York/NY",0,0,0,0,58,0,0,58,0,58,0,58,58,0,0,100,0,100,0,0,0,0,100,100,0
36,New York/NY,3604109,"NYC-Queens Community District 2--Sunnyside & Woodside PUMA, New York/NY",0,0,62,0,34,12,0,34,74,46,62,108,108,0,0,43,57,31,0,11,57,0,100,31,69
36,New York/NY,3604110,"NYC-Queens Community District 5--Ridgewood, Glendale & Middle Village PUMA, New York/NY",31,14,49,23,28,14,54,42,63,42,63,105,159,19,14,26,40,18,9,9,31,34,66,26,40
36,New York/NY,3604111,"NYC-Queens Community District 9--Richmond Hill & Woodhaven PUMA, New York/NY",0,9,48,0,23,33,0,32,81,56,57,113,113,0,0,50,50,20,8,29,42,0,100,28,72
36,New York/NY,3604112,"NYC-Queens Community District 12--Jamaica, Hollis & St. Albans PUMA, New York/NY",16,68,0,0,115,93,16,183,93,208,68,276,292,5,0,71,23,39,23,32,0,5,95,63,32
36,New York/NY,3604113,"NYC-Queens Community District 10--Howard Beach & Ozone Park PUMA, New York/NY",26,10,48,21,20,27,47,30,75,47,58,105,152,17,14,31,38,13,7,18,32,31,69,20,49
36,New York/NY,3604114,"NYC-Queens Community District 14--Far Rockaway, Breezy Point & Broad Channel PUMA, New York/NY",31,0,40,88,0,0,119,0,40,0,40,40,159,19,55,0,25,0,0,0,25,75,25,0,25
37,North Carolina/NC,3700100,"Boone High Country--Watauga, Ashe, Yancey, Avery & Mitchell Counties PUMA, North Carolina/NC",806,0,111,0,0,0,806,0,111,0,111,111,917,88,0,0,12,0,0,0,12,88,12,0,12
37,North Carolina/NC,3700200,"Wilkesboro High Country--Surry, Wilkes & Alleghany Counties PUMA, North Carolina/NC",1152,153,462,137,0,107,1289,153,569,107,615,722,2011,57,7,5,31,0,8,5,23,64,36,8,28
37,North Carolina/NC,3700300,"Rockingham & Stokes Counties PUMA, North Carolina/NC",511,0,270,0,0,0,511,0,270,0,270,270,781,65,0,0,35,0,0,0,35,65,35,0,35
37,North Carolina/NC,3700400,"Granville, Person & Caswell Counties PUMA, North Carolina/NC",227,0,78,62,0,0,289,0,78,0,78,78,367,62,17,0,21,0,0,0,21,79,21,0,21
37,North Carolina/NC,3700500,"Franklin, Vance & Warren (West) Counties PUMA, North Carolina/NC",750,20,594,40,0,0,790,20,594,0,614,614,1404,53,3,0,44,0,1,0,42,56,44,1,42
37,North Carolina/NC,3700600,"Halifax, Hertford, Northampton & Warren (East) Counties PUMA, North Carolina/NC",1437,25,108,2,0,0,1439,25,108,0,133,133,1572,91,0,0,8,0,2,0,7,92,8,2,7
37,North Carolina/NC,3700700,"Northeast Albemarle Sound Region PUMA, North Carolina/NC",585,0,51,0,0,25,585,0,76,25,51,76,661,89,0,4,8,0,0,4,8,89,11,0,11
37,North Carolina/NC,3700800,"South & West Albemarle Sound & Northern Outer Banks Regions PUMA, North Carolina/NC",1547,0,120,8,0,0,1555,0,120,0,120,120,1675,92,0,0,7,0,0,0,7,93,7,0,7
37,North Carolina/NC,3700900,"Nash & Edgecombe Counties--Rocky Mount City PUMA, North Carolina/NC",1261,164,372,121,0,0,1382,164,372,0,536,536,1918,66,6,0,28,0,9,0,19,72,28,9,19
37,North Carolina/NC,3701000,"Wilson & Greene Counties--Wilson City PUMA, North Carolina/NC",1069,89,848,54,56,0,1123,145,848,56,937,993,2116,51,3,3,44,3,4,0,40,53,47,7,40
37,North Carolina/NC,3701100,"Johnston County PUMA, North Carolina/NC",583,0,341,17,0,0,600,0,341,0,341,341,941,62,2,0,36,0,0,0,36,64,36,0,36
37,North Carolina/NC,3701201,"Raleigh City (South & Central) PUMA, North Carolina/NC",259,0,99,0,0,0,259,0,99,0,99,99,358,72,0,0,28,0,0,0,28,72,28,0,28
37,North Carolina/NC,3701202,"Raleigh City (North) PUMA, North Carolina/NC",86,0,0,11,0,0,97,0,0,0,0,0,97,89,11,0,0,0,0,0,0,100,0,0,0
37,North Carolina/NC,3701203,"Wake County (Northeast)--Raleigh City (Northeast), Wake Forest & Rolesville Towns PUMA, North Carolina/NC",98,61,34,18,102,0,116,163,34,102,95,197,313,31,6,33,30,33,19,0,11,37,63,52,11
37,North Carolina/NC,3701204,"Wake County (East)--Raleigh City (East), Knightdale & Garner (North) Towns PUMA, North Carolina/NC",60,17,85,32,0,0,92,17,85,0,102,102,194,31,16,0,53,0,9,0,44,47,53,9,44
37,North Carolina/NC,3701205,"Wake County (Southeast)--Garner (South) & Fuquay-Varina Towns PUMA, North Carolina/NC",166,0,23,0,0,0,166,0,23,0,23,23,189,88,0,0,12,0,0,0,12,88,12,0,12
37,North Carolina/NC,3701206,"Wake County (Northwest)--Raleigh City (Northwest) & Morrisville Town PUMA, North Carolina/NC",0,0,0,0,48,58,0,48,58,106,0,106,106,0,0,100,0,45,0,55,0,0,100,45,55
37,North Carolina/NC,3701207,"Wake County (West Central)--Cary Town PUMA, North Carolina/NC",59,9,0,0,88,0,59,97,0,88,9,97,156,38,0,56,6,56,6,0,0,38,62,62,0
37,North Carolina/NC,3701208,"Wake County (Southwest)--Apex & Holly Springs Towns PUMA, North Carolina/NC",76,0,87,10,28,0,86,28,87,28,87,115,201,38,5,14,43,14,0,0,43,43,57,14,43
37,North Carolina/NC,3701301,"Durham County (South)--Durham City (South) PUMA, North Carolina/NC",264,0,319,41,36,0,305,36,319,36,319,355,660,40,6,5,48,5,0,0,48,46,54,5,48
37,North Carolina/NC,3701302,"Durham County (North)--Durham City (North) PUMA, North Carolina/NC",162,0,57,0,0,19,162,0,76,19,57,76,238,68,0,8,24,0,0,8,24,68,32,0,32
37,North Carolina/NC,3701400,"Orange County--Chapel Hill Town PUMA, North Carolina/NC",147,0,41,0,40,0,147,40,41,40,41,81,228,64,0,18,18,18,0,0,18,64,36,18,18
37,North Carolina/NC,3701500,"Chatham & Lee Counties PUMA, North Carolina/NC",392,161,471,160,0,0,552,161,471,0,632,632,1184,33,14,0,53,0,14,0,40,47,53,14,40
37,North Carolina/NC,3701600,"Alamance County--Burlington City PUMA, North Carolina/NC",280,66,406,25,0,0,305,66,406,0,472,472,777,36,3,0,61,0,8,0,52,39,61,8,52
37,North Carolina/NC,3701701,"Greensboro City (North) PUMA, North Carolina/NC",78,41,108,112,0,54,190,41,162,54,149,203,393,20,28,14,38,0,10,14,27,48,52,10,41
37,North Carolina/NC,3701702,"Greensboro City (South) PUMA, North Carolina/NC",210,28,29,10,0,0,220,28,29,0,57,57,277,76,4,0,21,0,10,0,10,79,21,10,10
37,North Carolina/NC,3701703,"Guilford County (North)--Summerfield Town PUMA, North Carolina/NC",374,0,108,21,0,52,395,0,160,52,108,160,555,67,4,9,19,0,0,9,19,71,29,0,29
37,North Carolina/NC,3701704,"Guilford County (South)--High Point City PUMA, North Carolina/NC",49,13,83,0,0,239,49,13,322,239,96,335,384,13,0,62,25,0,3,62,22,13,87,3,84
37,North Carolina/NC,3701801,"Winston-Salem City (North) PUMA, North Carolina/NC",320,0,36,13,28,78,333,28,114,106,36,142,475,67,3,22,8,6,0,16,8,70,30,6,24
37,North Carolina/NC,3701802,"Winston-Salem City (South) PUMA, North Carolina/NC",160,0,25,19,0,0,179,0,25,0,25,25,204,78,9,0,12,0,0,0,12,88,12,0,12
37,North Carolina/NC,3701803,"Forsyth County (Outside Winston-Salem City)--Kernersville Town & Clemmons Village PUMA, North Carolina/NC",294,48,29,0,0,0,294,48,29,0,77,77,371,79,0,0,21,0,13,0,8,79,21,13,8
37,North Carolina/NC,3701900,"Davie, Yadkin & Iredell (North) Counties PUMA, North Carolina/NC",411,31,223,0,0,0,411,31,223,0,254,254,665,62,0,0,38,0,5,0,34,62,38,5,34
37,North Carolina/NC,3702000,"Caldwell & Alexander Counties PUMA, North Carolina/NC",260,99,232,77,0,0,337,99,232,0,331,331,668,39,12,0,50,0,15,0,35,50,50,15,35
37,North Carolina/NC,3702100,"Burke & McDowell Counties PUMA, North Carolina/NC",263,0,183,223,29,27,486,29,210,56,183,239,725,36,31,8,25,4,0,4,25,67,33,4,29
37,North Carolina/NC,3702201,"Buncombe County (Southeast)--Asheville City PUMA, North Carolina/NC",132,0,88,0,0,0,132,0,88,0,88,88,220,60,0,0,40,0,0,0,40,60,40,0,40
37,North Carolina/NC,3702202,"Buncombe County (Northwest) PUMA, North Carolina/NC",176,0,112,17,0,0,193,0,112,0,112,112,305,58,6,0,37,0,0,0,37,63,37,0,37
37,North Carolina/NC,3702300,"Haywood, Madison, Swain, Graham & Jackson (North) Counties PUMA, North Carolina/NC",168,22,119,44,0,0,212,22,119,0,141,141,353,48,12,0,40,0,6,0,34,60,40,6,34
37,North Carolina/NC,3702400,"Jackson (South), Macon, Cherokee & Clay Counties PUMA, North Carolina/NC",359,11,37,21,0,0,380,11,37,0,48,48,428,84,5,0,11,0,3,0,9,89,11,3,9
37,North Carolina/NC,3702500,"Henderson & Transylvania Counties PUMA, North Carolina/NC",82,0,546,0,0,0,82,0,546,0,546,546,628,13,0,0,87,0,0,0,87,13,87,0,87
37,North Carolina/NC,3702600,"Rutherford, Cleveland (West) & Polk Counties--Shelby City PUMA, North Carolina/NC",361,64,98,0,0,0,361,64,98,0,162,162,523,69,0,0,31,0,12,0,19,69,31,12,19
37,North Carolina/NC,3702700,"Lincoln & Cleveland (East) Counties PUMA, North Carolina/NC",306,43,66,0,0,29,306,43,95,29,109,138,444,69,0,7,25,0,10,7,15,69,31,10,21
37,North Carolina/NC,3702800,"Catawba County--Hickory City PUMA, North Carolina/NC",332,12,51,0,28,0,332,40,51,28,63,91,423,78,0,7,15,7,3,0,12,78,22,9,12
37,North Carolina/NC,3702900,"Iredell (South)--Mooresville Town & Statesville City PUMA, North Carolina/NC",426,25,66,0,0,0,426,25,66,0,91,91,517,82,0,0,18,0,5,0,13,82,18,5,13
37,North Carolina/NC,3703001,"Gaston County (Northwest)--Mount Holly City PUMA, North Carolina/NC",146,0,100,0,0,0,146,0,100,0,100,100,246,59,0,0,41,0,0,0,41,59,41,0,41
37,North Carolina/NC,3703002,"Gaston County (Southeast)--Gastonia & Belmont Cities PUMA, North Carolina/NC",222,26,13,104,8,0,326,34,13,8,39,47,373,60,28,2,10,2,7,0,3,87,13,9,3
37,North Carolina/NC,3703101,"Charlotte City (Central) PUMA, North Carolina/NC",168,0,112,11,65,117,179,65,229,182,112,294,473,36,2,38,24,14,0,25,24,38,62,14,48
37,North Carolina/NC,3703102,"Charlotte City (Northwest) PUMA, North Carolina/NC",377,0,53,16,53,111,393,53,164,164,53,217,610,62,3,27,9,9,0,18,9,64,36,9,27
37,North Carolina/NC,3703103,"Charlotte City (Northeast) PUMA, North Carolina/NC",207,0,132,0,26,133,207,26,265,159,132,291,498,42,0,32,27,5,0,27,27,42,58,5,53
37,North Carolina/NC,3703104,"Charlotte City (South) PUMA, North Carolina/NC",98,26,11,23,0,0,121,26,11,0,37,37,158,62,15,0,23,0,16,0,7,77,23,16,7
37,North Carolina/NC,3703105,"Charlotte City (Southwest) PUMA, North Carolina/NC",172,21,248,0,9,18,172,30,266,27,269,296,468,37,0,6,57,2,4,4,53,37,63,6,57
37,North Carolina/NC,3703106,"Mecklenburg County (North)--Huntersville, Cornelius & Davidson Towns PUMA, North Carolina/NC",72,30,0,0,0,0,72,30,0,0,30,30,102,71,0,0,29,0,29,0,0,71,29,29,0
37,North Carolina/NC,3703107,"Mecklenburg County (East)--Mint Hill & Matthews (North) Towns PUMA, North Carolina/NC",172,25,41,0,0,0,172,25,41,0,66,66,238,72,0,0,28,0,11,0,17,72,28,11,17
37,North Carolina/NC,3703108,"Mecklenburg County (South)--Matthews Town (South) PUMA, North Carolina/NC",109,60,107,0,12,0,109,72,107,12,167,179,288,38,0,4,58,4,21,0,37,38,62,25,37
37,North Carolina/NC,3703200,"Cabarrus County (West)--Concord, Kannapolis Cities & Harrisburg Town PUMA, North Carolina/NC",311,158,43,34,0,0,345,158,43,0,201,201,546,57,6,0,37,0,29,0,8,63,37,29,8
37,North Carolina/NC,3703300,"Stanley & Cabarrus (East) Counties PUMA, North Carolina/NC",384,0,67,0,29,0,384,29,67,29,67,96,480,80,0,6,14,6,0,0,14,80,20,6,14
37,North Carolina/NC,3703400,"Rowan County PUMA, North Carolina/NC",361,0,121,68,0,0,429,0,121,0,121,121,550,66,12,0,22,0,0,0,22,78,22,0,22
37,North Carolina/NC,3703500,"Davidson County PUMA, North Carolina/NC",375,38,53,16,48,0,391,86,53,48,91,139,530,71,3,9,17,9,7,0,10,74,26,16,10
37,North Carolina/NC,3703600,"Randolph County PUMA, North Carolina/NC",273,0,67,0,0,0,273,0,67,0,67,67,340,80,0,0,20,0,0,0,20,80,20,0,20
37,North Carolina/NC,3703700,"Moore & Montgomery Counties PUMA, North Carolina/NC",709,9,98,111,0,0,820,9,98,0,107,107,927,76,12,0,12,0,1,0,11,88,12,1,11
37,North Carolina/NC,3703800,"Harnett County PUMA, North Carolina/NC",582,0,151,0,0,0,582,0,151,0,151,151,733,79,0,0,21,0,0,0,21,79,21,0,21
37,North Carolina/NC,3703900,"Sampson & Duplin Counties PUMA, North Carolina/NC",2492,370,3424,171,85,72,2663,455,3496,157,3794,3951,6614,38,3,2,57,1,6,1,52,40,60,7,53
37,North Carolina/NC,3704000,"Wayne County PUMA, North Carolina/NC",1294,198,1469,215,49,365,1509,247,1834,414,1667,2081,3590,36,6,12,46,1,6,10,41,42,58,7,51
37,North Carolina/NC,3704100,"Lenoir, Onslow (North) & Jones Counties PUMA, North Carolina/NC",1184,49,306,174,0,0,1358,49,306,0,355,355,1713,69,10,0,21,0,3,0,18,79,21,3,18
37,North Carolina/NC,3704200,"Pitt County--Greenville City PUMA, North Carolina/NC",762,14,209,31,0,0,793,14,209,0,223,223,1016,75,3,0,22,0,1,0,21,78,22,1,21
37,North Carolina/NC,3704300,"Craven County PUMA, North Carolina/NC",218,69,332,59,0,0,277,69,332,0,401,401,678,32,9,0,59,0,10,0,49,41,59,10,49
37,North Carolina/NC,3704400,"Carteret, Beaufort & Pamlico Counties PUMA, North Carolina/NC",452,0,32,8,0,0,460,0,32,0,32,32,492,92,2,0,7,0,0,0,7,93,7,0,7
37,North Carolina/NC,3704500,"Onslow County (South)--Jacksonville City PUMA, North Carolina/NC",113,0,20,0,0,0,113,0,20,0,20,20,133,85,0,0,15,0,0,0,15,85,15,0,15
37,North Carolina/NC,3704600,"Pender & New Hanover (North) Counties PUMA, North Carolina/NC",249,36,328,33,0,13,282,36,341,13,364,377,659,38,5,2,55,0,5,2,50,43,57,5,52
37,North Carolina/NC,3704700,"New Hanover County (South)--Wilmington City PUMA, North Carolina/NC",128,0,82,0,0,0,128,0,82,0,82,82,210,61,0,0,39,0,0,0,39,61,39,0,39
37,North Carolina/NC,3704800,"Brunswick County PUMA, North Carolina/NC",248,0,7,0,0,0,248,0,7,0,7,7,255,97,0,0,3,0,0,0,3,97,3,0,3
37,North Carolina/NC,3704900,"Columbus, Bladen & Robeson (East) Counties PUMA, North Carolina/NC",1149,15,367,29,0,0,1178,15,367,0,382,382,1560,74,2,0,24,0,1,0,24,76,24,1,24
37,North Carolina/NC,3705001,"Cumberland County (Central)--Fayetteville City (Central & East) PUMA, North Carolina/NC",751,0,18,106,8,60,857,8,78,68,18,86,943,80,11,7,2,1,0,6,2,91,9,1,8
37,North Carolina/NC,3705002,"Cumberland County (East)--Hope Mills & Spring Lake Towns PUMA, North Carolina/NC",307,53,218,12,23,171,319,76,389,194,271,465,784,39,2,25,35,3,7,22,28,41,59,10,50
37,North Carolina/NC,3705003,"Cumberland County (West)--Fayetteville City (West) PUMA, North Carolina/NC",472,33,148,195,21,0,667,54,148,21,181,202,869,54,22,2,21,2,4,0,17,77,23,6,17
37,North Carolina/NC,3705100,"Robeson County (West)--Lumberton City PUMA, North Carolina/NC",2550,122,914,192,8,12,2742,130,926,20,1036,1056,3798,67,5,1,27,0,3,0,24,72,28,3,24
37,North Carolina/NC,3705200,"Hoke, Richmond & Scotland Counties PUMA, North Carolina/NC",1936,0,348,89,28,0,2025,28,348,28,348,376,2401,81,4,1,14,1,0,0,14,84,16,1,14
37,North Carolina/NC,3705300,"Union (East) & Anson Counties--Monroe City PUMA, North Carolina/NC",966,199,445,116,36,0,1082,235,445,36,644,680,1762,55,7,2,37,2,11,0,25,61,39,13,25
37,North Carolina/NC,3705400,"Union County (West)--Indian Trail & Stallings Towns PUMA, North Carolina/NC",47,0,0,53,0,0,100,0,0,0,0,0,100,47,53,0,0,0,0,0,0,100,0,0,0
38,North Dakota/ND,3800100,"West North Dakota--Minot City PUMA, North Dakota/ND",1905,0,47,2,0,5,1907,0,52,5,47,52,1959,97,0,0,2,0,0,0,2,97,3,0,3
38,North Dakota/ND,3800200,"East Central North Dakota--Jamestown City PUMA, North Dakota/ND",2461,0,73,9,7,8,2470,7,81,15,73,88,2558,96,0,1,3,0,0,0,3,97,3,0,3
38,North Dakota/ND,3800300,"South Central North Dakota--Bismarck City PUMA, North Dakota/ND",1103,0,0,249,0,3,1352,0,3,3,0,3,1355,81,18,0,0,0,0,0,0,100,0,0,0
38,North Dakota/ND,3800400,"Northeast North Dakota--Grand Forks City PUMA, North Dakota/ND",1858,0,30,269,0,91,2127,0,121,91,30,121,2248,83,12,4,1,0,0,4,1,95,5,0,5
38,North Dakota/ND,3800500,"Cass County--Fargo City PUMA, North Dakota/ND",874,0,0,0,62,50,874,62,50,112,0,112,986,89,0,11,0,6,0,5,0,89,11,6,5
39,Ohio/OH,3900100,"Defiance, Williams, Henry & Paulding Counties PUMA, Ohio/OH",1349,7,67,83,9,26,1432,16,93,35,74,109,1541,88,5,2,5,1,0,2,4,93,7,1,6
39,Ohio/OH,3900200,"Wood (South), Fulton & Lucas (Southwest) Counties--Bowling Green City PUMA, Ohio/OH",845,0,219,89,0,0,934,0,219,0,219,219,1153,73,8,0,19,0,0,0,19,81,19,0,19
39,Ohio/OH,3900300,"Lucas (West) & Wood (North Central) Counties--Perrysburg, Sylvania & Maumee Cities PUMA, Ohio/OH",150,0,0,35,27,0,185,27,0,27,0,27,212,71,17,13,0,13,0,0,0,87,13,13,0
39,Ohio/OH,3900400,"Toledo City (West) PUMA, Ohio/OH",542,0,0,0,0,0,542,0,0,0,0,0,542,100,0,0,0,0,0,0,0,100,0,0,0
39,Ohio/OH,3900500,"Toledo City (East) PUMA, Ohio/OH",447,42,12,0,0,0,447,42,12,0,54,54,501,89,0,0,11,0,8,0,2,89,11,8,2
39,Ohio/OH,3900600,"Ottawa, Wood (Northeast) & Lucas (East) Counties--Oregon City PUMA, Ohio/OH",152,5,18,0,0,0,152,5,18,0,23,23,175,87,0,0,13,0,3,0,10,87,13,3,10
39,Ohio/OH,3900700,"Erie & Sandusky Counties PUMA, Ohio/OH",930,0,106,122,14,60,1052,14,166,74,106,180,1232,75,10,6,9,1,0,5,9,85,15,1,13
39,Ohio/OH,3900801,"Lorain County (North)--Elyria & Lorain Cities PUMA, Ohio/OH",300,16,20,270,0,42,570,16,62,42,36,78,648,46,42,6,6,0,2,6,3,88,12,2,10
39,Ohio/OH,3900802,"Lorain County (South)--Avon, Avon Lake & North Ridgeville Cities PUMA, Ohio/OH",355,0,0,0,0,0,355,0,0,0,0,0,355,100,0,0,0,0,0,0,0,100,0,0,0
39,Ohio/OH,3900901,"Cuyahoga County--Olmsted Township, Bay Village, North Olmsted & Westlake Cities PUMA, Ohio/OH",37,0,31,0,13,0,37,13,31,13,31,44,81,46,0,16,38,16,0,0,38,46,54,16,38
39,Ohio/OH,3900902,"Cuyahoga County (West)--Berea, Brook Park, Lakewood & Rocky River Cities PUMA, Ohio/OH",92,20,0,32,20,0,124,40,0,20,20,40,164,56,20,12,12,12,12,0,0,76,24,24,0
39,Ohio/OH,3900903,"Cuyahoga County (South)--Broadview Heights, North Royalton & Strongsville Cities PUMA, Ohio/OH",131,0,0,0,0,0,131,0,0,0,0,0,131,100,0,0,0,0,0,0,0,100,0,0,0
39,Ohio/OH,3900904,"Cuyahoga County (South Central)--Brooklyn, Parma, Parma Heights & Seven Hills Cities PUMA, Ohio/OH",211,0,0,0,0,0,211,0,0,0,0,0,211,100,0,0,0,0,0,0,0,100,0,0,0
39,Ohio/OH,3900905,"Cleveland City (West) PUMA, Ohio/OH",253,0,48,140,0,10,393,0,58,10,48,58,451,56,31,2,11,0,0,2,11,87,13,0,13
39,Ohio/OH,3900906,"Cleveland City (Central) PUMA, Ohio/OH",111,0,40,84,0,0,195,0,40,0,40,40,235,47,36,0,17,0,0,0,17,83,17,0,17
39,Ohio/OH,3900907,"Cuyahoga County (Southeast)--Bedford, Garfield Heights & Maple Heights Cities PUMA, Ohio/OH",545,47,0,0,0,0,545,47,0,0,47,47,592,92,0,0,8,0,8,0,0,92,8,8,0
39,Ohio/OH,3900908,"Cleveland City (East) & Bratenahl Village PUMA, Ohio/OH",185,0,0,0,0,29,185,0,29,29,0,29,214,86,0,14,0,0,0,14,0,86,14,0,14
39,Ohio/OH,3900909,"Cuyahoga County (Northeast)--Euclid, Cleveland Heights & South Euclid Cities PUMA, Ohio/OH",282,0,0,12,0,0,294,0,0,0,0,0,294,96,4,0,0,0,0,0,0,100,0,0,0
39,Ohio/OH,3900910,"Cuyahoga County (East)--Lyndhurst, Mayfield Heights, Shaker Heights & Solon Cities PUMA, Ohio/OH",61,0,0,0,15,10,61,15,10,25,0,25,86,71,0,29,0,17,0,12,0,71,29,17,12
39,Ohio/OH,3901000,"Lake County (West)--Eastlake, Wickliffe, Willoughby & Willowick Cities PUMA, Ohio/OH",54,0,0,0,0,0,54,0,0,0,0,0,54,100,0,0,0,0,0,0,0,100,0,0,0
39,Ohio/OH,3901100,"Lake County (East)--Mentor, Painesville Cities & Madison Village PUMA, Ohio/OH",146,64,157,55,0,0,201,64,157,0,221,221,422,35,13,0,52,0,15,0,37,48,52,15,37
39,Ohio/OH,3901200,"Geauga & Lake (South) Counties PUMA, Ohio/OH",305,3,22,0,0,0,305,3,22,0,25,25,330,92,0,0,8,0,1,0,7,92,8,1,7
39,Ohio/OH,3901300,"Ashtabula County PUMA, Ohio/OH",375,0,0,29,0,0,404,0,0,0,0,0,404,93,7,0,0,0,0,0,0,100,0,0,0
39,Ohio/OH,3901400,"Trumbull (Outside Warren City) & Mahoning (Outside Youngstown City) Counties PUMA, Ohio/OH",782,0,0,0,0,0,782,0,0,0,0,0,782,100,0,0,0,0,0,0,0,100,0,0,0
39,Ohio/OH,3901500,"Mahoning County (Northeast)--Youngstown City, Boardman & Austintown PUMA, Ohio/OH",245,0,0,19,0,0,264,0,0,0,0,0,264,93,7,0,0,0,0,0,0,100,0,0,0
39,Ohio/OH,3901600,"Trumbull County (South Central)--Warren & Niles Cities PUMA, Ohio/OH",158,0,0,0,0,0,158,0,0,0,0,0,158,100,0,0,0,0,0,0,0,100,0,0,0
39,Ohio/OH,3901700,"Portage County PUMA, Ohio/OH",779,0,0,70,0,0,849,0,0,0,0,0,849,92,8,0,0,0,0,0,0,100,0,0,0
39,Ohio/OH,3901801,"Summit County (North & Northwest)--Hudson, Twinsburg & Macedonia Cities PUMA, Ohio/OH",115,0,30,0,17,0,115,17,30,17,30,47,162,71,0,10,19,10,0,0,19,71,29,10,19
39,Ohio/OH,3901802,"Summit County (East Central)--Cuyahoga Falls (Southeast), Stow & Tallmadge Cities PUMA, Ohio/OH",209,0,0,0,30,0,209,30,0,30,0,30,239,87,0,13,0,13,0,0,0,87,13,13,0
39,Ohio/OH,3901803,"Summit County (Central)--Akron City (East) PUMA, Ohio/OH",118,0,0,0,48,118,118,48,118,166,0,166,284,42,0,58,0,17,0,42,0,42,58,17,42
39,Ohio/OH,3901804,"Summit County (Central)--Akron (West) & Cuyahoga Falls (West) Cities PUMA, Ohio/OH",105,0,0,0,0,29,105,0,29,29,0,29,134,78,0,22,0,0,0,22,0,78,22,0,22
39,Ohio/OH,3901805,"Summit County (South)--Barberton, Green & New Franklin Cities PUMA, Ohio/OH",220,0,0,0,0,0,220,0,0,0,0,0,220,100,0,0,0,0,0,0,0,100,0,0,0
39,Ohio/OH,3901900,"Medina County PUMA, Ohio/OH",339,0,0,0,0,0,339,0,0,0,0,0,339,100,0,0,0,0,0,0,0,100,0,0,0
39,Ohio/OH,3902000,"Wayne County PUMA, Ohio/OH",1293,44,0,59,0,14,1352,44,14,14,44,58,1410,92,4,1,3,0,3,1,0,96,4,3,1
39,Ohio/OH,3902100,"Huron & Ashland Counties PUMA, Ohio/OH",1250,7,265,88,0,0,1338,7,265,0,272,272,1610,78,5,0,17,0,0,0,16,83,17,0,16
39,Ohio/OH,3902200,"Richland County PUMA, Ohio/OH",145,0,0,55,0,0,200,0,0,0,0,0,200,72,28,0,0,0,0,0,0,100,0,0,0
39,Ohio/OH,3902300,"Seneca, Crawford & Wyandot Counties PUMA, Ohio/OH",796,39,115,3,0,0,799,39,115,0,154,154,953,84,0,0,16,0,4,0,12,84,16,4,12
39,Ohio/OH,3902400,"Hancock & Putnam Counties PUMA, Ohio/OH",804,62,37,204,21,62,1008,83,99,83,99,182,1190,68,17,7,8,2,5,5,3,85,15,7,8
39,Ohio/OH,3902500,"Allen County PUMA, Ohio/OH",1104,0,0,32,0,0,1136,0,0,0,0,0,1136,97,3,0,0,0,0,0,0,100,0,0,0
39,Ohio/OH,3902600,"Auglaize, Mercer & Van Wert Counties PUMA, Ohio/OH",1448,12,89,38,0,75,1486,12,164,75,101,176,1662,87,2,5,6,0,1,5,5,89,11,1,10
39,Ohio/OH,3902700,"Logan, Champaign & Hardin Counties PUMA, Ohio/OH",717,0,0,23,0,0,740,0,0,0,0,0,740,97,3,0,0,0,0,0,0,100,0,0,0
39,Ohio/OH,3902800,"Marion, Knox & Morrow Counties PUMA, Ohio/OH",1184,0,97,25,0,21,1209,0,118,21,97,118,1327,89,2,2,7,0,0,2,7,91,9,0,9
39,Ohio/OH,3902900,"Holmes, Guernsey & Coshocton Counties PUMA, Ohio/OH",1291,0,0,0,0,0,1291,0,0,0,0,0,1291,100,0,0,0,0,0,0,0,100,0,0,0
39,Ohio/OH,3903000,"Tuscarawas & Harrison Counties PUMA, Ohio/OH",580,0,115,0,0,0,580,0,115,0,115,115,695,83,0,0,17,0,0,0,17,83,17,0,17
39,Ohio/OH,3903100,"Stark County (West)--Massillon City PUMA, Ohio/OH",1246,0,0,0,24,0,1246,24,0,24,0,24,1270,98,0,2,0,2,0,0,0,98,2,2,0
39,Ohio/OH,3903200,"Stark County (Central)--Canton & North Canton Cities PUMA, Ohio/OH",766,41,0,14,0,0,780,41,0,0,41,41,821,93,2,0,5,0,5,0,0,95,5,5,0
39,Ohio/OH,3903300,"Stark County (East) & Carroll County--Alliance City PUMA, Ohio/OH",682,16,0,0,0,0,682,16,0,0,16,16,698,98,0,0,2,0,2,0,0,98,2,2,0
39,Ohio/OH,3903400,"Columbiana County PUMA, Ohio/OH",498,0,0,49,0,0,547,0,0,0,0,0,547,91,9,0,0,0,0,0,0,100,0,0,0
39,Ohio/OH,3903500,"Belmont & Jefferson Counties PUMA, Ohio/OH",312,7,0,0,0,0,312,7,0,0,7,7,319,98,0,0,2,0,2,0,0,98,2,2,0
39,Ohio/OH,3903600,"Washington, Morgan, Noble & Monroe Counties PUMA, Ohio/OH",340,0,0,57,17,0,397,17,0,17,0,17,414,82,14,4,0,4,0,0,0,96,4,4,0
39,Ohio/OH,3903700,"Muskingum & Perry Counties PUMA, Ohio/OH",945,0,0,0,0,0,945,0,0,0,0,0,945,100,0,0,0,0,0,0,0,100,0,0,0
39,Ohio/OH,3903800,"Licking County PUMA, Ohio/OH",542,0,0,21,0,0,563,0,0,0,0,0,563,96,4,0,0,0,0,0,0,100,0,0,0
39,Ohio/OH,3903900,"Fairfield County PUMA, Ohio/OH",411,11,0,0,0,0,411,11,0,0,11,11,422,97,0,0,3,0,3,0,0,97,3,3,0
39,Ohio/OH,3904000,"Delaware County PUMA, Ohio/OH",187,0,0,0,21,14,187,21,14,35,0,35,222,84,0,16,0,9,0,6,0,84,16,9,6
39,Ohio/OH,3904101,"Columbus (Far Northeast), Gahanna & New Albany Cities PUMA, Ohio/OH",224,0,0,0,112,0,224,112,0,112,0,112,336,67,0,33,0,33,0,0,0,67,33,33,0
39,Ohio/OH,3904102,"Columbus (North), Westerville & Worthington Cities PUMA, Ohio/OH",0,0,0,0,0,38,0,0,38,38,0,38,38,0,0,100,0,0,0,100,0,0,100,0,100
39,Ohio/OH,3904103,"Columbus (Far Northwest), Dublin & Hilliard (North) Cities PUMA, Ohio/OH",75,0,0,0,0,20,75,0,20,20,0,20,95,79,0,21,0,0,0,21,0,79,21,0,21
39,Ohio/OH,3904104,"Columbus (Northwest), Upper Arlington & Grandview Heights Cities PUMA, Ohio/OH",54,0,0,0,0,0,54,0,0,0,0,0,54,100,0,0,0,0,0,0,0,100,0,0,0
39,Ohio/OH,3904105,"Columbus City (Central) PUMA, Ohio/OH",299,0,0,0,0,0,299,0,0,0,0,0,299,100,0,0,0,0,0,0,0,100,0,0,0
39,Ohio/OH,3904106,"Columbus City (Northeast) PUMA, Ohio/OH",175,0,31,0,28,177,175,28,208,205,31,236,411,43,0,50,8,7,0,43,8,43,57,7,51
39,Ohio/OH,3904107,"Columbus (East), Whitehall & Bexley Cities PUMA, Ohio/OH",119,49,74,0,0,0,119,49,74,0,123,123,242,49,0,0,51,0,20,0,31,49,51,20,31
39,Ohio/OH,3904108,"Columbus (Southeast) & Reynoldsburg Cities PUMA, Ohio/OH",67,0,61,26,0,0,93,0,61,0,61,61,154,44,17,0,40,0,0,0,40,60,40,0,40
39,Ohio/OH,3904109,"Franklin County (South)--Columbus (South), Grove Cities & Groveport Village PUMA, Ohio/OH",138,0,0,0,17,0,138,17,0,17,0,17,155,89,0,11,0,11,0,0,0,89,11,11,0
39,Ohio/OH,3904110,"Columbus City (West) PUMA, Ohio/OH",135,0,21,0,48,0,135,48,21,48,21,69,204,66,0,24,10,24,0,0,10,66,34,24,10
39,Ohio/OH,3904111,"Columbus (Far West) & Hilliard (South) Cities PUMA, Ohio/OH",114,0,0,0,69,26,114,69,26,95,0,95,209,55,0,45,0,33,0,12,0,55,45,33,12
39,Ohio/OH,3904200,"Pickaway, Union & Madison Counties PUMA, Ohio/OH",473,0,94,0,0,0,473,0,94,0,94,94,567,83,0,0,17,0,0,0,17,83,17,0,17
39,Ohio/OH,3904300,"Clark County PUMA, Ohio/OH",492,3,43,6,0,0,498,3,43,0,46,46,544,90,1,0,8,0,1,0,8,92,8,1,8
39,Ohio/OH,3904400,"Miami County PUMA, Ohio/OH",822,3,6,0,0,0,822,3,6,0,9,9,831,99,0,0,1,0,0,0,1,99,1,0,1
39,Ohio/OH,3904500,"Darke, Shelby & Preble Counties PUMA, Ohio/OH",1511,0,2,14,0,0,1525,0,2,0,2,2,1527,99,1,0,0,0,0,0,0,100,0,0,0
39,Ohio/OH,3904601,"Montgomery County (West)--Miamisburg & West Carrollton Cities PUMA, Ohio/OH",224,0,0,0,0,0,224,0,0,0,0,0,224,100,0,0,0,0,0,0,0,100,0,0,0
39,Ohio/OH,3904602,"Montgomery County (Northeast)--Huber Heights, Trotwood, Vandalia & Englewood Cities PUMA, Ohio/OH",285,0,0,0,16,22,285,16,22,38,0,38,323,88,0,12,0,5,0,7,0,88,12,5,7
39,Ohio/OH,3904603,"Montgomery County (East Central)--Dayton & Riverside Cities PUMA, Ohio/OH",216,13,0,0,118,15,216,131,15,133,13,146,362,60,0,37,4,33,4,4,0,60,40,36,4
39,Ohio/OH,3904604,"Montgomery County (Southeast)--Kettering & Centerville Cities PUMA, Ohio/OH",68,0,0,0,0,0,68,0,0,0,0,0,68,100,0,0,0,0,0,0,0,100,0,0,0
39,Ohio/OH,3904700,"Greene County PUMA, Ohio/OH",340,4,4,0,0,13,340,4,17,13,8,21,361,94,0,4,2,0,1,4,1,94,6,1,5
39,Ohio/OH,3904800,"Ross & Fayette Counties PUMA, Ohio/OH",468,21,21,0,25,0,468,46,21,25,42,67,535,87,0,5,8,5,4,0,4,87,13,9,4
39,Ohio/OH,3904900,"Jackson, Hocking, Pike & Vinton Counties PUMA, Ohio/OH",1200,0,0,34,0,0,1234,0,0,0,0,0,1234,97,3,0,0,0,0,0,0,100,0,0,0
39,Ohio/OH,3905000,"Athens, Gallia & Meigs Counties PUMA, Ohio/OH",535,0,0,0,0,0,535,0,0,0,0,0,535,100,0,0,0,0,0,0,0,100,0,0,0
39,Ohio/OH,3905100,"Scioto & Lawrence Counties PUMA, Ohio/OH",421,0,0,0,25,0,421,25,0,25,0,25,446,94,0,6,0,6,0,0,0,94,6,6,0
39,Ohio/OH,3905200,"Highland, Clinton & Adams Counties PUMA, Ohio/OH",1035,0,14,0,0,0,1035,0,14,0,14,14,1049,99,0,0,1,0,0,0,1,99,1,0,1
39,Ohio/OH,3905301,"Warren County (East)--Lebanon & Springboro (East) Cities PUMA, Ohio/OH",399,0,0,0,0,0,399,0,0,0,0,0,399,100,0,0,0,0,0,0,0,100,0,0,0
39,Ohio/OH,3905302,"Warren County (West)--Mason, Franklin & Springboro (West) Cities PUMA, Ohio/OH",246,0,0,0,0,0,246,0,0,0,0,0,246,100,0,0,0,0,0,0,0,100,0,0,0
39,Ohio/OH,3905401,"Butler County (Southeast)--Monroe City & Beckett Ridge PUMA, Ohio/OH",264,35,31,57,45,10,321,80,41,55,66,121,442,60,13,12,15,10,8,2,7,73,27,18,9
39,Ohio/OH,3905402,"Butler County (South Central)--Hamilton & Fairfield Cities PUMA, Ohio/OH",180,0,0,17,15,0,197,15,0,15,0,15,212,85,8,7,0,7,0,0,0,93,7,7,0
39,Ohio/OH,3905403,"Butler County (North & West)--Middletown, Oxford & Trenton Cities PUMA, Ohio/OH",223,65,24,0,0,0,223,65,24,0,89,89,312,71,0,0,29,0,21,0,8,71,29,21,8
39,Ohio/OH,3905501,"Hamilton County (West)--Mack & Dent PUMA, Ohio/OH",257,0,0,0,16,22,257,16,22,38,0,38,295,87,0,13,0,5,0,7,0,87,13,5,7
39,Ohio/OH,3905502,"Hamilton County (Central)--Forest Park City, White Oak, Bridgetown & Finneytown PUMA, Ohio/OH",489,0,44,25,0,0,514,0,44,0,44,44,558,88,4,0,8,0,0,0,8,92,8,0,8
39,Ohio/OH,3905503,"Cincinnati City (West) PUMA, Ohio/OH",474,0,0,0,0,11,474,0,11,11,0,11,485,98,0,2,0,0,0,2,0,98,2,0,2
39,Ohio/OH,3905504,"Cincinnati City (Central) PUMA, Ohio/OH",374,0,0,0,22,10,374,22,10,32,0,32,406,92,0,8,0,5,0,2,0,92,8,5,2
39,Ohio/OH,3905505,"Cincinnati (East) & Norwood Cities PUMA, Ohio/OH",249,0,0,0,8,32,249,8,32,40,0,40,289,86,0,14,0,3,0,11,0,86,14,3,11
39,Ohio/OH,3905506,"Hamilton County (North Central)--Sharonville, Blue Ash, Springdale & Reading Cities PUMA, Ohio/OH",199,0,0,24,216,74,223,216,74,290,0,290,513,39,5,57,0,42,0,14,0,43,57,42,14
39,Ohio/OH,3905507,"Hamilton County (East)--Loveland, Montgomery Cities & Forestville PUMA, Ohio/OH",179,0,0,0,0,0,179,0,0,0,0,0,179,100,0,0,0,0,0,0,0,100,0,0,0
39,Ohio/OH,3905600,"Clermont County (West) PUMA, Ohio/OH",275,0,0,0,0,0,275,0,0,0,0,0,275,100,0,0,0,0,0,0,0,100,0,0,0
39,Ohio/OH,3905700,"Clermont (East) & Brown Counties PUMA, Ohio/OH",350,0,0,0,0,0,350,0,0,0,0,0,350,100,0,0,0,0,0,0,0,100,0,0,0
40,Oklahoma/OK,4000100,"Northeast Oklahoma PUMA, Oklahoma/OK",1284,23,161,92,10,136,1376,33,297,146,184,330,1706,75,5,9,11,1,1,8,9,81,19,2,17
40,Oklahoma/OK,4000200,"Cherokee, Sequoyah & Adair Counties PUMA, Oklahoma/OK",1197,13,255,83,41,21,1280,54,276,62,268,330,1610,74,5,4,17,3,1,1,16,80,20,3,17
40,Oklahoma/OK,4000300,"Southeast Oklahoma PUMA, Oklahoma/OK",1693,68,122,117,19,97,1810,87,219,116,190,306,2116,80,6,5,9,1,3,5,6,86,14,4,10
40,Oklahoma/OK,4000400,"Southwest Oklahoma PUMA, Oklahoma/OK",1118,138,55,540,0,0,1658,138,55,0,193,193,1851,60,29,0,10,0,7,0,3,90,10,7,3
40,Oklahoma/OK,4000500,"Panhandle & Northwest Oklahoma PUMA, Oklahoma/OK",1408,58,1818,478,5,140,1886,63,1958,145,1876,2021,3907,36,12,4,48,0,1,4,47,48,52,2,50
40,Oklahoma/OK,4000601,"Comanche County (Central)--Lawton City PUMA, Oklahoma/OK",146,0,48,68,0,0,214,0,48,0,48,48,262,56,26,0,18,0,0,0,18,82,18,0,18
40,Oklahoma/OK,4000602,"Stephens, Caddo, Comanche (North), Tillman, Jefferson & Cotton Counties PUMA, Oklahoma/OK",535,5,143,122,0,7,657,5,150,7,148,155,812,66,15,1,18,0,1,1,18,81,19,1,18
40,Oklahoma/OK,4000701,"Carter, Garvin, Murray, Love & Pontotoc (West) Counties PUMA, Oklahoma/OK",523,9,18,74,0,0,597,9,18,0,27,27,624,84,12,0,4,0,1,0,3,96,4,1,3
40,Oklahoma/OK,4000702,"Bryan, Pontotoc (East), Marshall, Atoka, Johnston & Coal Counties--Ada City PUMA, Oklahoma/OK",431,22,8,34,0,17,465,22,25,17,30,47,512,84,7,3,6,0,4,3,2,91,9,4,5
40,Oklahoma/OK,4000800,"Canadian County--Oklahoma City (West) PUMA, Oklahoma/OK",559,0,12,13,282,0,572,282,12,282,12,294,866,65,2,33,1,33,0,0,1,66,34,33,1
40,Oklahoma/OK,4000900,"Cleveland County--Norman, Oklahoma City (South) & Moore Cities PUMA, Oklahoma/OK",239,0,64,54,23,0,293,23,64,23,64,87,380,63,14,6,17,6,0,0,17,77,23,6,17
40,Oklahoma/OK,4001001,"Oklahoma County (Southwest)--Oklahoma City (West Central) PUMA, Oklahoma/OK",80,19,60,292,0,0,372,19,60,0,79,79,451,18,65,0,18,0,4,0,13,82,18,4,13
40,Oklahoma/OK,4001002,"Oklahoma County (Northwest)--Oklahoma City (Northwest Central) & Bethany Cities PUMA, Oklahoma/OK",254,0,0,81,0,0,335,0,0,0,0,0,335,76,24,0,0,0,0,0,0,100,0,0,0
40,Oklahoma/OK,4001003,"Oklahoma County (Northeast)--Edmond & Oklahoma City (North Central) Cities PUMA, Oklahoma/OK",253,52,161,0,0,0,253,52,161,0,213,213,466,54,0,0,46,0,11,0,35,54,46,11,35
40,Oklahoma/OK,4001004,"Oklahoma County (East)--Midwest, Del & Oklahoma City (Northeast) Cities PUMA, Oklahoma/OK",177,0,0,0,0,0,177,0,0,0,0,0,177,100,0,0,0,0,0,0,0,100,0,0,0
40,Oklahoma/OK,4001005,"Oklahoma County (Southeast)--Oklahoma City (East Central) PUMA, Oklahoma/OK",127,56,154,0,0,0,127,56,154,0,210,210,337,38,0,0,62,0,17,0,46,38,62,17,46
40,Oklahoma/OK,4001006,"Oklahoma County (Central)--Oklahoma City (Central) PUMA, Oklahoma/OK",70,0,43,0,13,0,70,13,43,13,43,56,126,56,0,10,34,10,0,0,34,56,44,10,34
40,Oklahoma/OK,4001101,"Grady, McClain & Pottawatomie (South) Counties PUMA, Oklahoma/OK",414,0,77,15,53,0,429,53,77,53,77,130,559,74,3,9,14,9,0,0,14,77,23,9,14
40,Oklahoma/OK,4001102,"Pottawatomie (North), Logan & Lincoln Counties--Shawnee City PUMA, Oklahoma/OK",644,0,63,59,44,0,703,44,63,44,63,107,810,80,7,5,8,5,0,0,8,87,13,5,8
40,Oklahoma/OK,4001201,"Tulsa County (Central)--Tulsa City (Central) PUMA, Oklahoma/OK",233,54,229,66,0,47,299,54,276,47,283,330,629,37,10,7,45,0,9,7,36,48,52,9,44
40,Oklahoma/OK,4001202,"Tulsa County (Southeast)--Tulsa (Southeast) & Broken Arrow (West) Cities PUMA, Oklahoma/OK",180,69,79,0,16,22,180,85,101,38,148,186,366,49,0,10,40,4,19,6,22,49,51,23,28
40,Oklahoma/OK,4001203,"Tulsa County (North)--Tulsa (North) & Owasso Cities PUMA, Oklahoma/OK",255,0,42,0,0,17,255,0,59,17,42,59,314,81,0,5,13,0,0,5,13,81,19,0,19
40,Oklahoma/OK,4001204,"Tulsa (West), Creek (Northeast) & Osage (Southeast) Counties--Tulsa City (West) PUMA, Oklahoma/OK",385,0,19,0,0,0,385,0,19,0,19,19,404,95,0,0,5,0,0,0,5,95,5,0,5
40,Oklahoma/OK,4001301,"Rogers (Central) & Wagoner (West) Counties--Claremore City PUMA, Oklahoma/OK",109,0,0,0,0,0,109,0,0,0,0,0,109,100,0,0,0,0,0,0,0,100,0,0,0
40,Oklahoma/OK,4001302,"Muskogee, Okmulgee, Wagoner (East) & McIntosh Counties PUMA, Oklahoma/OK",278,0,27,57,0,0,335,0,27,0,27,27,362,77,16,0,7,0,0,0,7,93,7,0,7
40,Oklahoma/OK,4001400,"Garfield, Kay & Noble Counties--Enid City PUMA, Oklahoma/OK",775,106,169,144,35,6,919,141,175,41,275,316,1235,63,12,3,22,3,9,0,14,74,26,11,14
40,Oklahoma/OK,4001501,"Payne, Seminole, Creek (Southwest), Hughes & Okfuskee Counties--Stillwater City PUMA, Oklahoma/OK",703,13,89,167,15,0,870,28,89,15,102,117,987,71,17,2,10,2,1,0,9,88,12,3,9
40,Oklahoma/OK,4001601,"Washington, Osage (North & West), Pawnee & Creek (Northwest) Counties PUMA, Oklahoma/OK",265,0,0,0,6,0,265,6,0,6,0,6,271,98,0,2,0,2,0,0,0,98,2,2,0
41,Oregon/OR,4100100,"Umatilla, Union, Baker & Wallowa Counties PUMA, Oregon/OR",1545,185,1799,345,23,0,1890,208,1799,23,1984,2007,3897,40,9,1,51,1,5,0,46,48,52,5,46
41,Oregon/OR,4100200,"North Central Oregon--The Dalles City PUMA, Oregon/OR",1082,399,2174,355,0,7,1437,399,2181,7,2573,2580,4017,27,9,0,64,0,10,0,54,36,64,10,54
41,Oregon/OR,4100300,"Klamath, Malheur, Lake & Harney Counties PUMA, Oregon/OR",1172,91,790,197,58,0,1369,149,790,58,881,939,2308,51,9,3,38,3,4,0,34,59,41,6,34
41,Oregon/OR,4100400,"Deschutes County PUMA, Oregon/OR",320,0,264,56,40,0,376,40,264,40,264,304,680,47,8,6,39,6,0,0,39,55,45,6,39
41,Oregon/OR,4100500,"Columbia, Lincoln, Clatsop & Tillamook Counties PUMA, Oregon/OR",681,9,486,36,0,33,717,9,519,33,495,528,1245,55,3,3,40,0,1,3,39,58,42,1,42
41,Oregon/OR,4100600,"Linn & Benton Counties PUMA, Oregon/OR",1453,115,599,104,23,57,1557,138,656,80,714,794,2351,62,4,3,30,1,5,2,25,66,34,6,28
41,Oregon/OR,4100703,"Lane County (West Central)--Eugene City (West & South) PUMA, Oregon/OR",669,25,135,148,0,0,817,25,135,0,160,160,977,68,15,0,16,0,3,0,14,84,16,3,14
41,Oregon/OR,4100704,"Lane County (East Central)--Eugene (Northeast) & Springfield Cities PUMA, Oregon/OR",637,0,187,44,0,0,681,0,187,0,187,187,868,73,5,0,22,0,0,0,22,78,22,0,22
41,Oregon/OR,4100705,"Lane County (Outside Eugene & Springfield Cities) PUMA, Oregon/OR",350,19,73,47,18,0,397,37,73,18,92,110,507,69,9,4,18,4,4,0,14,78,22,7,14
41,Oregon/OR,4100800,"Josephine, Coos & Curry Counties PUMA, Oregon/OR",1037,43,234,99,0,0,1136,43,234,0,277,277,1413,73,7,0,20,0,3,0,17,80,20,3,17
41,Oregon/OR,4100901,"Jackson County (Central)--Medford & Central Point Cities PUMA, Oregon/OR",364,75,508,130,0,13,494,75,521,13,583,596,1090,33,12,1,53,0,7,1,47,45,55,7,48
41,Oregon/OR,4100902,"Jackson County (Outside Medford & Central Point Cities)--Ashland City PUMA, Oregon/OR",271,0,220,73,0,0,344,0,220,0,220,220,564,48,13,0,39,0,0,0,39,61,39,0,39
41,Oregon/OR,4101000,"Douglas County PUMA, Oregon/OR",376,10,98,0,0,0,376,10,98,0,108,108,484,78,0,0,22,0,2,0,20,78,22,2,20
41,Oregon/OR,4101103,"Marion County (West Central)--Salem (North), Keizer Cities & Hayesville PUMA, Oregon/OR",382,478,2336,490,78,0,872,556,2336,78,2814,2892,3764,10,13,2,75,2,13,0,62,23,77,15,62
41,Oregon/OR,4101104,"Marion County (West Central)--Salem City (South) & Four Corners PUMA, Oregon/OR",307,0,687,58,51,8,365,51,695,59,687,746,1111,28,5,5,62,5,0,1,62,33,67,5,63
41,Oregon/OR,4101105,"Marion County (Outside Salem & Keizer Cities)--Woodburn & Silverton Cities PUMA, Oregon/OR",688,263,1669,341,0,32,1029,263,1701,32,1932,1964,2993,23,11,1,65,0,9,1,56,34,66,9,57
41,Oregon/OR,4101200,"Yamhill & Polk Counties PUMA, Oregon/OR",1014,536,2164,263,0,0,1277,536,2164,0,2700,2700,3977,25,7,0,68,0,13,0,54,32,68,13,54
41,Oregon/OR,4101301,"Portland City (North & Northeast) PUMA, Oregon/OR",298,65,74,127,33,0,425,98,74,33,139,172,597,50,21,6,23,6,11,0,12,71,29,16,12
41,Oregon/OR,4101302,"Portland City (East) PUMA, Oregon/OR",253,0,339,0,48,20,253,48,359,68,339,407,660,38,0,10,51,7,0,3,51,38,62,7,54
41,Oregon/OR,4101303,"Portland City (Southeast) PUMA, Oregon/OR",256,18,114,30,59,42,286,77,156,101,132,233,519,49,6,19,25,11,3,8,22,55,45,15,30
41,Oregon/OR,4101305,"Portland City (Central East) PUMA, Oregon/OR",231,20,53,95,0,35,326,20,88,35,73,108,434,53,22,8,17,0,5,8,12,75,25,5,20
41,Oregon/OR,4101314,"Portland City (Northwest & Southwest) PUMA, Oregon/OR",177,0,0,3,0,44,180,0,44,44,0,44,224,79,1,20,0,0,0,20,0,80,20,0,20
41,Oregon/OR,4101316,"Multnomah County (East)--Gresham & Troutdale Cities PUMA, Oregon/OR",302,158,643,96,68,98,398,226,741,166,801,967,1365,22,7,12,59,5,12,7,47,29,71,17,54
41,Oregon/OR,4101317,"Clackamas County (South & East)--Damascus City PUMA, Oregon/OR",267,42,408,184,0,14,451,42,422,14,450,464,915,29,20,2,49,0,5,2,45,49,51,5,46
41,Oregon/OR,4101318,"Clackamas County (Northwest)--Oregon City, Milwaukie & Happy Valley Cities PUMA, Oregon/OR",586,91,25,130,27,14,716,118,39,41,116,157,873,67,15,5,13,3,10,2,3,82,18,14,4
41,Oregon/OR,4101319,"Clackamas County (Northwest)--Lake Oswego, West Linn, Wilsonville & Canby Cities PUMA, Oregon/OR",99,77,400,27,0,0,126,77,400,0,477,477,603,16,4,0,79,0,13,0,66,21,79,13,66
41,Oregon/OR,4101320,"Washington County (Southeast)--Tigard, Tualatin & Sherwood Cities PUMA, Oregon/OR",295,95,112,52,24,0,347,119,112,24,207,231,578,51,9,4,36,4,16,0,19,60,40,21,19
41,Oregon/OR,4101321,"Washington County (West)--Forest Grove, Cornelius Cities, Bethany & Oak Hills PUMA, Oregon/OR",188,45,765,380,0,27,568,45,792,27,810,837,1405,13,27,2,58,0,3,2,54,40,60,3,56
41,Oregon/OR,4101322,"Washington County (Central)--Hillsboro City PUMA, Oregon/OR",214,112,649,232,39,0,446,151,649,39,761,800,1246,17,19,3,61,3,9,0,52,36,64,12,52
41,Oregon/OR,4101323,"Washington County (Central)--Beaverton City (West) & Aloha PUMA, Oregon/OR",96,77,49,30,13,0,126,90,49,13,126,139,265,36,11,5,48,5,29,0,18,48,52,34,18
41,Oregon/OR,4101324,"Washington County (Northeast)--Beaverton City (East & Central) & Cedar Mill PUMA, Oregon/OR",311,69,286,29,0,0,340,69,286,0,355,355,695,45,4,0,51,0,10,0,41,49,51,10,41
42,Pennsylvania/PA,4200101,"Erie City, Lawrence Park Township & Wesleyville Borough PUMA, Pennsylvania/PA",411,12,12,75,75,33,486,87,45,108,24,132,618,67,12,17,4,12,2,5,2,79,21,14,7
42,Pennsylvania/PA,4200102,"Erie County (Outer) PUMA, Pennsylvania/PA",793,0,1,0,0,29,793,0,30,29,1,30,823,96,0,4,0,0,0,4,0,96,4,0,4
42,Pennsylvania/PA,4200200,"Crawford & Warren Counties PUMA, Pennsylvania/PA",840,0,0,46,0,5,886,0,5,5,0,5,891,94,5,1,0,0,0,1,0,99,1,0,1
42,Pennsylvania/PA,4200300,"Clearfield, McKean, Elk, Potter & Cameron Counties PUMA, Pennsylvania/PA",462,0,0,0,0,4,462,0,4,4,0,4,466,99,0,1,0,0,0,1,0,99,1,0,1
42,Pennsylvania/PA,4200400,"Bradford, Tioga & Sullivan Counties PUMA, Pennsylvania/PA",1342,0,54,11,0,3,1353,0,57,3,54,57,1410,95,1,0,4,0,0,0,4,96,4,0,4
42,Pennsylvania/PA,4200500,"Pike, Wayne & Susquehanna Counties PUMA, Pennsylvania/PA",523,0,28,28,0,0,551,0,28,0,28,28,579,90,5,0,5,0,0,0,5,95,5,0,5
42,Pennsylvania/PA,4200600,"Monroe County PUMA, Pennsylvania/PA",255,0,120,68,0,0,323,0,120,0,120,120,443,58,15,0,27,0,0,0,27,73,27,0,27
42,Pennsylvania/PA,4200701,"Lackawanna County--Scranton City, Dunmore, Old Forge, Taylor & Moosic Boroughs PUMA, Pennsylvania/PA",241,0,135,499,20,102,740,20,237,122,135,257,997,24,50,12,14,2,0,10,14,74,26,2,24
42,Pennsylvania/PA,4200702,"Lackawanna (Outside Greater Scranton City) & Wyoming Counties PUMA, Pennsylvania/PA",644,0,5,0,0,24,644,0,29,24,5,29,673,96,0,4,1,0,0,4,1,96,4,0,4
42,Pennsylvania/PA,4200801,"Luzerne County (East)--Kingston Borough PUMA, Pennsylvania/PA",421,0,171,0,12,38,421,12,209,50,171,221,642,66,0,8,27,2,0,6,27,66,34,2,33
42,Pennsylvania/PA,4200802,"Luzerne County (South Central)--Wilkes-Barre & Hazleton Cities PUMA, Pennsylvania/PA",827,177,548,160,40,0,987,217,548,40,725,765,1752,47,9,2,41,2,10,0,31,56,44,12,31
42,Pennsylvania/PA,4200803,"Columbia & Luzerne (West) Counties--Bloomsburg Town & Berwick Borough PUMA, Pennsylvania/PA",959,11,75,21,7,0,980,18,75,7,86,93,1073,89,2,1,8,1,1,0,7,91,9,2,7
42,Pennsylvania/PA,4200900,"Lycoming & Clinton Counties PUMA, Pennsylvania/PA",668,0,0,0,0,0,668,0,0,0,0,0,668,100,0,0,0,0,0,0,0,100,0,0,0
42,Pennsylvania/PA,4201000,"Northumberland & Montour Counties PUMA, Pennsylvania/PA",1078,0,0,20,12,0,1098,12,0,12,0,12,1110,97,2,1,0,1,0,0,0,99,1,1,0
42,Pennsylvania/PA,4201100,"Mifflin, Union, Snyder & Juniata Counties PUMA, Pennsylvania/PA",1711,71,256,189,0,0,1900,71,256,0,327,327,2227,77,8,0,15,0,3,0,11,85,15,3,11
42,Pennsylvania/PA,4201200,"Centre County PUMA, Pennsylvania/PA",346,0,4,0,52,0,346,52,4,52,4,56,402,86,0,13,1,13,0,0,1,86,14,13,1
42,Pennsylvania/PA,4201300,"Venango, Jefferson, Clarion & Forest Counties PUMA, Pennsylvania/PA",416,0,0,0,0,0,416,0,0,0,0,0,416,100,0,0,0,0,0,0,0,100,0,0,0
42,Pennsylvania/PA,4201400,"Mercer County PUMA, Pennsylvania/PA",911,0,6,29,44,38,940,44,44,82,6,88,1028,89,3,8,1,4,0,4,1,91,9,4,4
42,Pennsylvania/PA,4201501,"Lawrence & Beaver (North) Counties--New Castle City PUMA, Pennsylvania/PA",223,0,5,36,0,0,259,0,5,0,5,5,264,84,14,0,2,0,0,0,2,98,2,0,2
42,Pennsylvania/PA,4201502,"Beaver County (South) PUMA, Pennsylvania/PA",139,0,0,27,0,0,166,0,0,0,0,0,166,84,16,0,0,0,0,0,0,100,0,0,0
42,Pennsylvania/PA,4201600,"Butler County PUMA, Pennsylvania/PA",295,0,13,0,0,0,295,0,13,0,13,13,308,96,0,0,4,0,0,0,4,96,4,0,4
42,Pennsylvania/PA,4201701,"Pittsburgh City (North) PUMA, Pennsylvania/PA",205,0,0,73,20,0,278,20,0,20,0,20,298,69,24,7,0,7,0,0,0,93,7,7,0
42,Pennsylvania/PA,4201702,"Pittsburgh City (South) PUMA, Pennsylvania/PA",87,0,24,0,18,0,87,18,24,18,24,42,129,67,0,14,19,14,0,0,19,67,33,14,19
42,Pennsylvania/PA,4201801,"Allegheny County (West) PUMA, Pennsylvania/PA",72,0,0,0,0,0,72,0,0,0,0,0,72,100,0,0,0,0,0,0,0,100,0,0,0
42,Pennsylvania/PA,4201802,"Allegheny County (North)--Franklin Park Borough & Allison Park PUMA, Pennsylvania/PA",131,0,0,58,0,0,189,0,0,0,0,0,189,69,31,0,0,0,0,0,0,100,0,0,0
42,Pennsylvania/PA,4201803,"Allegheny County (North Central) PUMA, Pennsylvania/PA",139,0,5,0,0,0,139,0,5,0,5,5,144,97,0,0,3,0,0,0,3,97,3,0,3
42,Pennsylvania/PA,4201804,"Allegheny County (East)--Monroeville Municipality, Plum & Wilkinsburg Boroughs PUMA, Pennsylvania/PA",207,0,0,0,18,0,207,18,0,18,0,18,225,92,0,8,0,8,0,0,0,92,8,8,0
42,Pennsylvania/PA,4201805,"Allegheny County (Southeast)--West Mifflin Borough, McKeesport City & Munhall Borough PUMA, Pennsylvania/PA",132,0,1,6,4,0,138,4,1,4,1,5,143,92,4,3,1,3,0,0,1,97,3,3,1
42,Pennsylvania/PA,4201806,"Allegheny County (South Central)--Baldwin & Whitehall Boroughs PUMA, Pennsylvania/PA",171,0,0,37,74,12,208,74,12,86,0,86,294,58,13,29,0,25,0,4,0,71,29,25,4
42,Pennsylvania/PA,4201807,"Allegheny County (South)--Bethel Park Municipality & Jefferson Hills Borough PUMA, Pennsylvania/PA",84,0,1,0,0,0,84,0,1,0,1,1,85,99,0,0,1,0,0,0,1,99,1,0,1
42,Pennsylvania/PA,4201900,"Indiana & Armstrong Counties PUMA, Pennsylvania/PA",472,0,4,0,0,0,472,0,4,0,4,4,476,99,0,0,1,0,0,0,1,99,1,0,1
42,Pennsylvania/PA,4202001,"Westmoreland County (Northwest)--Murrysville Municipality & New Kensington City PUMA, Pennsylvania/PA",271,0,3,0,0,0,271,0,3,0,3,3,274,99,0,0,1,0,0,0,1,99,1,0,1
42,Pennsylvania/PA,4202002,"Westmoreland County (Southwest)--Greensburg City PUMA, Pennsylvania/PA",129,4,0,0,0,0,129,4,0,0,4,4,133,97,0,0,3,0,3,0,0,97,3,3,0
42,Pennsylvania/PA,4202003,"Westmoreland County (East) PUMA, Pennsylvania/PA",252,0,78,0,0,0,252,0,78,0,78,78,330,76,0,0,24,0,0,0,24,76,24,0,24
42,Pennsylvania/PA,4202100,"Cambria County PUMA, Pennsylvania/PA",277,0,7,0,0,0,277,0,7,0,7,7,284,98,0,0,2,0,0,0,2,98,2,0,2
42,Pennsylvania/PA,4202200,"Blair & Huntingdon Counties--Altoona City PUMA, Pennsylvania/PA",1113,0,37,0,0,0,1113,0,37,0,37,37,1150,97,0,0,3,0,0,0,3,97,3,0,3
42,Pennsylvania/PA,4202301,"Cumberland (West) & Perry Counties--Carlisle Borough PUMA, Pennsylvania/PA",1288,0,60,62,0,5,1350,0,65,5,60,65,1415,91,4,0,4,0,0,0,4,95,5,0,5
42,Pennsylvania/PA,4202302,"Cumberland County (East) PUMA, Pennsylvania/PA",390,0,0,54,49,35,444,49,35,84,0,84,528,74,10,16,0,9,0,7,0,84,16,9,7
42,Pennsylvania/PA,4202401,"Dauphin County (Central)--Harrisburg City & Colonial Park PUMA, Pennsylvania/PA",384,63,0,110,92,81,494,155,81,173,63,236,730,53,15,24,9,13,9,11,0,68,32,21,11
42,Pennsylvania/PA,4202402,"Dauphin County (Outer)--Hershey PUMA, Pennsylvania/PA",415,0,49,30,0,28,445,0,77,28,49,77,522,80,6,5,9,0,0,5,9,85,15,0,15
42,Pennsylvania/PA,4202500,"Lebanon County PUMA, Pennsylvania/PA",1343,0,59,427,58,110,1770,58,169,168,59,227,1997,67,21,8,3,3,0,6,3,89,11,3,8
42,Pennsylvania/PA,4202600,"Schuylkill County PUMA, Pennsylvania/PA",777,0,4,69,0,0,846,0,4,0,4,4,850,91,8,0,0,0,0,0,0,100,0,0,0
42,Pennsylvania/PA,4202701,"Berks County (Northwest)--Wyomissing Borough PUMA, Pennsylvania/PA",565,11,97,130,0,71,695,11,168,71,108,179,874,65,15,8,12,0,1,8,11,80,20,1,19
42,Pennsylvania/PA,4202702,"Berks County (Southwest)--Reading City PUMA, Pennsylvania/PA",353,134,1141,889,146,0,1242,280,1141,146,1275,1421,2663,13,33,5,48,5,5,0,43,47,53,11,43
42,Pennsylvania/PA,4202703,"Berks County (East) PUMA, Pennsylvania/PA",979,0,0,53,0,106,1032,0,106,106,0,106,1138,86,5,9,0,0,0,9,0,91,9,0,9
42,Pennsylvania/PA,4202801,"Carbon & Lehigh (North) Counties PUMA, Pennsylvania/PA",753,0,38,37,10,0,790,10,38,10,38,48,838,90,4,1,5,1,0,0,5,94,6,1,5
42,Pennsylvania/PA,4202802,"Lehigh County (South--Outside Allentown & Bethlehem Cities)--Emmaus Borough PUMA, Pennsylvania/PA",383,0,139,86,0,5,469,0,144,5,139,144,613,62,14,1,23,0,0,1,23,77,23,0,23
42,Pennsylvania/PA,4202803,"Allentown City PUMA, Pennsylvania/PA",195,77,370,489,0,0,684,77,370,0,447,447,1131,17,43,0,40,0,7,0,33,60,40,7,33
42,Pennsylvania/PA,4202901,"Northampton (South) & Lehigh (East) Counties--Bethlehem (East) & Easton Cities PUMA, Pennsylvania/PA",347,31,458,172,0,21,519,31,479,21,489,510,1029,34,17,2,48,0,3,2,45,50,50,3,47
42,Pennsylvania/PA,4202902,"Northampton County (North) PUMA, Pennsylvania/PA",460,0,0,0,29,0,460,29,0,29,0,29,489,94,0,6,0,6,0,0,0,94,6,6,0
42,Pennsylvania/PA,4203001,"Bucks County (North) PUMA, Pennsylvania/PA",347,0,18,0,0,0,347,0,18,0,18,18,365,95,0,0,5,0,0,0,5,95,5,0,5
42,Pennsylvania/PA,4203002,"Bucks County (Central) PUMA, Pennsylvania/PA",122,0,0,0,0,0,122,0,0,0,0,0,122,100,0,0,0,0,0,0,0,100,0,0,0
42,Pennsylvania/PA,4203003,"Bucks County (Southeast)--Levittown PUMA, Pennsylvania/PA",68,0,0,101,25,0,169,25,0,25,0,25,194,35,52,13,0,13,0,0,0,87,13,13,0
42,Pennsylvania/PA,4203004,"Bucks County (Southwest) PUMA, Pennsylvania/PA",174,0,40,162,13,0,336,13,40,13,40,53,389,45,42,3,10,3,0,0,10,86,14,3,10
42,Pennsylvania/PA,4203101,"Montgomery County (Northwest)--Pottstown Borough PUMA, Pennsylvania/PA",358,0,26,0,0,0,358,0,26,0,26,26,384,93,0,0,7,0,0,0,7,93,7,0,7
42,Pennsylvania/PA,4203102,"Montgomery County (Northeast)--Lansdale Borough PUMA, Pennsylvania/PA",335,0,223,103,130,112,438,130,335,242,223,465,903,37,11,27,25,14,0,12,25,49,51,14,37
42,Pennsylvania/PA,4203103,"Montgomery County (Southwest)--King of Prussia & Ardmore (East) PUMA, Pennsylvania/PA",102,0,8,0,0,0,102,0,8,0,8,8,110,93,0,0,7,0,0,0,7,93,7,0,7
42,Pennsylvania/PA,4203104,"Montgomery County (Central)--Norristown Borough PUMA, Pennsylvania/PA",315,0,12,24,0,25,339,0,37,25,12,37,376,84,6,7,3,0,0,7,3,90,10,0,10
42,Pennsylvania/PA,4203105,"Montgomery County (Southeast)--Willow Grove, Horsham & Montgomeryville PUMA, Pennsylvania/PA",81,0,53,0,0,0,81,0,53,0,53,53,134,60,0,0,40,0,0,0,40,60,40,0,40
42,Pennsylvania/PA,4203106,"Montgomery County (South Central) PUMA, Pennsylvania/PA",68,0,0,0,0,0,68,0,0,0,0,0,68,100,0,0,0,0,0,0,0,100,0,0,0
42,Pennsylvania/PA,4203201,"Philadelphia City (Far Northeast) PUMA, Pennsylvania/PA",190,0,0,22,0,42,212,0,42,42,0,42,254,75,9,17,0,0,0,17,0,83,17,0,17
42,Pennsylvania/PA,4203202,"Philadelphia City (Near Northeast-West) PUMA, Pennsylvania/PA",123,102,0,0,20,302,123,122,302,322,102,424,547,22,0,59,19,4,19,55,0,22,78,22,55
42,Pennsylvania/PA,4203203,"Philadelphia City (Near Northeast-East) PUMA, Pennsylvania/PA",297,0,101,105,0,0,402,0,101,0,101,101,503,59,21,0,20,0,0,0,20,80,20,0,20
42,Pennsylvania/PA,4203204,"Philadelphia City (North) PUMA, Pennsylvania/PA",212,0,55,0,39,177,212,39,232,216,55,271,483,44,0,45,11,8,0,37,11,44,56,8,48
42,Pennsylvania/PA,4203205,"Philadelphia City (East) PUMA, Pennsylvania/PA",135,66,60,200,0,0,335,66,60,0,126,126,461,29,43,0,27,0,14,0,13,73,27,14,13
42,Pennsylvania/PA,4203206,"Philadelphia City (Northwest) PUMA, Pennsylvania/PA",184,0,0,0,0,0,184,0,0,0,0,0,184,100,0,0,0,0,0,0,0,100,0,0,0
42,Pennsylvania/PA,4203207,"Philadelphia City (Central) PUMA, Pennsylvania/PA",399,0,0,45,0,0,444,0,0,0,0,0,444,90,10,0,0,0,0,0,0,100,0,0,0
42,Pennsylvania/PA,4203208,"Philadelphia City (West) PUMA, Pennsylvania/PA",219,0,0,0,0,0,219,0,0,0,0,0,219,100,0,0,0,0,0,0,0,100,0,0,0
42,Pennsylvania/PA,4203209,"Philadelphia City (Center City) PUMA, Pennsylvania/PA",53,0,0,62,0,0,115,0,0,0,0,0,115,46,54,0,0,0,0,0,0,100,0,0,0
42,Pennsylvania/PA,4203210,"Philadelphia City (Southwest) PUMA, Pennsylvania/PA",124,0,0,0,124,50,124,124,50,174,0,174,298,42,0,58,0,42,0,17,0,42,58,42,17
42,Pennsylvania/PA,4203211,"Philadelphia City (Southeast) PUMA, Pennsylvania/PA",88,0,100,596,74,33,684,74,133,107,100,207,891,10,67,12,11,8,0,4,11,77,23,8,15
42,Pennsylvania/PA,4203301,"Delaware County (North)--Broomall & Ardmore (West) PUMA, Pennsylvania/PA",72,0,4,0,0,0,72,0,4,0,4,4,76,95,0,0,5,0,0,0,5,95,5,0,5
42,Pennsylvania/PA,4203302,"Delaware County (East)--Yeadon, Darby, Lansdowne Boroughs & Drexel Hill PUMA, Pennsylvania/PA",72,0,24,52,34,112,124,34,136,146,24,170,294,24,18,50,8,12,0,38,8,42,58,12,46
42,Pennsylvania/PA,4203303,"Delaware County (Southeast)--Chester City PUMA, Pennsylvania/PA",282,26,62,16,0,0,298,26,62,0,88,88,386,73,4,0,23,0,7,0,16,77,23,7,16
42,Pennsylvania/PA,4203304,"Delaware County (West) PUMA, Pennsylvania/PA",134,0,26,0,0,0,134,0,26,0,26,26,160,84,0,0,16,0,0,0,16,84,16,0,16
42,Pennsylvania/PA,4203401,"Chester County (North)--Phoenixville Borough PUMA, Pennsylvania/PA",194,0,128,0,0,0,194,0,128,0,128,128,322,60,0,0,40,0,0,0,40,60,40,0,40
42,Pennsylvania/PA,4203402,"Chester County (East Central)--West Chester Borough PUMA, Pennsylvania/PA",261,0,193,0,0,29,261,0,222,29,193,222,483,54,0,6,40,0,0,6,40,54,46,0,46
42,Pennsylvania/PA,4203403,"Chester County (West Central)--Coatesville City PUMA, Pennsylvania/PA",149,0,184,0,26,0,149,26,184,26,184,210,359,42,0,7,51,7,0,0,51,42,58,7,51
42,Pennsylvania/PA,4203404,"Chester County (South) PUMA, Pennsylvania/PA",913,208,2606,160,12,15,1073,220,2621,27,2814,2841,3914,23,4,1,72,0,5,0,67,27,73,6,67
42,Pennsylvania/PA,4203501,"Lancaster County--Lancaster City, East Lampeter, Lancaster & West Lampeter Townships PUMA, Pennsylvania/PA",548,82,66,394,21,225,942,103,291,246,148,394,1336,41,29,18,11,2,6,17,5,71,29,8,22
42,Pennsylvania/PA,4203502,"Lancaster County (Northwest)--Elizabethtown Borough PUMA, Pennsylvania/PA",922,0,83,26,0,3,948,0,86,3,83,86,1034,89,3,0,8,0,0,0,8,92,8,0,8
42,Pennsylvania/PA,4203503,"Lancaster County (East)--Ephrata Borough PUMA, Pennsylvania/PA",2581,0,27,133,76,47,2714,76,74,123,27,150,2864,90,5,4,1,3,0,2,1,95,5,3,3
42,Pennsylvania/PA,4203504,"Lancaster County (Southwest)--Columbia Borough PUMA, Pennsylvania/PA",928,0,92,30,138,0,958,138,92,138,92,230,1188,78,3,12,8,12,0,0,8,81,19,12,8
42,Pennsylvania/PA,4203601,"York County (Central)--York City & Shiloh PUMA, Pennsylvania/PA",430,0,172,51,0,0,481,0,172,0,172,172,653,66,8,0,26,0,0,0,26,74,26,0,26
42,Pennsylvania/PA,4203602,"York County (North)--Weigelstown PUMA, Pennsylvania/PA",630,0,3,0,0,0,630,0,3,0,3,3,633,100,0,0,0,0,0,0,0,100,0,0,0
42,Pennsylvania/PA,4203603,"York County (South) PUMA, Pennsylvania/PA",1113,0,29,0,14,0,1113,14,29,14,29,43,1156,96,0,1,3,1,0,0,3,96,4,1,3
42,Pennsylvania/PA,4203701,"Adams & Franklin (Southeast) Counties PUMA, Pennsylvania/PA",1571,185,581,99,0,5,1670,185,586,5,766,771,2441,64,4,0,31,0,8,0,24,68,32,8,24
42,Pennsylvania/PA,4203702,"Franklin County (Outside Washington Township & Waynesboro Borough) PUMA, Pennsylvania/PA",1519,0,179,27,0,0,1546,0,179,0,179,179,1725,88,2,0,10,0,0,0,10,90,10,0,10
42,Pennsylvania/PA,4203800,"Somerset, Bedford & Fulton Counties PUMA, Pennsylvania/PA",1086,0,34,0,94,0,1086,94,34,94,34,128,1214,89,0,8,3,8,0,0,3,89,11,8,3
42,Pennsylvania/PA,4203900,"Fayette County PUMA, Pennsylvania/PA",138,0,0,0,0,0,138,0,0,0,0,0,138,100,0,0,0,0,0,0,0,100,0,0,0
42,Pennsylvania/PA,4204001,"Washington County (North)--Washington City PUMA, Pennsylvania/PA",344,0,12,0,0,0,344,0,12,0,12,12,356,97,0,0,3,0,0,0,3,97,3,0,3
42,Pennsylvania/PA,4204002,"Washington (South) & Greene Counties PUMA, Pennsylvania/PA",79,0,0,0,0,0,79,0,0,0,0,0,79,100,0,0,0,0,0,0,0,100,0,0,0
44,Rhode Island/RI,4400101,"Northwest Rhode Island--Providence County (West & Central)--Woonsocket City PUMA, Rhode Island/RI",365,31,0,0,0,21,365,31,21,21,31,52,417,88,0,5,7,0,7,5,0,88,12,7,5
44,Rhode Island/RI,4400102,"Northeast Rhode Island--Providence County--Pawtucket & Central Falls Cities PUMA, Rhode Island/RI",178,11,141,55,0,34,233,11,175,34,152,186,419,42,13,8,36,0,3,8,34,56,44,3,42
44,Rhode Island/RI,4400103,"Providence City PUMA, Rhode Island/RI",83,66,297,72,124,15,155,190,312,139,363,502,657,13,11,21,55,19,10,2,45,24,76,29,47
44,Rhode Island/RI,4400104,"Providence County (Southeast)--Cranston & East Providence Cities PUMA, Rhode Island/RI",135,0,38,0,11,32,135,11,70,43,38,81,216,62,0,20,18,5,0,15,18,62,38,5,32
44,Rhode Island/RI,4400201,"Central Rhode Island--Kent County--Warwick City PUMA, Rhode Island/RI",42,9,12,0,0,18,42,9,30,18,21,39,81,52,0,22,26,0,11,22,15,52,48,11,37
44,Rhode Island/RI,4400300,"Southeast Rhode Island--Newport & Bristol Counties--Newport City PUMA, Rhode Island/RI",211,0,0,0,28,0,211,28,0,28,0,28,239,88,0,12,0,12,0,0,0,88,12,12,0
44,Rhode Island/RI,4400400,"South Rhode Island--Washington County PUMA, Rhode Island/RI",77,0,0,0,0,20,77,0,20,20,0,20,97,79,0,21,0,0,0,21,0,79,21,0,21
45,South Carolina/SC,4500101,"Pickens & Oconee Counties--Easley & Clemson Cities PUMA, South Carolina/SC",359,0,221,16,0,0,375,0,221,0,221,221,596,60,3,0,37,0,0,0,37,63,37,0,37
45,South Carolina/SC,4500102,"Greenville County (North)--Greer City (North & West) & Taylors (Central & East) PUMA, South Carolina/SC",128,27,66,0,0,0,128,27,66,0,93,93,221,58,0,0,42,0,12,0,30,58,42,12,30
45,South Carolina/SC,4500103,"Greenville County (North Central & Outside Greenville City)--Wade Hampton & Berea PUMA, South Carolina/SC",283,23,175,0,21,10,283,44,185,31,198,229,512,55,0,6,39,4,4,2,34,55,45,9,36
45,South Carolina/SC,4500104,"Greenville County (Central)--Greenville & Mauldin Cities PUMA, South Carolina/SC",156,0,6,0,0,0,156,0,6,0,6,6,162,96,0,0,4,0,0,0,4,96,4,0,4
45,South Carolina/SC,4500105,"Greenville (South) & Laurens Counties--Simpsonville, Laurens & Clinton Cities PUMA, South Carolina/SC",275,0,66,0,0,0,275,0,66,0,66,66,341,81,0,0,19,0,0,0,19,81,19,0,19
45,South Carolina/SC,4500200,"Anderson County--Anderson City PUMA, South Carolina/SC",461,0,2,0,0,0,461,0,2,0,2,2,463,100,0,0,0,0,0,0,0,100,0,0,0
45,South Carolina/SC,4500301,"Spartanburg County (Central)--Spartanburg City PUMA, South Carolina/SC",333,0,6,26,15,17,359,15,23,32,6,38,397,84,7,8,2,4,0,4,2,90,10,4,6
45,South Carolina/SC,4500302,"Spartanburg County (Outside Spartanburg City)--Greer City (East) PUMA, South Carolina/SC",240,82,23,5,0,0,245,82,23,0,105,105,350,69,1,0,30,0,23,0,7,70,30,23,7
45,South Carolina/SC,4500400,"Cherokee, Newberry, Chester & Union Counties PUMA, South Carolina/SC",1050,43,158,10,0,0,1060,43,158,0,201,201,1261,83,1,0,16,0,3,0,13,84,16,3,13
45,South Carolina/SC,4500501,"York County (West & Outside Rock Hill City) PUMA, South Carolina/SC",341,0,6,0,0,0,341,0,6,0,6,6,347,98,0,0,2,0,0,0,2,98,2,0,2
45,South Carolina/SC,4500502,"York County (East)--Rock Hill City & Fort Mill Town PUMA, South Carolina/SC",268,0,77,0,0,0,268,0,77,0,77,77,345,78,0,0,22,0,0,0,22,78,22,0,22
45,South Carolina/SC,4500601,"Lexington (South & West) & Saluda Counties--Lexington Town & Red Bank PUMA, South Carolina/SC",745,87,550,86,10,40,831,97,590,50,637,687,1518,49,6,3,42,1,6,3,36,55,45,6,39
45,South Carolina/SC,4500602,"Lexington County (North & East)--West Columbia, Cayce Cities, Irmo Town & Seven Oaks PUMA, South Carolina/SC",267,0,39,4,0,53,271,0,92,53,39,92,363,74,1,15,11,0,0,15,11,75,25,0,25
45,South Carolina/SC,4500603,"Richland (North) & Fairfield Counties--Forest Acres City & Dentsville PUMA, South Carolina/SC",458,0,1,0,0,21,458,0,22,21,1,22,480,95,0,4,0,0,0,4,0,95,5,0,5
45,South Carolina/SC,4500604,"Richland County (Central)--Columbia City PUMA, South Carolina/SC",470,0,31,0,19,28,470,19,59,47,31,78,548,86,0,9,6,3,0,5,6,86,14,3,11
45,South Carolina/SC,4500605,"Kershaw, Richland (South) & Calhoun Counties PUMA, South Carolina/SC",399,0,64,0,0,0,399,0,64,0,64,64,463,86,0,0,14,0,0,0,14,86,14,0,14
45,South Carolina/SC,4500700,"Lancaster, Chesterfield & Marlboro Counties PUMA, South Carolina/SC",1040,0,267,0,0,0,1040,0,267,0,267,267,1307,80,0,0,20,0,0,0,20,80,20,0,20
45,South Carolina/SC,4500800,"Sumter, Clarendon, Williamsburg & Lee Counties--Sumter City PUMA, South Carolina/SC",1872,37,205,0,0,0,1872,37,205,0,242,242,2114,89,0,0,11,0,2,0,10,89,11,2,10
45,South Carolina/SC,4500900,"Florence & Darlington Counties--Florence City PUMA, South Carolina/SC",803,30,76,0,0,40,803,30,116,40,106,146,949,85,0,4,11,0,3,4,8,85,15,3,12
45,South Carolina/SC,4501000,"Georgetown, Marion & Dillon Counties PUMA, South Carolina/SC",1438,0,21,0,0,0,1438,0,21,0,21,21,1459,99,0,0,1,0,0,0,1,99,1,0,1
45,South Carolina/SC,4501101,"Horry County (West & North)--Conway City & Red Hill PUMA, South Carolina/SC",121,8,50,0,0,0,121,8,50,0,58,58,179,68,0,0,32,0,4,0,28,68,32,4,28
45,South Carolina/SC,4501102,"Horry County (Southeast)--Myrtle Beach, North Myrtle Beach Cities & Socastee (East) PUMA, South Carolina/SC",298,0,15,0,0,0,298,0,15,0,15,15,313,95,0,0,5,0,0,0,5,95,5,0,5
45,South Carolina/SC,4501201,"Dorchester (North & West) & Berkeley (Southwest) Counties--Summerville Town & Ladson PUMA, South Carolina/SC",261,0,4,0,0,0,261,0,4,0,4,4,265,98,0,0,2,0,0,0,2,98,2,0,2
45,South Carolina/SC,4501202,"Charleston (South & West) & Berkeley (South) Counties--Charleston City PUMA, South Carolina/SC",134,0,48,0,0,8,134,0,56,8,48,56,190,71,0,4,25,0,0,4,25,71,29,0,29
45,South Carolina/SC,4501203,"Charleston (Northeast) & Berkeley (North & East) Counties--Mount Pleasant Town PUMA, South Carolina/SC",106,0,36,0,0,0,106,0,36,0,36,36,142,75,0,0,25,0,0,0,25,75,25,0,25
45,South Carolina/SC,4501204,"Charleston, Berkeley & Dorchester Counties--North Charleston City PUMA, South Carolina/SC",195,0,27,0,0,0,195,0,27,0,27,27,222,88,0,0,12,0,0,0,12,88,12,0,12
45,South Carolina/SC,4501300,"Orangeburg, Colleton, Barnwell, Hampton, Bamberg & Allendale Counties PUMA, South Carolina/SC",1020,0,127,20,37,0,1040,37,127,37,127,164,1204,85,2,3,11,3,0,0,11,86,14,3,11
45,South Carolina/SC,4501400,"Beaufort & Jasper Counties--Hilton Head Island, Bluffton Towns & Beaufort City PUMA, South Carolina/SC",307,137,251,0,12,0,307,149,251,12,388,400,707,43,0,2,55,2,19,0,36,43,57,21,36
45,South Carolina/SC,4501500,"Aiken & Edgefield Counties--Aiken & North Augusta Cities PUMA, South Carolina/SC",750,107,378,18,29,69,768,136,447,98,485,583,1351,56,1,7,36,2,8,5,28,57,43,10,33
45,South Carolina/SC,4501600,"Greenwood, Abbeville & McCormick Counties PUMA, South Carolina/SC",545,0,124,0,2,0,545,2,124,2,124,126,671,81,0,0,18,0,0,0,18,81,19,0,18
46,South Dakota/SD,4600100,"West South Dakota--Rapid City PUMA, South Dakota/SD",1119,0,21,102,0,0,1221,0,21,0,21,21,1242,90,8,0,2,0,0,0,2,98,2,0,2
46,South Dakota/SD,4600200,"Lakota Region PUMA, South Dakota/SD",1995,0,0,44,0,0,2039,0,0,0,0,0,2039,98,2,0,0,0,0,0,0,100,0,0,0
46,South Dakota/SD,4600300,"Northeast South Dakota PUMA, South Dakota/SD",2162,12,192,199,32,262,2361,44,454,294,204,498,2859,76,7,10,7,1,0,9,7,83,17,2,16
46,South Dakota/SD,4600400,"Jackrabbit Region PUMA, South Dakota/SD",2303,0,408,98,141,455,2401,141,863,596,408,1004,3405,68,3,18,12,4,0,13,12,71,29,4,25
46,South Dakota/SD,4600500,"Southeast South Dakota (Outside Sioux Falls City) PUMA, South Dakota/SD",1080,68,230,23,0,25,1103,68,255,25,298,323,1426,76,2,2,21,0,5,2,16,77,23,5,18
46,South Dakota/SD,4600600,"Sioux Falls City PUMA, South Dakota/SD",914,221,291,17,1170,1232,931,1391,1523,2402,512,2914,3845,24,0,62,13,30,6,32,8,24,76,36,40
47,Tennessee/TN,4700100,"Northwest Tennessee--Gibson, Dyer, Obion, Crockett & Lake Counties PUMA, Tennessee/TN",1822,95,118,50,0,0,1872,95,118,0,213,213,2085,87,2,0,10,0,5,0,6,90,10,5,6
47,Tennessee/TN,4700200,"Land Between the Lakes--Weakley, Henry, Carroll, Humphreys, Benton & Houston Counties PUMA, Tennessee/TN",766,0,23,29,7,0,795,7,23,7,23,30,825,93,4,1,3,1,0,0,3,96,4,1,3
47,Tennessee/TN,4700300,"Montgomery & Stewart Counties--Clarksville City PUMA, Tennessee/TN",289,0,5,0,0,0,289,0,5,0,5,5,294,98,0,0,2,0,0,0,2,98,2,0,2
47,Tennessee/TN,4700400,"Robertson, Dickson, Cheatham & Hickman Counties PUMA, Tennessee/TN",692,0,125,0,0,0,692,0,125,0,125,125,817,85,0,0,15,0,0,0,15,85,15,0,15
47,Tennessee/TN,4700500,"Sumner County--Hendersonville City PUMA, Tennessee/TN",293,13,14,33,17,0,326,30,14,17,27,44,370,79,9,5,7,5,4,0,4,88,12,8,4
47,Tennessee/TN,4700600,"Warren, Macon, Smith, DeKalb, Cannon & Trousdale Counties PUMA, Tennessee/TN",756,44,354,0,0,114,756,44,468,114,398,512,1268,60,0,9,31,0,3,9,28,60,40,3,37
47,Tennessee/TN,4700700,"Putnam, Overton, Jackson, Clay & Pickett Counties PUMA, Tennessee/TN",454,7,112,0,0,0,454,7,112,0,119,119,573,79,0,0,21,0,1,0,20,79,21,1,20
47,Tennessee/TN,4700800,"Cumberland, White, Fentress & Van Buren Counties PUMA, Tennessee/TN",1073,0,0,104,0,0,1177,0,0,0,0,0,1177,91,9,0,0,0,0,0,0,100,0,0,0
47,Tennessee/TN,4700900,"Campbell, Claiborne, Scott, Morgan & Hancock Counties PUMA, Tennessee/TN",536,12,16,0,0,0,536,12,16,0,28,28,564,95,0,0,5,0,2,0,3,95,5,2,3
47,Tennessee/TN,4701000,"Hawkins & Sullivan (Northwest) Counties--Kingsport City PUMA, Tennessee/TN",239,0,0,0,0,0,239,0,0,0,0,0,239,100,0,0,0,0,0,0,0,100,0,0,0
47,Tennessee/TN,4701100,"Sullivan County (Southeast)--Bristol City PUMA, Tennessee/TN",142,0,25,0,0,0,142,0,25,0,25,25,167,85,0,0,15,0,0,0,15,85,15,0,15
47,Tennessee/TN,4701200,"Greene, Carter, Unicoi & Johnson Counties PUMA, Tennessee/TN",391,23,118,0,0,0,391,23,118,0,141,141,532,73,0,0,27,0,4,0,22,73,27,4,22
47,Tennessee/TN,4701300,"Washington County--Johnson City PUMA, Tennessee/TN",103,0,135,22,17,0,125,17,135,17,135,152,277,37,8,6,49,6,0,0,49,45,55,6,49
47,Tennessee/TN,4701400,"Hamblen, Cocke & Grainger Counties PUMA, Tennessee/TN",785,55,142,110,0,0,895,55,142,0,197,197,1092,72,10,0,18,0,5,0,13,82,18,5,13
47,Tennessee/TN,4701500,"Sevier & Jefferson Counties PUMA, Tennessee/TN",574,0,59,41,0,0,615,0,59,0,59,59,674,85,6,0,9,0,0,0,9,91,9,0,9
47,Tennessee/TN,4701601,"Anderson, Union & Knox (North) Counties--Oak Ridge (East) & Clinton Cities PUMA, Tennessee/TN",107,0,0,0,0,0,107,0,0,0,0,0,107,100,0,0,0,0,0,0,0,100,0,0,0
47,Tennessee/TN,4701602,"Knox County (East) PUMA, Tennessee/TN",213,120,4,0,7,0,213,127,4,7,124,131,344,62,0,2,36,2,35,0,1,62,38,37,1
47,Tennessee/TN,4701603,"Knoxville City PUMA, Tennessee/TN",279,0,0,0,0,65,279,0,65,65,0,65,344,81,0,19,0,0,0,19,0,81,19,0,19
47,Tennessee/TN,4701604,"Knox County (West)--Farragut Town PUMA, Tennessee/TN",133,14,1,0,0,0,133,14,1,0,15,15,148,90,0,0,10,0,9,0,1,90,10,9,1
47,Tennessee/TN,4701700,"Blount County PUMA, Tennessee/TN",196,0,0,0,14,0,196,14,0,14,0,14,210,93,0,7,0,7,0,0,0,93,7,7,0
47,Tennessee/TN,4701800,"Roane, Loudon & Monroe Counties--Oak Ridge City (West) PUMA, Tennessee/TN",399,86,142,14,0,0,413,86,142,0,228,228,641,62,2,0,36,0,13,0,22,64,36,13,22
47,Tennessee/TN,4701900,"Bradley, McMinn & Polk Counties--Cleveland City PUMA, Tennessee/TN",1196,12,71,16,0,6,1212,12,77,6,83,89,1301,92,1,0,6,0,1,0,5,93,7,1,6
47,Tennessee/TN,4702001,"Chattanooga City (South & Central) PUMA, Tennessee/TN",543,0,161,50,22,0,593,22,161,22,161,183,776,70,6,3,21,3,0,0,21,76,24,3,21
47,Tennessee/TN,4702002,"Hamilton County (South)--Chattanooga (North) & Red Bank Cities PUMA, Tennessee/TN",392,0,7,23,27,0,415,27,7,27,7,34,449,87,5,6,2,6,0,0,2,92,8,6,2
47,Tennessee/TN,4702003,"Hamilton County (North)--Soddy-Daisy City PUMA, Tennessee/TN",497,0,0,0,0,11,497,0,11,11,0,11,508,98,0,2,0,0,0,2,0,98,2,0,2
47,Tennessee/TN,4702100,"Rhea, Marion, Sequatchie, Grundy, Bledsoe & Meigs Counties PUMA, Tennessee/TN",514,28,328,0,0,97,514,28,425,97,356,453,967,53,0,10,37,0,3,10,34,53,47,3,44
47,Tennessee/TN,4702200,"Coffee, Franklin, Lincoln & Moore Counties PUMA, Tennessee/TN",850,0,88,61,0,0,911,0,88,0,88,88,999,85,6,0,9,0,0,0,9,91,9,0,9
47,Tennessee/TN,4702300,"Wilson County--Lebanon & Mount Juliet Cities PUMA, Tennessee/TN",133,0,0,8,0,0,141,0,0,0,0,0,141,94,6,0,0,0,0,0,0,100,0,0,0
47,Tennessee/TN,4702401,"Rutherford County (North)--Smyrna Town & La Vergne City PUMA, Tennessee/TN",246,58,0,0,24,153,246,82,153,177,58,235,481,51,0,37,12,5,12,32,0,51,49,17,32
47,Tennessee/TN,4702402,"Rutherford County (South)--Murfreesboro City PUMA, Tennessee/TN",811,0,23,0,0,0,811,0,23,0,23,23,834,97,0,0,3,0,0,0,3,97,3,0,3
47,Tennessee/TN,4702501,"Nashville-Davidson (East) PUMA, Tennessee/TN",114,27,143,0,76,350,114,103,493,426,170,596,710,16,0,60,24,11,4,49,20,16,84,15,69
47,Tennessee/TN,4702502,"Nashville-Davidson (North) PUMA, Tennessee/TN",523,0,84,34,0,68,557,0,152,68,84,152,709,74,5,10,12,0,0,10,12,79,21,0,21
47,Tennessee/TN,4702503,"Nashville-Davidson (Central) PUMA, Tennessee/TN",152,0,120,9,66,246,161,66,366,312,120,432,593,26,2,53,20,11,0,41,20,27,73,11,62
47,Tennessee/TN,4702504,"Nashville-Davidson (Southeast) PUMA, Tennessee/TN",185,0,36,0,102,547,185,102,583,649,36,685,870,21,0,75,4,12,0,63,4,21,79,12,67
47,Tennessee/TN,4702505,"Nashville-Davidson (Southwest) PUMA, Tennessee/TN",111,0,20,0,18,0,111,18,20,18,20,38,149,74,0,12,13,12,0,0,13,74,26,12,13
47,Tennessee/TN,4702600,"Williamson County--Franklin & Brentwood Cities PUMA, Tennessee/TN",155,0,0,9,0,0,164,0,0,0,0,0,164,95,5,0,0,0,0,0,0,100,0,0,0
47,Tennessee/TN,4702700,"Maury, Bedford & Marshall Counties PUMA, Tennessee/TN",991,12,76,118,18,71,1109,30,147,89,88,177,1286,77,9,7,7,1,1,6,6,86,14,2,11
47,Tennessee/TN,4702800,"Lawrence, Giles, Wayne, Lewis & Perry Counties PUMA, Tennessee/TN",501,0,80,0,0,0,501,0,80,0,80,80,581,86,0,0,14,0,0,0,14,86,14,0,14
47,Tennessee/TN,4702900,"Henderson, Hardeman, McNairy, Hardin, Haywood & Decatur Counties PUMA, Tennessee/TN",654,0,30,16,0,0,670,0,30,0,30,30,700,93,2,0,4,0,0,0,4,96,4,0,4
47,Tennessee/TN,4703000,"Madison & Chester Counties--Jackson City PUMA, Tennessee/TN",563,0,33,0,0,0,563,0,33,0,33,33,596,94,0,0,6,0,0,0,6,94,6,0,6
47,Tennessee/TN,4703100,"Tipton, Fayette & Lauderdale Counties PUMA, Tennessee/TN",948,29,145,51,0,0,999,29,145,0,174,174,1173,81,4,0,15,0,2,0,12,85,15,2,12
47,Tennessee/TN,4703201,"Memphis City (Central Riverside) PUMA, Tennessee/TN",277,0,26,0,0,30,277,0,56,30,26,56,333,83,0,9,8,0,0,9,8,83,17,0,17
47,Tennessee/TN,4703202,"Memphis City (Central Midtown) PUMA, Tennessee/TN",54,14,84,32,0,0,86,14,84,0,98,98,184,29,17,0,53,0,8,0,46,47,53,8,46
47,Tennessee/TN,4703203,"Memphis (North) & Bartlett (Southwest) Cities PUMA, Tennessee/TN",145,0,176,0,0,0,145,0,176,0,176,176,321,45,0,0,55,0,0,0,55,45,55,0,55
47,Tennessee/TN,4703204,"Shelby County (North)--Bartlett (North & East) & Millington Cities PUMA, Tennessee/TN",141,0,71,0,0,0,141,0,71,0,71,71,212,67,0,0,33,0,0,0,33,67,33,0,33
47,Tennessee/TN,4703205,"Memphis (East), Lakeland Cities & Arlington Town (South) PUMA, Tennessee/TN",75,0,0,26,0,0,101,0,0,0,0,0,101,74,26,0,0,0,0,0,0,100,0,0,0
47,Tennessee/TN,4703206,"Shelby County (Southeast)--Collierville Town & Germantown City PUMA, Tennessee/TN",129,0,0,0,0,0,129,0,0,0,0,0,129,100,0,0,0,0,0,0,0,100,0,0,0
47,Tennessee/TN,4703207,"Memphis City (Southeast) PUMA, Tennessee/TN",148,37,11,0,8,0,148,45,11,8,48,56,204,73,0,4,24,4,18,0,5,73,27,22,5
47,Tennessee/TN,4703208,"Memphis City (Southwest) PUMA, Tennessee/TN",210,0,0,0,0,0,210,0,0,0,0,0,210,100,0,0,0,0,0,0,0,100,0,0,0
48,Texas/TX,4800100,"Panhandle Regional Planning Commission (Outside Potter & Randall Counties) PUMA, Texas/TX",1920,685,3134,1897,47,175,3817,732,3309,222,3819,4041,7858,24,24,3,49,1,9,2,40,49,51,9,42
48,Texas/TX,4800200,"Panhandle Regional Planning Commission--Potter County--Amarillo City (North) PUMA, Texas/TX",387,159,442,664,431,1448,1051,590,1890,1879,601,2480,3531,11,19,53,17,12,5,41,13,30,70,17,54
48,Texas/TX,4800300,"Panhandle Regional Planning Commission--Randall County--Amarillo City (South) PUMA, Texas/TX",260,0,26,301,73,63,561,73,89,136,26,162,723,36,42,19,4,10,0,9,4,78,22,10,12
48,Texas/TX,4800400,"South Plains Association of Governments (Outside Lubbock County) PUMA, Texas/TX",778,338,1494,1389,36,175,2167,374,1669,211,1832,2043,4210,18,33,5,44,1,8,4,35,51,49,9,40
48,Texas/TX,4800501,"South Plains Association of Governments--Lubbock County--Lubbock City (Central) PUMA, Texas/TX",147,0,61,274,31,0,421,31,61,31,61,92,513,29,53,6,12,6,0,0,12,82,18,6,12
48,Texas/TX,4800502,"South Plains Association of Governments--Lubbock County--Lubbock City (Outer) PUMA, Texas/TX",388,0,70,102,0,29,490,0,99,29,70,99,589,66,17,5,12,0,0,5,12,83,17,0,17
48,Texas/TX,4800600,"North Texas Regional Planning Commission (Outside Wichita County) & Wise County PUMA, Texas/TX",685,107,259,199,0,55,884,107,314,55,366,421,1305,52,15,4,28,0,8,4,20,68,32,8,24
48,Texas/TX,4800700,"North Texas Regional Planning Commission--Wichita County--Wichita Falls City PUMA, Texas/TX",98,35,0,62,0,14,160,35,14,14,35,49,209,47,30,7,17,0,17,7,0,77,23,17,7
48,Texas/TX,4800800,"Texoma COG--Grayson, Cooke & Fannin Counties PUMA, Texas/TX",1121,68,240,221,72,244,1342,140,484,316,308,624,1966,57,11,16,16,4,3,12,12,68,32,7,25
48,Texas/TX,4800900,"Hunt & Rockwall Counties--Rockwall, Greenville & Dallas (Far Northeast) Cities PUMA, Texas/TX",257,18,157,53,0,0,310,18,157,0,175,175,485,53,11,0,36,0,4,0,32,64,36,4,32
48,Texas/TX,4801000,"Ark-Tex COG (West) PUMA, Texas/TX",1864,176,958,277,14,6,2141,190,964,20,1134,1154,3295,57,8,1,34,0,5,0,29,65,35,6,29
48,Texas/TX,4801100,"Ark-Tex COG (East)--Bowie & Cass Counties PUMA, Texas/TX",281,0,3,0,4,0,281,4,3,4,3,7,288,98,0,1,1,1,0,0,1,98,2,1,1
48,Texas/TX,4801200,"East Texas COG (Northeast)--Harrison, Upshur & Marion Counties PUMA, Texas/TX",185,0,219,24,0,0,209,0,219,0,219,219,428,43,6,0,51,0,0,0,51,49,51,0,51
48,Texas/TX,4801300,"East Texas COG (Northwest)--Van Zandt, Wood, Camp & Rains Counties PUMA, Texas/TX",462,94,202,56,21,0,518,115,202,21,296,317,835,55,7,3,35,3,11,0,24,62,38,14,24
48,Texas/TX,4801400,"Kaufman County PUMA, Texas/TX",237,57,24,0,0,0,237,57,24,0,81,81,318,75,0,0,25,0,18,0,8,75,25,18,8
48,Texas/TX,4801501,"East Texas COG (Central)--Smith County (Outside Tyler City) PUMA, Texas/TX",73,0,61,67,0,0,140,0,61,0,61,61,201,36,33,0,30,0,0,0,30,70,30,0,30
48,Texas/TX,4801502,"East Texas COG (Central)--Smith County (West)--Tyler City PUMA, Texas/TX",288,33,60,44,0,0,332,33,60,0,93,93,425,68,10,0,22,0,8,0,14,78,22,8,14
48,Texas/TX,4801600,"East Texas COG (Central)--Gregg County--Longview City PUMA, Texas/TX",152,0,43,15,0,0,167,0,43,0,43,43,210,72,7,0,20,0,0,0,20,80,20,0,20
48,Texas/TX,4801700,"East Texas COG (Southeast)--Rusk, Cherokee & Panola Counties PUMA, Texas/TX",408,13,599,35,0,0,443,13,599,0,612,612,1055,39,3,0,58,0,1,0,57,42,58,1,57
48,Texas/TX,4801800,"East Texas COG (Southwest)--Henderson & Anderson Counties PUMA, Texas/TX",492,40,171,180,0,0,672,40,171,0,211,211,883,56,20,0,24,0,5,0,19,76,24,5,19
48,Texas/TX,4801901,"Collin County (Southwest)--Dallas (North), Plano (South) & Richardson (North) Cities PUMA, Texas/TX",62,30,0,0,0,0,62,30,0,0,30,30,92,67,0,0,33,0,33,0,0,67,33,33,0
48,Texas/TX,4801902,"Collin County (Southwest)--Plano City (West) PUMA, Texas/TX",0,0,17,67,24,0,67,24,17,24,17,41,108,0,62,22,16,22,0,0,16,62,38,22,16
48,Texas/TX,4801903,"Collin County (Southwest)--Plano City (Central) PUMA, Texas/TX",0,0,0,21,0,0,21,0,0,0,0,0,21,0,100,0,0,0,0,0,0,100,0,0,0
48,Texas/TX,4801904,"Collin County (South Central)--Allen, Murphy, Plano (East) & Parker Cities PUMA, Texas/TX",40,0,0,0,159,45,40,159,45,204,0,204,244,16,0,84,0,65,0,18,0,16,84,65,18
48,Texas/TX,4801905,"Collin County (Central)--McKinney City PUMA, Texas/TX",26,0,0,25,0,0,51,0,0,0,0,0,51,51,49,0,0,0,0,0,0,100,0,0,0
48,Texas/TX,4801906,"Collin County (Northwest)--Frisco City (East) & Prosper Town PUMA, Texas/TX",59,0,72,0,23,0,59,23,72,23,72,95,154,38,0,15,47,15,0,0,47,38,62,15,47
48,Texas/TX,4801907,"Collin County (East) PUMA, Texas/TX",136,0,41,57,0,0,193,0,41,0,41,41,234,58,24,0,18,0,0,0,18,82,18,0,18
48,Texas/TX,4802001,"Denton County (Far Southeast)--Carrollton (North) & Dallas (North) Cities PUMA, Texas/TX",12,59,21,12,0,10,24,59,31,10,80,90,114,11,11,9,70,0,52,9,18,21,79,52,27
48,Texas/TX,4802002,"Denton County (Southeast)--Lewisville City PUMA, Texas/TX",52,96,89,51,32,35,103,128,124,67,185,252,355,15,14,19,52,9,27,10,25,29,71,36,35
48,Texas/TX,4802003,"Denton County (South Central)--Flower Mound Town & Highland Village City PUMA, Texas/TX",119,0,0,0,0,0,119,0,0,0,0,0,119,100,0,0,0,0,0,0,0,100,0,0,0
48,Texas/TX,4802004,"Denton County (East Central)--Frisco (West), The Colony & Little Elm Cities PUMA, Texas/TX",10,0,0,24,0,0,34,0,0,0,0,0,34,29,71,0,0,0,0,0,0,100,0,0,0
48,Texas/TX,4802005,"Denton County (Central)--Denton (Central) & Corinth Cities PUMA, Texas/TX",154,89,92,64,8,8,218,97,100,16,181,197,415,37,15,4,44,2,21,2,22,53,47,23,24
48,Texas/TX,4802006,"Denton County (North & West)--Denton City (Outer) PUMA, Texas/TX",155,0,0,24,25,0,179,25,0,25,0,25,204,76,12,12,0,12,0,0,0,88,12,12,0
48,Texas/TX,4802101,"Ellis County PUMA, Texas/TX",228,13,43,86,0,100,314,13,143,100,56,156,470,49,18,21,12,0,3,21,9,67,33,3,30
48,Texas/TX,4802102,"Johnson County PUMA, Texas/TX",326,0,6,158,0,142,484,0,148,142,6,148,632,52,25,22,1,0,0,22,1,77,23,0,23
48,Texas/TX,4802200,"North Central Texas COG (West)--Hood, Erath, Palo Pinto & Somervell Counties PUMA, Texas/TX",878,24,257,191,21,0,1069,45,257,21,281,302,1371,64,14,2,20,2,2,0,19,78,22,3,19
48,Texas/TX,4802301,"Dallas County (Northeast)--Rowlett & Garland (Northeast) Cities PUMA, Texas/TX",34,0,27,0,27,0,34,27,27,27,27,54,88,39,0,31,31,31,0,0,31,39,61,31,31
48,Texas/TX,4802302,"Dallas County (Northeast)--Garland City (South) PUMA, Texas/TX",33,0,194,13,0,36,46,0,230,36,194,230,276,12,5,13,70,0,0,13,70,17,83,0,83
48,Texas/TX,4802303,"Dallas County (East)--Mesquite City (Central & Southeast) PUMA, Texas/TX",54,32,16,14,0,0,68,32,16,0,48,48,116,47,12,0,41,0,28,0,14,59,41,28,14
48,Texas/TX,4802304,"Dallas County (Southeast)--Dallas City (Southeast) PUMA, Texas/TX",90,37,22,41,0,0,131,37,22,0,59,59,190,47,22,0,31,0,19,0,12,69,31,19,12
48,Texas/TX,4802305,"Dallas (East) & Mesquite (West) Cities--South of I-30 & West of I-635 PUMA, Texas/TX",130,89,90,154,0,0,284,89,90,0,179,179,463,28,33,0,39,0,19,0,19,61,39,19,19
48,Texas/TX,4802306,"Dallas (Northeast) & Mesquite (North) Cities--North of I-30 & West of I-635 PUMA, Texas/TX",24,133,198,19,37,20,43,170,218,57,331,388,431,6,4,13,77,9,31,5,46,10,90,39,51
48,Texas/TX,4802307,"Dallas City (Northeast)--East of US-75 PUMA, Texas/TX",13,13,218,79,56,298,92,69,516,354,231,585,677,2,12,52,34,8,2,44,32,14,86,10,76
48,Texas/TX,4802308,"Dallas County (Northeast)--Garland (Northwest) & Richardson (East) Cities PUMA, Texas/TX",8,0,18,0,0,206,8,0,224,206,18,224,232,3,0,89,8,0,0,89,8,3,97,0,97
48,Texas/TX,4802309,"Dallas (Far North) & Richardson (Southwest) Cities PUMA, Texas/TX",53,30,49,0,60,24,53,90,73,84,79,163,216,25,0,39,37,28,14,11,23,25,75,42,34
48,Texas/TX,4802310,"Dallas (Far North), Carrollton (Southeast) Cities & Addison Town--North of I-635 PUMA, Texas/TX",104,18,170,25,0,62,129,18,232,62,188,250,379,27,7,16,50,0,5,16,45,34,66,5,61
48,Texas/TX,4802311,"Dallas City (North)--South of I-635 & West of US-75 PUMA, Texas/TX",68,0,216,19,0,0,87,0,216,0,216,216,303,22,6,0,71,0,0,0,71,29,71,0,71
48,Texas/TX,4802312,"Dallas (West Central), University Park Cities & Highland Park Town PUMA, Texas/TX",87,0,297,0,0,0,87,0,297,0,297,297,384,23,0,0,77,0,0,0,77,23,77,0,77
48,Texas/TX,4802313,"Dallas City (Downtown)--North of I-30 PUMA, Texas/TX",13,0,304,0,0,0,13,0,304,0,304,304,317,4,0,0,96,0,0,0,96,4,96,0,96
48,Texas/TX,4802314,"Dallas City (East Central)--South of I-30 & East of I-35E PUMA, Texas/TX",151,35,256,88,0,0,239,35,256,0,291,291,530,28,17,0,55,0,7,0,48,45,55,7,48
48,Texas/TX,4802315,"Dallas City (West Central)--East of Loop TX-12 & West of I-35E PUMA, Texas/TX",50,62,286,78,0,0,128,62,286,0,348,348,476,11,16,0,73,0,13,0,60,27,73,13,60
48,Texas/TX,4802316,"Dallas City (South Central)--North of I-20 & West of I-35E PUMA, Texas/TX",74,17,293,89,0,0,163,17,293,0,310,310,473,16,19,0,66,0,4,0,62,34,66,4,62
48,Texas/TX,4802317,"Dallas County (South)--DeSoto & Lancaster Cities PUMA, Texas/TX",131,25,83,121,0,0,252,25,83,0,108,108,360,36,34,0,30,0,7,0,23,70,30,7,23
48,Texas/TX,4802318,"Dallas County (Southwest)--Cedar Hill & Duncanville Cities PUMA, Texas/TX",118,37,78,65,34,0,183,71,78,34,115,149,332,36,20,10,35,10,11,0,23,55,45,21,23
48,Texas/TX,4802319,"Dallas County (West)--Grand Prairie (Central) & Dallas (Southwest) Cities PUMA, Texas/TX",84,42,36,126,0,0,210,42,36,0,78,78,288,29,44,0,27,0,15,0,12,73,27,15,12
48,Texas/TX,4802320,"Dallas County (West)--Irving (South) & Grand Prairie (North) Cities PUMA, Texas/TX",19,39,185,144,0,0,163,39,185,0,224,224,387,5,37,0,58,0,10,0,48,42,58,10,48
48,Texas/TX,4802321,"Dallas County (Northwest)--Irving (Central) & Dallas (Northwest) Cities PUMA, Texas/TX",27,55,173,23,0,12,50,55,185,12,228,240,290,9,8,4,79,0,19,4,60,17,83,19,64
48,Texas/TX,4802322,"Dallas County (Northwest)--Irving (North), Coppell & Carrollton (Southwest) Cities PUMA, Texas/TX",26,38,0,39,18,12,65,56,12,30,38,68,133,20,29,23,29,14,29,9,0,49,51,42,9
48,Texas/TX,4802400,"Parker County PUMA, Texas/TX",458,27,125,22,0,0,480,27,125,0,152,152,632,72,3,0,24,0,4,0,20,76,24,4,20
48,Texas/TX,4802501,"Tarrant County (Northeast)--Grapevine, Southlake & Colleyville Cities PUMA, Texas/TX",33,0,0,30,0,0,63,0,0,0,0,0,63,52,48,0,0,0,0,0,0,100,0,0,0
48,Texas/TX,4802502,"Tarrant County (East)--Euless (South & West) & Arlington (North) Cities PUMA, Texas/TX",79,0,0,0,0,0,79,0,0,0,0,0,79,100,0,0,0,0,0,0,0,100,0,0,0
48,Texas/TX,4802503,"Tarrant County (East)--Arlington (East) & Grand Prairie (West Central) Cities PUMA, Texas/TX",125,45,88,92,111,0,217,156,88,111,133,244,461,27,20,24,29,24,10,0,19,47,53,34,19
48,Texas/TX,4802504,"Tarrant County (Southeast)--Arlington (Southeast) & Grand Prairie (Southwest) Cities PUMA, Texas/TX",27,13,68,0,36,0,27,49,68,36,81,117,144,19,0,25,56,25,9,0,47,19,81,34,47
48,Texas/TX,4802505,"Tarrant County (Southeast)--Mansfield (North) & Arlington (Southwest) Cities PUMA, Texas/TX",72,0,37,0,0,0,72,0,37,0,37,37,109,66,0,0,34,0,0,0,34,66,34,0,34
48,Texas/TX,4802506,"Tarrant County (South Central)--Fort Worth City (Southeast)--South of I-20 PUMA, Texas/TX",207,46,178,62,19,0,269,65,178,19,224,243,512,40,12,4,44,4,9,0,35,53,47,13,35
48,Texas/TX,4802507,"Tarrant County (East)--Arlington City (West)--South of I-30 & East of Loop I-820 PUMA, Texas/TX",114,9,0,0,0,0,114,9,0,0,9,9,123,93,0,0,7,0,7,0,0,93,7,7,0
48,Texas/TX,4802508,"Fort Worth City (East Central)--South of I-30, East of I-35W & Inside Loop I-820 PUMA, Texas/TX",71,63,291,45,0,68,116,63,359,68,354,422,538,13,8,13,66,0,12,13,54,22,78,12,67
48,Texas/TX,4802509,"Fort Worth (Northeast) & Hurst (South) Cities--North of I-30 PUMA, Texas/TX",59,191,89,42,0,136,101,191,225,136,280,416,517,11,8,26,54,0,37,26,17,20,80,37,44
48,Texas/TX,4802510,"Tarrant County (North)--North Richland Hills (North) & Keller Cities PUMA, Texas/TX",24,0,64,45,0,0,69,0,64,0,64,64,133,18,34,0,48,0,0,0,48,52,48,0,48
48,Texas/TX,4802511,"Fort Worth City (North)--East of I-35W & West of US-377 PUMA, Texas/TX",167,35,0,30,34,0,197,69,0,34,35,69,266,63,11,13,13,13,13,0,0,74,26,26,0
48,Texas/TX,4802512,"Fort Worth City (North Central) & Haltom City (North)--Inside Loop I-820 PUMA, Texas/TX",77,289,583,292,19,0,369,308,583,19,872,891,1260,6,23,2,69,2,23,0,46,29,71,24,46
48,Texas/TX,4802513,"Fort Worth City (South Central) & Edgecliff Village Town PUMA, Texas/TX",95,78,80,32,18,61,127,96,141,79,158,237,364,26,9,22,43,5,21,17,22,35,65,26,39
48,Texas/TX,4802514,"Tarrant County (Southwest)--Fort Worth (Southwest) & Benbrook Cities PUMA, Texas/TX",47,0,45,11,0,92,58,0,137,92,45,137,195,24,6,47,23,0,0,47,23,30,70,0,70
48,Texas/TX,4802515,"Tarrant County (West)--Fort Worth City (West) PUMA, Texas/TX",118,70,74,100,0,0,218,70,74,0,144,144,362,33,28,0,40,0,19,0,20,60,40,19,20
48,Texas/TX,4802516,"Tarrant County (Northwest)--Fort Worth (Northwest) & Saginaw Cities PUMA, Texas/TX",94,0,101,0,0,0,94,0,101,0,101,101,195,48,0,0,52,0,0,0,52,48,52,0,52
48,Texas/TX,4802600,"West Central Texas COG (Outside Taylor County) PUMA, Texas/TX",1103,133,468,269,14,30,1372,147,498,44,601,645,2017,55,13,2,30,1,7,1,23,68,32,7,25
48,Texas/TX,4802700,"West Central Texas COG--Taylor County--Abilene City PUMA, Texas/TX",281,11,0,44,44,81,325,55,81,125,11,136,461,61,10,27,2,10,2,18,0,70,30,12,18
48,Texas/TX,4802800,"Concho Valley COG & Permian Basin Regional Planning Commission (East) PUMA, Texas/TX",432,109,314,432,5,56,864,114,370,61,423,484,1348,32,32,5,31,0,8,4,23,64,36,8,27
48,Texas/TX,4802900,"Concho Valley COG--Tom Green County--San Angelo City PUMA, Texas/TX",195,19,379,298,0,0,493,19,379,0,398,398,891,22,33,0,45,0,2,0,43,55,45,2,43
48,Texas/TX,4803000,"Permian Basin Regional Planning Commission (Central)--Midland County--Midland City PUMA, Texas/TX",42,0,72,36,0,0,78,0,72,0,72,72,150,28,24,0,48,0,0,0,48,52,48,0,48
48,Texas/TX,4803100,"Permian Basin Regional Planning Commission (Central)--Ector County--Odessa City PUMA, Texas/TX",18,8,0,13,0,0,31,8,0,0,8,8,39,46,33,0,21,0,21,0,0,79,21,21,0
48,Texas/TX,4803200,"Rio Grande COG & Permian Basin Regional Planning Commission (West) PUMA, Texas/TX",242,107,298,591,73,49,833,180,347,122,405,527,1360,18,43,9,30,5,8,4,22,61,39,13,26
48,Texas/TX,4803301,"El Paso County (Outside El Paso City)--Socorro & Horizon Cities PUMA, Texas/TX",14,25,332,197,0,0,211,25,332,0,357,357,568,2,35,0,63,0,4,0,58,37,63,4,58
48,Texas/TX,4803302,"El Paso City (East) PUMA, Texas/TX",0,44,156,105,0,0,105,44,156,0,200,200,305,0,34,0,66,0,14,0,51,34,66,14,51
48,Texas/TX,4803303,"El Paso City (Southeast) PUMA, Texas/TX",0,127,54,39,0,0,39,127,54,0,181,181,220,0,18,0,82,0,58,0,25,18,82,58,25
48,Texas/TX,4803304,"El Paso City (Central) PUMA, Texas/TX",0,27,85,12,0,0,12,27,85,0,112,112,124,0,10,0,90,0,22,0,69,10,90,22,69
48,Texas/TX,4803305,"El Paso City (North) PUMA, Texas/TX",0,143,270,102,0,0,102,143,270,0,413,413,515,0,20,0,80,0,28,0,52,20,80,28,52
48,Texas/TX,4803306,"El Paso City (Northwest) PUMA, Texas/TX",21,20,175,76,0,0,97,20,175,0,195,195,292,7,26,0,67,0,7,0,60,33,67,7,60
48,Texas/TX,4803400,"Central Texas COG (West), Burnet & Llano Counties PUMA, Texas/TX",567,20,322,238,11,122,805,31,444,133,342,475,1280,44,19,10,27,1,2,10,25,63,37,2,35
48,Texas/TX,4803501,"Central Texas COG--Bell County (West)--Killeen & Harker Heights Cities PUMA, Texas/TX",99,0,4,21,0,29,120,0,33,29,4,33,153,65,14,19,3,0,0,19,3,78,22,0,22
48,Texas/TX,4803502,"Central Texas COG--Bell County (North, East & South)--Temple & Belton Cities PUMA, Texas/TX",183,0,4,97,0,0,280,0,4,0,4,4,284,64,34,0,1,0,0,0,1,99,1,0,1
48,Texas/TX,4803601,"Brazos Valley COG (Outside Brazos County) & Milam County PUMA, Texas/TX",1324,190,697,307,39,0,1631,229,697,39,887,926,2557,52,12,2,35,2,7,0,27,64,36,9,27
48,Texas/TX,4803602,"Brazos Valley COG--Brazos County--College Station & Bryan Cities PUMA, Texas/TX",762,454,385,283,0,0,1045,454,385,0,839,839,1884,40,15,0,45,0,24,0,20,55,45,24,20
48,Texas/TX,4803700,"Heart of Texas COG (Outside McLennan County) & Navarro County PUMA, Texas/TX",963,209,603,299,39,66,1262,248,669,105,812,917,2179,44,14,5,37,2,10,3,28,58,42,11,31
48,Texas/TX,4803801,"Heart of Texas COG--McLennan County--Waco City (Central) PUMA, Texas/TX",560,101,410,260,0,0,820,101,410,0,511,511,1331,42,20,0,38,0,8,0,31,62,38,8,31
48,Texas/TX,4803802,"Heart of Texas COG--McLennan County--Waco (Outer), Hewitt & Robinson Cities PUMA, Texas/TX",704,103,73,192,0,0,896,103,73,0,176,176,1072,66,18,0,16,0,10,0,7,84,16,10,7
48,Texas/TX,4803900,"Deep East Texas COG (West) & Walker County PUMA, Texas/TX",335,40,44,76,0,0,411,40,44,0,84,84,495,68,15,0,17,0,8,0,9,83,17,8,9
48,Texas/TX,4804000,"Deep East Texas COG (Central)--Angelina & Nacogdoches Counties PUMA, Texas/TX",926,113,483,344,16,65,1270,129,548,81,596,677,1947,48,18,4,31,1,6,3,25,65,35,7,28
48,Texas/TX,4804100,"Deep East Texas COG (East) PUMA, Texas/TX",570,101,288,83,0,21,653,101,309,21,389,410,1063,54,8,2,37,0,10,2,27,61,39,10,29
48,Texas/TX,4804200,"Orange & Hardin Counties PUMA, Texas/TX",120,0,17,0,0,0,120,0,17,0,17,17,137,88,0,0,12,0,0,0,12,88,12,0,12
48,Texas/TX,4804301,"Jefferson County (North Central)--Beaumont City PUMA, Texas/TX",171,0,15,0,0,23,171,0,38,23,15,38,209,82,0,11,7,0,0,11,7,82,18,0,18
48,Texas/TX,4804302,"Jefferson County (Outside Beaumont City)--Port Arthur City PUMA, Texas/TX",100,25,94,35,40,0,135,65,94,40,119,159,294,34,12,14,40,14,9,0,32,46,54,22,32
48,Texas/TX,4804400,"Houston-Galveston Area Council--Liberty & Chambers Counties PUMA, Texas/TX",283,0,96,0,0,0,283,0,96,0,96,96,379,75,0,0,25,0,0,0,25,75,25,0,25
48,Texas/TX,4804501,"Houston-Galveston Area Council--Montgomery County (Northeast)--Conroe City (East) PUMA, Texas/TX",119,0,83,34,0,0,153,0,83,0,83,83,236,50,14,0,35,0,0,0,35,65,35,0,35
48,Texas/TX,4804502,"Houston-Galveston Area Council--Montgomery County (West)--Conroe City (West) PUMA, Texas/TX",47,0,56,9,0,0,56,0,56,0,56,56,112,42,8,0,50,0,0,0,50,50,50,0,50
48,Texas/TX,4804503,"Houston-Galveston Area Council--Montgomery County (South)--The Woodlands (North) PUMA, Texas/TX",0,0,0,28,0,0,28,0,0,0,0,0,28,0,100,0,0,0,0,0,0,100,0,0,0
48,Texas/TX,4804504,"Houston-Galveston Area Council--Montgomery County (Southeast) PUMA, Texas/TX",70,0,45,0,0,0,70,0,45,0,45,45,115,61,0,0,39,0,0,0,39,61,39,0,39
48,Texas/TX,4804601,"Houston City (North Central)--North of I-10 & Inside Loop I-610 PUMA, Texas/TX",9,47,64,167,0,0,176,47,64,0,111,111,287,3,58,0,39,0,16,0,22,61,39,16,22
48,Texas/TX,4804602,"Houston City (East Central)--East of I-45 & Inside Loop I-610 PUMA, Texas/TX",0,55,108,138,0,0,138,55,108,0,163,163,301,0,46,0,54,0,18,0,36,46,54,18,36
48,Texas/TX,4804603,"Houston City (South Central)--South of US-59, West of I-45 & Inside Loop I-610 PUMA, Texas/TX",0,0,0,19,0,0,19,0,0,0,0,0,19,0,100,0,0,0,0,0,0,100,0,0,0
48,Texas/TX,4804604,"Houston City (West Central)--South of I-10 & Inside Loop I-610 PUMA, Texas/TX",19,0,0,47,0,0,66,0,0,0,0,0,66,29,71,0,0,0,0,0,0,100,0,0,0
48,Texas/TX,4804605,"Harris County (Southeast)--Pasadena City (North & Central)--Inside Beltway TX-8 PUMA, Texas/TX",35,66,296,11,0,0,46,66,296,0,362,362,408,9,3,0,89,0,16,0,73,11,89,16,73
48,Texas/TX,4804606,"Houston (East), Galena Park, Jacinto Cities & Cloverleaf PUMA, Texas/TX",37,20,220,26,0,0,63,20,220,0,240,240,303,12,9,0,79,0,7,0,73,21,79,7,73
48,Texas/TX,4804607,"Houston City (Northeast)--Between Loop I-610 & Beltway TX-8 PUMA, Texas/TX",35,0,20,13,0,0,48,0,20,0,20,20,68,51,19,0,29,0,0,0,29,71,29,0,29
48,Texas/TX,4804608,"Houston City (North) & Aldine--Between Loop I-610 & Beltway TX-8 PUMA, Texas/TX",13,18,223,97,0,0,110,18,223,0,241,241,351,4,28,0,69,0,5,0,64,31,69,5,64
48,Texas/TX,4804609,"Houston City (North)--South of Aldine & Inside Beltway TX-8 PUMA, Texas/TX",11,48,17,40,0,0,51,48,17,0,65,65,116,9,34,0,56,0,41,0,15,44,56,41,15
48,Texas/TX,4804610,"Houston City (North)--West of Aldine & Inside Beltway TX-8 PUMA, Texas/TX",117,0,134,0,0,22,117,0,156,22,134,156,273,43,0,8,49,0,0,8,49,43,57,0,57
48,Texas/TX,4804611,"Houston City (Northwest)--Between Loop I-610 & Beltway TX-8 PUMA, Texas/TX",23,0,0,88,0,0,111,0,0,0,0,0,111,21,79,0,0,0,0,0,0,100,0,0,0
48,Texas/TX,4804612,"Houston (West) & Spring Valley Village Cities--Between Loop I-610 & Beltway TX-8 PUMA, Texas/TX",29,39,95,0,0,0,29,39,95,0,134,134,163,18,0,0,82,0,24,0,58,18,82,24,58
48,Texas/TX,4804613,"Houston (West) & Hunters Creek Village Cities--Between Loop I-610 & Beltway TX-8 PUMA, Texas/TX",49,0,0,0,13,0,49,13,0,13,0,13,62,79,0,21,0,21,0,0,0,79,21,21,0
48,Texas/TX,4804614,"Houston City (West)--Westpark Tollway, Between Loop I-610 & Beltway TX-8 PUMA, Texas/TX",0,0,127,94,0,107,94,0,234,107,127,234,328,0,29,33,39,0,0,33,39,29,71,0,71
48,Texas/TX,4804615,"Houston (Southwest) & Bellaire (Southeast) Cities--Between Loop I-610 & Beltway TX-8 PUMA, Texas/TX",0,0,60,0,15,0,0,15,60,15,60,75,75,0,0,20,80,20,0,0,80,0,100,20,80
48,Texas/TX,4804616,"Houston City (Southwest)--Between Loop I-610 & Beltway TX-8 PUMA, Texas/TX",59,18,12,0,0,0,59,18,12,0,30,30,89,66,0,0,34,0,20,0,13,66,34,20,13
48,Texas/TX,4804617,"Houston City (South)--Between Loop I-610 & Beltway TX-8 PUMA, Texas/TX",334,0,0,0,55,0,334,55,0,55,0,55,389,86,0,14,0,14,0,0,0,86,14,14,0
48,Texas/TX,4804618,"Houston City (Southeast)--West of Pasadena City & Outside Loop I-610 PUMA, Texas/TX",91,36,66,24,0,0,115,36,66,0,102,102,217,42,11,0,47,0,17,0,30,53,47,17,30
48,Texas/TX,4804619,"Houston (Southeast) & South Houston Cities--Inside Beltway TX-8 PUMA, Texas/TX",0,57,150,32,45,80,32,102,230,125,207,332,364,0,9,34,57,12,16,22,41,9,91,28,63
48,Texas/TX,4804620,"Houston (Southeast) & Webster Cities PUMA, Texas/TX",41,116,0,0,0,0,41,116,0,0,116,116,157,26,0,0,74,0,74,0,0,26,74,74,0
48,Texas/TX,4804621,"Houston (Southeast), Pasadena (Southeast), La Porte (South) & Seabrook (East) Cities PUMA, Texas/TX",0,0,24,49,0,0,49,0,24,0,24,24,73,0,67,0,33,0,0,0,33,67,33,0,33
48,Texas/TX,4804622,"Harris County (East)--Deer Park, La Porte (North) Cities & Channelview PUMA, Texas/TX",104,0,0,12,0,0,116,0,0,0,0,0,116,90,10,0,0,0,0,0,0,100,0,0,0
48,Texas/TX,4804623,"Harris County (East)--Baytown City PUMA, Texas/TX",75,0,91,0,0,0,75,0,91,0,91,91,166,45,0,0,55,0,0,0,55,45,55,0,55
48,Texas/TX,4804624,"Harris County (Northeast)--Houston City (Far Northeast) PUMA, Texas/TX",83,0,0,22,0,0,105,0,0,0,0,0,105,79,21,0,0,0,0,0,0,100,0,0,0
48,Texas/TX,4804625,"Harris County (North)--Houston (North), Humble Cities & Atascocita PUMA, Texas/TX",0,0,83,98,0,0,98,0,83,0,83,83,181,0,54,0,46,0,0,0,46,54,46,0,46
48,Texas/TX,4804626,"Harris County (North)--Houston City (North)--I-45, Between Beltway TX-8 & FM-1960 PUMA, Texas/TX",11,65,310,63,0,55,74,65,365,55,375,430,504,2,12,11,74,0,13,11,62,15,85,13,72
48,Texas/TX,4804627,"Harris County (Far North)--Spring PUMA, Texas/TX",90,109,0,80,0,0,170,109,0,0,109,109,279,32,29,0,39,0,39,0,0,61,39,39,0
48,Texas/TX,4804628,"Harris County (Northwest)--Jersey Village City--Between Beltway TX-8 & FM-1960 PUMA, Texas/TX",0,20,26,0,0,0,0,20,26,0,46,46,46,0,0,0,100,0,43,0,57,0,100,43,57
48,Texas/TX,4804629,"Harris County (North)--North of FM-1960, West of I-45 & East of TX-249 PUMA, Texas/TX",108,0,0,0,0,0,108,0,0,0,0,0,108,100,0,0,0,0,0,0,0,100,0,0,0
48,Texas/TX,4804630,"Harris County (Far North)--Tomball City & The Woodlands (Southwest) PUMA, Texas/TX",120,281,0,0,0,0,120,281,0,0,281,281,401,30,0,0,70,0,70,0,0,30,70,70,0
48,Texas/TX,4804631,"Harris County (Northwest)--North of US-290 & North of FM-1960 PUMA, Texas/TX",28,0,0,23,0,0,51,0,0,0,0,0,51,55,45,0,0,0,0,0,0,100,0,0,0
48,Texas/TX,4804632,"Harris County (Far Northwest)--Katy City (Northeast) PUMA, Texas/TX",53,0,173,7,14,0,60,14,173,14,173,187,247,21,3,6,70,6,0,0,70,24,76,6,70
48,Texas/TX,4804633,"Harris County (Northwest)--South of US-290 & West of TX-6 PUMA, Texas/TX",83,0,0,63,59,0,146,59,0,59,0,59,205,40,31,29,0,29,0,0,0,71,29,29,0
48,Texas/TX,4804634,"Harris County (West)--Houston City (West)--North of US-90 & West of TX-6 PUMA, Texas/TX",92,0,0,0,0,0,92,0,0,0,0,0,92,100,0,0,0,0,0,0,0,100,0,0,0
48,Texas/TX,4804635,"Houston City (West)--South of I-10 & West of TX-6 PUMA, Texas/TX",16,47,91,0,0,0,16,47,91,0,138,138,154,10,0,0,90,0,31,0,59,10,90,31,59
48,Texas/TX,4804636,"Houston City (West)--East of TX-6 & West of Beltway TX-8 PUMA, Texas/TX",109,0,96,0,0,0,109,0,96,0,96,96,205,53,0,0,47,0,0,0,47,53,47,0,47
48,Texas/TX,4804637,"Houston City (West)--Westpark Tollway, West of Beltway TX-8 PUMA, Texas/TX",0,0,44,45,36,56,45,36,100,92,44,136,181,0,25,51,24,20,0,31,24,25,75,20,55
48,Texas/TX,4804638,"Houston City (Southwest)--East of TX-6 & West of Beltway TX-8 PUMA, Texas/TX",41,22,16,23,0,33,64,22,49,33,38,71,135,30,17,24,28,0,16,24,12,47,53,16,36
48,Texas/TX,4804701,"Galveston County (Central, South & East)--Galveston, Texas City & La Marque Cities PUMA, Texas/TX",147,16,29,26,0,0,173,16,29,0,45,45,218,67,12,0,21,0,7,0,13,79,21,7,13
48,Texas/TX,4804702,"Galveston County (Northwest)--League City & Friendswood City PUMA, Texas/TX",76,0,33,45,0,0,121,0,33,0,33,33,154,49,29,0,21,0,0,0,21,79,21,0,21
48,Texas/TX,4804801,"Houston-Galveston Area Council--Brazoria County (North)--Pearland City PUMA, Texas/TX",148,0,0,0,0,0,148,0,0,0,0,0,148,100,0,0,0,0,0,0,0,100,0,0,0
48,Texas/TX,4804802,"Houston-Galveston Area Council--Brazoria County (Central)--Alvin City PUMA, Texas/TX",22,15,13,5,0,0,27,15,13,0,28,28,55,40,9,0,51,0,27,0,24,49,51,27,24
48,Texas/TX,4804803,"Houston-Galveston Area Council--Brazoria County (Southwest)--Lake Jackson City PUMA, Texas/TX",36,48,0,9,0,0,45,48,0,0,48,48,93,39,10,0,52,0,52,0,0,48,52,52,0
48,Texas/TX,4804901,"Fort Bend County (East)--Missouri City PUMA, Texas/TX",0,0,34,28,23,79,28,23,113,102,34,136,164,0,17,62,21,14,0,48,21,17,83,14,69
48,Texas/TX,4804902,"Fort Bend County (Northeast)--Sugar Land & Stafford Cities PUMA, Texas/TX",68,0,15,0,0,0,68,0,15,0,15,15,83,82,0,0,18,0,0,0,18,82,18,0,18
48,Texas/TX,4804903,"Fort Bend County (Central)--Rosenberg City, Pecan Grove & New Territory PUMA, Texas/TX",30,22,40,97,13,0,127,35,40,13,62,75,202,15,48,6,31,6,11,0,20,63,37,17,20
48,Texas/TX,4804904,"Fort Bend County (North)--Mission Bend (Southwest), Cinco Ranch & Four Corners PUMA, Texas/TX",0,0,0,16,18,23,16,18,23,41,0,41,57,0,28,72,0,32,0,40,0,28,72,32,40
48,Texas/TX,4804905,"Fort Bend County (West & South) PUMA, Texas/TX",177,101,54,50,0,0,227,101,54,0,155,155,382,46,13,0,41,0,26,0,14,59,41,26,14
48,Texas/TX,4805000,"Houston-Galveston Area Council (West) PUMA, Texas/TX",843,145,796,186,0,35,1029,145,831,35,941,976,2005,42,9,2,47,0,7,2,40,51,49,7,41
48,Texas/TX,4805100,"Capital Area COG (East)--Bastrop, Caldwell, Fayette & Lee Counties PUMA, Texas/TX",434,9,119,125,0,0,559,9,119,0,128,128,687,63,18,0,19,0,1,0,17,81,19,1,17
48,Texas/TX,4805201,"Capital Area COG--Williamson County (North)--Georgetown (East) & Taylor Cities PUMA, Texas/TX",59,0,149,8,0,0,67,0,149,0,149,149,216,27,4,0,69,0,0,0,69,31,69,0,69
48,Texas/TX,4805202,"Capital Area COG--Williamson County (Southeast)--Round Rock City PUMA, Texas/TX",79,0,11,0,0,0,79,0,11,0,11,11,90,88,0,0,12,0,0,0,12,88,12,0,12
48,Texas/TX,4805204,"Capital Area COG--Williamson County (West)--Cedar Park & Leander Cities PUMA, Texas/TX",96,0,0,15,0,0,111,0,0,0,0,0,111,86,14,0,0,0,0,0,0,100,0,0,0
48,Texas/TX,4805301,"Travis County (Northeast)--Pflugerville, Manor Cities & Wells Branch PUMA, Texas/TX",32,0,23,152,0,0,184,0,23,0,23,23,207,15,73,0,11,0,0,0,11,89,11,0,11
48,Texas/TX,4805302,"Austin City (North) PUMA, Texas/TX",242,0,64,33,28,0,275,28,64,28,64,92,367,66,9,8,17,8,0,0,17,75,25,8,17
48,Texas/TX,4805303,"Austin City (Northeast) PUMA, Texas/TX",138,0,180,31,0,11,169,0,191,11,180,191,360,38,9,3,50,0,0,3,50,47,53,0,53
48,Texas/TX,4805304,"Austin City (Southeast) PUMA, Texas/TX",24,0,97,48,102,0,72,102,97,102,97,199,271,9,18,38,36,38,0,0,36,27,73,38,36
48,Texas/TX,4805305,"Austin City (Northwest) PUMA, Texas/TX",58,0,9,6,0,0,64,0,9,0,9,9,73,79,8,0,12,0,0,0,12,88,12,0,12
48,Texas/TX,4805306,"Austin City (Central) PUMA, Texas/TX",78,19,0,28,0,72,106,19,72,72,19,91,197,40,14,37,10,0,10,37,0,54,46,10,37
48,Texas/TX,4805307,"Austin City (South) PUMA, Texas/TX",16,0,81,0,0,0,16,0,81,0,81,81,97,16,0,0,84,0,0,0,84,16,84,0,84
48,Texas/TX,4805308,"Austin City (Southwest), Lost Creek & Barton Creek PUMA, Texas/TX",70,0,0,0,0,0,70,0,0,0,0,0,70,100,0,0,0,0,0,0,0,100,0,0,0
48,Texas/TX,4805309,"Travis County (West, South & Outside Austin City) PUMA, Texas/TX",18,0,128,0,0,0,18,0,128,0,128,128,146,12,0,0,88,0,0,0,88,12,88,0,88
48,Texas/TX,4805400,"Capital Area COG (Southwest)--Hays County PUMA, Texas/TX",238,0,0,75,0,0,313,0,0,0,0,0,313,76,24,0,0,0,0,0,0,100,0,0,0
48,Texas/TX,4805500,"Golden Crescent Regional Planning Commission (North) & Wilson & Karnes Counties PUMA, Texas/TX",610,67,1028,627,0,3,1237,67,1031,3,1095,1098,2335,26,27,0,47,0,3,0,44,53,47,3,44
48,Texas/TX,4805600,"Golden Crescent Regional Planning Commission (Southeast)--Victoria & Calhoun Counties PUMA, Texas/TX",279,26,46,97,0,0,376,26,46,0,72,72,448,62,22,0,16,0,6,0,10,84,16,6,10
48,Texas/TX,4805700,"Alamo Area COG (Northeast)--Guadalupe County PUMA, Texas/TX",266,60,79,324,0,0,590,60,79,0,139,139,729,36,44,0,19,0,8,0,11,81,19,8,11
48,Texas/TX,4805800,"Alamo Area COG (Northeast)--Comal County PUMA, Texas/TX",111,0,0,143,0,0,254,0,0,0,0,0,254,44,56,0,0,0,0,0,0,100,0,0,0
48,Texas/TX,4805901,"San Antonio City (Central) PUMA, Texas/TX",55,12,104,139,0,0,194,12,104,0,116,116,310,18,45,0,37,0,4,0,34,63,37,4,34
48,Texas/TX,4805902,"San Antonio City (Northeast)--Inside Loop I-410 PUMA, Texas/TX",87,34,58,108,0,0,195,34,58,0,92,92,287,30,38,0,32,0,12,0,20,68,32,12,20
48,Texas/TX,4805903,"San Antonio City (Southeast)--Inside Loop I-410 PUMA, Texas/TX",119,13,73,196,0,8,315,13,81,8,86,94,409,29,48,2,21,0,3,2,18,77,23,3,20
48,Texas/TX,4805904,"San Antonio City (Northwest)--Inside Loop I-410 PUMA, Texas/TX",18,0,37,141,0,99,159,0,136,99,37,136,295,6,48,34,13,0,0,34,13,54,46,0,46
48,Texas/TX,4805905,"San Antonio City (West)--Inside Loop I-410 PUMA, Texas/TX",0,32,52,292,0,0,292,32,52,0,84,84,376,0,78,0,22,0,9,0,14,78,22,9,14
48,Texas/TX,4805906,"San Antonio City (Southwest)--Inside Loop I-410 PUMA, Texas/TX",0,105,150,228,0,0,228,105,150,0,255,255,483,0,47,0,53,0,22,0,31,47,53,22,31
48,Texas/TX,4805907,"Bexar County (South)--San Antonio City (Far South) PUMA, Texas/TX",106,33,163,111,0,0,217,33,163,0,196,196,413,26,27,0,47,0,8,0,39,53,47,8,39
48,Texas/TX,4805908,"San Antonio City (West)--Between Loop TX-1604 & Loop I-410 PUMA, Texas/TX",0,0,29,0,25,0,0,25,29,25,29,54,54,0,0,46,54,46,0,0,54,0,100,46,54
48,Texas/TX,4805909,"San Antonio (Northwest) & Leon Valley Cities PUMA, Texas/TX",75,44,0,0,9,0,75,53,0,9,44,53,128,59,0,7,34,7,34,0,0,59,41,41,0
48,Texas/TX,4805910,"San Antonio City (Northwest)--Between Loop TX-1604 & Loop I-410 PUMA, Texas/TX",14,0,0,11,38,25,25,38,25,63,0,63,88,16,12,72,0,43,0,28,0,28,72,43,28
48,Texas/TX,4805911,"San Antonio City (North), Hollywood Park Town & Shavano Park City PUMA, Texas/TX",260,62,95,0,32,0,260,94,95,32,157,189,449,58,0,7,35,7,14,0,21,58,42,21,21
48,Texas/TX,4805912,"San Antonio City (Northeast)--Between Loop TX-1604 & Loop I-410 PUMA, Texas/TX",21,22,11,74,19,0,95,41,11,19,33,52,147,14,50,13,22,13,15,0,7,65,35,28,7
48,Texas/TX,4805913,"San Antonio (Northeast), Kirby & Windcrest Cities PUMA, Texas/TX",156,0,99,46,13,0,202,13,99,13,99,112,314,50,15,4,32,4,0,0,32,64,36,4,32
48,Texas/TX,4805914,"Bexar County (Northwest)--San Antonio (Far Northwest) & Helotes Cities PUMA, Texas/TX",82,0,16,30,0,0,112,0,16,0,16,16,128,64,23,0,12,0,0,0,12,88,12,0,12
48,Texas/TX,4805915,"Bexar County (North)--San Antonio City (Far North) & Timberwood Park PUMA, Texas/TX",0,0,0,0,0,15,0,0,15,15,0,15,15,0,0,100,0,0,0,100,0,0,100,0,100
48,Texas/TX,4805916,"Bexar County (Northeast)--San Antonio (Northeast), Universal City & Converse Cities PUMA, Texas/TX",21,22,0,54,0,0,75,22,0,0,22,22,97,22,56,0,23,0,23,0,0,77,23,23,0
48,Texas/TX,4806000,"Alamo Area COG (Northwest) & Blanco County PUMA, Texas/TX",228,50,53,196,0,0,424,50,53,0,103,103,527,43,37,0,20,0,9,0,10,80,20,9,10
48,Texas/TX,4806100,"Alamo Area COG (Southwest) PUMA, Texas/TX",285,199,194,407,0,0,692,199,194,0,393,393,1085,26,38,0,36,0,18,0,18,64,36,18,18
48,Texas/TX,4806200,"Middle Rio Grande Development Council PUMA, Texas/TX",176,320,319,1000,0,24,1176,320,343,24,639,663,1839,10,54,1,35,0,17,1,17,64,36,17,19
48,Texas/TX,4806301,"South Texas Development Council (North)--Webb County--Laredo City (Central) PUMA, Texas/TX",0,10,64,43,0,0,43,10,64,0,74,74,117,0,37,0,63,0,9,0,55,37,63,9,55
48,Texas/TX,4806302,"South Texas Development Council--Webb County (North & East)--Laredo City (Outer) PUMA, Texas/TX",17,0,152,23,0,0,40,0,152,0,152,152,192,9,12,0,79,0,0,0,79,21,79,0,79
48,Texas/TX,4806400,"South Texas Development Council (South) & Coastal Bend COG (West) PUMA, Texas/TX",38,69,274,397,0,0,435,69,274,0,343,343,778,5,51,0,44,0,9,0,35,56,44,9,35
48,Texas/TX,4806500,"Coastal Bend COG (Northeast) PUMA, Texas/TX",49,0,65,209,0,0,258,0,65,0,65,65,323,15,65,0,20,0,0,0,20,80,20,0,20
48,Texas/TX,4806601,"Coastal Bend COG--Nueces County--Corpus Christi City (Outer) PUMA, Texas/TX",157,10,101,158,0,65,315,10,166,65,111,176,491,32,32,13,23,0,2,13,21,64,36,2,34
48,Texas/TX,4806602,"Coastal Bend COG--Nueces County (Central)--Corpus Christi City (North Central) PUMA, Texas/TX",69,10,82,112,0,0,181,10,82,0,92,92,273,25,41,0,34,0,4,0,30,66,34,4,30
48,Texas/TX,4806603,"Coastal Bend COG--Nueces County (Central)--Corpus Christi City (South Central) PUMA, Texas/TX",41,0,0,97,15,0,138,15,0,15,0,15,153,27,63,10,0,10,0,0,0,90,10,10,0
48,Texas/TX,4806701,"Cameron County (East)--Brownsville City (North) PUMA, Texas/TX",41,45,435,133,0,0,174,45,435,0,480,480,654,6,20,0,73,0,7,0,67,27,73,7,67
48,Texas/TX,4806702,"Cameron County (West)--Harlingen & San Benito Cities PUMA, Texas/TX",59,39,459,263,0,0,322,39,459,0,498,498,820,7,32,0,61,0,5,0,56,39,61,5,56
48,Texas/TX,4806703,"Cameron County (South)--Brownsville City (Central) PUMA, Texas/TX",10,83,249,93,0,0,103,83,249,0,332,332,435,2,21,0,76,0,19,0,57,24,76,19,57
48,Texas/TX,4806801,"Hidalgo County (Southeast)--Weslaco & Mercedes Cities PUMA, Texas/TX",0,46,401,308,0,0,308,46,401,0,447,447,755,0,41,0,59,0,6,0,53,41,59,6,53
48,Texas/TX,4806802,"Hidalgo County (East)--Alamo & Donna Cities PUMA, Texas/TX",0,26,945,187,0,0,187,26,945,0,971,971,1158,0,16,0,84,0,2,0,82,16,84,2,82
48,Texas/TX,4806803,"Hidalgo County (South Central)--Pharr, San Juan & Hidalgo Cities PUMA, Texas/TX",0,0,204,187,0,0,187,0,204,0,204,204,391,0,48,0,52,0,0,0,52,48,52,0,52
48,Texas/TX,4806804,"Hidalgo County (North Central)--Edinburg City PUMA, Texas/TX",0,65,495,98,0,0,98,65,495,0,560,560,658,0,15,0,85,0,10,0,75,15,85,10,75
48,Texas/TX,4806805,"Hidalgo County (Central)--McAllen City PUMA, Texas/TX",33,44,189,151,0,0,184,44,189,0,233,233,417,8,36,0,56,0,11,0,45,44,56,11,45
48,Texas/TX,4806806,"Hidalgo County (Southwest)--Mission City PUMA, Texas/TX",0,26,190,204,0,0,204,26,190,0,216,216,420,0,49,0,51,0,6,0,45,49,51,6,45
48,Texas/TX,4806807,"Hidalgo County (North & West) PUMA, Texas/TX",0,90,795,245,0,0,245,90,795,0,885,885,1130,0,22,0,78,0,8,0,70,22,78,8,70
48,Texas/TX,4806900,"Coastal Bend COG (Southeast) & Willacy County PUMA, Texas/TX",444,103,109,689,0,0,1133,103,109,0,212,212,1345,33,51,0,16,0,8,0,8,84,16,8,8
49,Utah/UT,4903001,"Tooele & Box Elder Counties PUMA, Utah/UT",769,90,11,64,0,0,833,90,11,0,101,101,934,82,7,0,11,0,10,0,1,89,11,10,1
49,Utah/UT,4905001,"Cache, Summit, Morgan & Rich Counties PUMA, Utah/UT",1421,120,281,309,107,203,1730,227,484,310,401,711,2441,58,13,13,16,4,5,8,12,71,29,9,20
49,Utah/UT,4911001,"Davis County (North)--Layton, Clearfield, Kaysville, Syracuse & Clinton Cities PUMA, Utah/UT",391,80,49,43,28,56,434,108,105,84,129,213,647,60,7,13,20,4,12,9,8,67,33,17,16
49,Utah/UT,4911002,"Davis County (South)--Bountiful, Farmington & North Salt Lake Cities PUMA, Utah/UT",119,0,0,94,0,0,213,0,0,0,0,0,213,56,44,0,0,0,0,0,0,100,0,0,0
49,Utah/UT,4913001,"Southeast Utah & Uintah Basin Region PUMA, Utah/UT",245,0,337,0,0,0,245,0,337,0,337,337,582,42,0,0,58,0,0,0,58,42,58,0,58
49,Utah/UT,4921001,"Southwest & South Central Utah (Outside Washington County)--Cedar City PUMA, Utah/UT",1186,48,917,160,3,62,1346,51,979,65,965,1030,2376,50,7,3,41,0,2,3,39,57,43,2,41
49,Utah/UT,4935001,"Salt Lake County (Northwest)--Salt Lake City (West), West Valley City (West) & Magna PUMA, Utah/UT",102,38,502,138,76,27,240,114,529,103,540,643,883,12,16,12,61,9,4,3,57,27,73,13,60
49,Utah/UT,4935002,"Salt Lake County (Northeast)--Salt Lake City (East) PUMA, Utah/UT",214,0,145,23,0,15,237,0,160,15,145,160,397,54,6,4,37,0,0,4,37,60,40,0,40
49,Utah/UT,4935003,"Salt Lake County--West Valley City (Central), Salt Lake City (South Central) & Kearns PUMA, Utah/UT",185,0,329,150,39,127,335,39,456,166,329,495,830,22,18,20,40,5,0,15,40,40,60,5,55
49,Utah/UT,4935004,"Salt Lake County--West Valley City (East), Taylorsville & Murray (West) Cities PUMA, Utah/UT",117,20,92,379,33,30,496,53,122,63,112,175,671,17,56,9,17,5,3,4,14,74,26,8,18
49,Utah/UT,4935005,"Salt Lake County (East Central)--Murray (East), Holladay Cities & Millcreek PUMA, Utah/UT",156,11,68,0,0,0,156,11,68,0,79,79,235,66,0,0,34,0,5,0,29,66,34,5,29
49,Utah/UT,4935006,"Salt Lake County--West Jordan (West), Herriman & South Jordan (West) Cities PUMA, Utah/UT",77,151,38,0,0,0,77,151,38,0,189,189,266,29,0,0,71,0,57,0,14,29,71,57,14
49,Utah/UT,4935007,"Salt Lake County--West Jordan (East), South Jordan (East) & Riverton Cities PUMA, Utah/UT",84,0,15,0,65,71,84,65,86,136,15,151,235,36,0,58,6,28,0,30,6,36,64,28,37
49,Utah/UT,4935008,"Salt Lake County (Southeast)--Sandy (North), Cottonwood Heights & Midvale Cities PUMA, Utah/UT",62,0,0,0,0,0,62,0,0,0,0,0,62,100,0,0,0,0,0,0,0,100,0,0,0
49,Utah/UT,4935009,"Salt Lake County (South & East Central)--Draper (Northwest) & Sandy (South) Cities PUMA, Utah/UT",106,0,0,0,0,0,106,0,0,0,0,0,106,100,0,0,0,0,0,0,0,100,0,0,0
49,Utah/UT,4949001,"Utah County (West)--Saratoga Springs, Payson & Lehi (Southwest) Cities PUMA, Utah/UT",472,28,193,111,12,0,583,40,193,12,221,233,816,58,14,1,27,1,3,0,24,71,29,5,24
49,Utah/UT,4949002,"Utah County (Central)--Orem, Pleasant Grove, American Fork & Lindon Cities PUMA, Utah/UT",274,21,172,65,36,0,339,57,172,36,193,229,568,48,11,6,34,6,4,0,30,60,40,10,30
49,Utah/UT,4949003,"Utah County (Central)--Provo City PUMA, Utah/UT",155,17,98,0,0,0,155,17,98,0,115,115,270,57,0,0,43,0,6,0,36,57,43,6,36
49,Utah/UT,4949004,"Utah County (East)--Spanish Fork, Springville, Lehi (Northeast) & Highland Cities PUMA, Utah/UT",301,157,144,7,15,36,308,172,180,51,301,352,660,46,1,8,46,2,24,5,22,47,53,26,27
49,Utah/UT,4953001,"Washington County--St. George City PUMA, Utah/UT",411,0,0,0,0,47,411,0,47,47,0,47,458,90,0,10,0,0,0,10,0,90,10,0,10
49,Utah/UT,4957001,"Weber County (West)--Roy, North Ogden, Ogden (Northwest) & West Haven Cities PUMA, Utah/UT",376,126,95,196,44,0,572,170,95,44,221,265,837,45,23,5,26,5,15,0,11,68,32,20,11
49,Utah/UT,4957002,"Weber County (East)--Ogden (Southeast) & South Ogden Cities PUMA, Utah/UT",283,170,187,38,10,23,321,180,210,33,357,390,711,40,5,5,50,1,24,3,26,45,55,25,30
50,Vermont/VT,5000100,"Northwest Vermont--Chittenden, Franklin & Grand Isle Counties--Burlington City PUMA, Vermont/VT",1765,47,102,0,99,297,1765,146,399,396,149,545,2310,76,0,17,6,4,2,13,4,76,24,6,17
50,Vermont/VT,5000200,"Northeast Vermont--Washington, Caledonia, Orleans, Lamoille & Essex Counties PUMA, Vermont/VT",1658,0,0,83,0,0,1741,0,0,0,0,0,1741,95,5,0,0,0,0,0,0,100,0,0,0
50,Vermont/VT,5000300,"Southeast Vermont--Windsor, Windham & Orange Counties PUMA, Vermont/VT",1007,0,96,0,26,0,1007,26,96,26,96,122,1129,89,0,2,9,2,0,0,9,89,11,2,9
50,Vermont/VT,5000400,"Southwest Vermont--Rutland, Bennington & Addison Counties PUMA, Vermont/VT",1631,0,24,0,0,15,1631,0,39,15,24,39,1670,98,0,1,1,0,0,1,1,98,2,0,2
51,Virginia/VA,5101301,"Arlington County (North) PUMA, Virginia/VA",0,0,0,0,0,4,0,0,4,4,0,4,4,0,0,100,0,0,0,100,0,0,100,0,100
51,Virginia/VA,5101302,"Arlington County (South) PUMA, Virginia/VA",0,0,47,0,0,0,0,0,47,0,47,47,47,0,0,0,100,0,0,0,100,0,100,0,100
51,Virginia/VA,5104101,"Chesterfield County (East)--James River Region PUMA, Virginia/VA",154,0,27,0,0,0,154,0,27,0,27,27,181,85,0,0,15,0,0,0,15,85,15,0,15
51,Virginia/VA,5104102,"Chesterfield County (Central)--Chester & Rockwood PUMA, Virginia/VA",76,21,16,0,0,0,76,21,16,0,37,37,113,67,0,0,33,0,19,0,14,67,33,19,14
51,Virginia/VA,5104103,"Chesterfield County (West)--Brandermill & Woodlake PUMA, Virginia/VA",187,0,0,0,0,0,187,0,0,0,0,0,187,100,0,0,0,0,0,0,0,100,0,0,0
51,Virginia/VA,5110701,"Loudoun County (Northeast)--Sterling & Ashburn (Northeast/Ashburn Village) PUMA, Virginia/VA",128,0,57,82,14,0,210,14,57,14,57,71,281,46,29,5,20,5,0,0,20,75,25,5,20
51,Virginia/VA,5110702,"Loudoun County (East Central)--Ashburn (Southwest/Belmont Ridge) & Dulles Airport PUMA, Virginia/VA",20,0,0,0,0,0,20,0,0,0,0,0,20,100,0,0,0,0,0,0,0,100,0,0,0
51,Virginia/VA,5110703,"Loudoun County (West & South)--Leesburg Town PUMA, Virginia/VA",153,0,49,19,23,0,172,23,49,23,49,72,244,63,8,9,20,9,0,0,20,70,30,9,20
51,Virginia/VA,5151010,"LENOWISCO & Cumberland Plateau Planning District Commissions PUMA, Virginia/VA",570,9,23,0,0,0,570,9,23,0,32,32,602,95,0,0,5,0,1,0,4,95,5,1,4
51,Virginia/VA,5151020,"Mount Rogers Planning District Commission PUMA, Virginia/VA",921,0,157,0,0,0,921,0,157,0,157,157,1078,85,0,0,15,0,0,0,15,85,15,0,15
51,Virginia/VA,5151040,"New River Valley Planning District Commission PUMA, Virginia/VA",544,0,44,0,54,0,544,54,44,54,44,98,642,85,0,8,7,8,0,0,7,85,15,8,7
51,Virginia/VA,5151044,"Roanoke Valley-Alleghany Regional Commission (Roanoke, Salem Cities & Vinton Town) PUMA, Virginia/VA",134,0,0,0,19,106,134,19,106,125,0,125,259,52,0,48,0,7,0,41,0,52,48,7,41
51,Virginia/VA,5151045,"Roanoke Valley-Alleghany Regional Commission (Outside Roanoke & Salem Cities) PUMA, Virginia/VA",622,0,55,0,0,0,622,0,55,0,55,55,677,92,0,0,8,0,0,0,8,92,8,0,8
51,Virginia/VA,5151080,"Central Shenandoah Planning District Commission (Southwest) PUMA, Virginia/VA",1706,0,49,16,66,0,1722,66,49,66,49,115,1837,93,1,4,3,4,0,0,3,94,6,4,3
51,Virginia/VA,5151084,"Northern Shenandoah Valley Regional Commission (North) PUMA, Virginia/VA",294,19,272,26,0,0,320,19,272,0,291,291,611,48,4,0,48,0,3,0,45,52,48,3,45
51,Virginia/VA,5151085,"Northern Shenandoah Valley Regional Commission (South) PUMA, Virginia/VA",1152,197,109,11,20,15,1163,217,124,35,306,341,1504,77,1,2,20,1,13,1,7,77,23,14,8
51,Virginia/VA,5151087,"Rappahannock-Rapidan Regional Commission PUMA, Virginia/VA",498,0,754,0,0,0,498,0,754,0,754,754,1252,40,0,0,60,0,0,0,60,40,60,0,60
51,Virginia/VA,5151089,"Thomas Jefferson Planning District Commission (South & East) PUMA, Virginia/VA",351,0,130,0,0,0,351,0,130,0,130,130,481,73,0,0,27,0,0,0,27,73,27,0,27
51,Virginia/VA,5151090,"Thomas Jefferson Planning District Commission (North) PUMA, Virginia/VA",249,0,44,0,0,0,249,0,44,0,44,44,293,85,0,0,15,0,0,0,15,85,15,0,15
51,Virginia/VA,5151095,"Virginia's Region 2000 (North)--Bedford, Amherst, Appomattox Counties & Bedford City PUMA, Virginia/VA",308,0,0,0,0,0,308,0,0,0,0,0,308,100,0,0,0,0,0,0,0,100,0,0,0
51,Virginia/VA,5151096,"Virginia's Region 2000 (South)--Campbell County & Lynchburg City PUMA, Virginia/VA",213,0,194,15,0,0,228,0,194,0,194,194,422,50,4,0,46,0,0,0,46,54,46,0,46
51,Virginia/VA,5151097,"West Piedmont Planning District Commission PUMA, Virginia/VA",824,0,31,140,22,0,964,22,31,22,31,53,1017,81,14,2,3,2,0,0,3,95,5,2,3
51,Virginia/VA,5151105,"Southside Planning District Commission & Commonwealth Regional Council PUMA, Virginia/VA",1017,0,207,59,95,0,1076,95,207,95,207,302,1378,74,4,7,15,7,0,0,15,78,22,7,15
51,Virginia/VA,5151110,"Central Shenandoah Planning District Commission (Northeast) PUMA, Virginia/VA",2147,445,704,484,88,253,2631,533,957,341,1149,1490,4121,52,12,8,28,2,11,6,17,64,36,13,23
51,Virginia/VA,5151115,"George Washington Regional Commission (North) PUMA, Virginia/VA",195,0,81,0,0,0,195,0,81,0,81,81,276,71,0,0,29,0,0,0,29,71,29,0,29
51,Virginia/VA,5151120,"George Washington Regional Commission (South) PUMA, Virginia/VA",360,76,4,0,13,0,360,89,4,13,80,93,453,79,0,3,18,3,17,0,1,79,21,20,1
51,Virginia/VA,5151125,"Middle Peninsula, Northern Neck & Accomack-Northampton Planning District Commissions PUMA, Virginia/VA",1521,72,106,0,21,70,1521,93,176,91,178,269,1790,85,0,5,10,1,4,4,6,85,15,5,10
51,Virginia/VA,5151135,"Crater Planning District Commission PUMA, Virginia/VA",1138,0,0,78,0,0,1216,0,0,0,0,0,1216,94,6,0,0,0,0,0,0,100,0,0,0
51,Virginia/VA,5151145,"Isle of Wight, Southampton Counties, Suffolk & Franklin Cities PUMA, Virginia/VA",1632,0,3,0,0,15,1632,0,18,15,3,18,1650,99,0,1,0,0,0,1,0,99,1,0,1
51,Virginia/VA,5151154,"Norfolk City (Northeast) PUMA, Virginia/VA",338,0,51,47,0,16,385,0,67,16,51,67,452,75,10,4,11,0,0,4,11,85,15,0,15
51,Virginia/VA,5151155,"Portsmouth & Norfolk (Southwest) Cities PUMA, Virginia/VA",94,0,0,34,0,0,128,0,0,0,0,0,128,73,27,0,0,0,0,0,0,100,0,0,0
51,Virginia/VA,5151164,"Virginia Beach City (North) PUMA, Virginia/VA",173,0,26,0,0,0,173,0,26,0,26,26,199,87,0,0,13,0,0,0,13,87,13,0,13
51,Virginia/VA,5151165,"Virginia Beach City (Central) PUMA, Virginia/VA",79,0,0,0,0,0,79,0,0,0,0,0,79,100,0,0,0,0,0,0,0,100,0,0,0
51,Virginia/VA,5151167,"Virginia Beach City (South) PUMA, Virginia/VA",136,0,0,13,0,0,149,0,0,0,0,0,149,91,9,0,0,0,0,0,0,100,0,0,0
51,Virginia/VA,5151175,"Newport News City PUMA, Virginia/VA",533,0,96,46,78,203,579,78,299,281,96,377,956,56,5,29,10,8,0,21,10,61,39,8,31
51,Virginia/VA,5151186,"Hampton City PUMA, Virginia/VA",530,0,0,0,72,44,530,72,44,116,0,116,646,82,0,18,0,11,0,7,0,82,18,11,7
51,Virginia/VA,5151206,"James City, York Counties, Williamsburg & Poquoson Cities PUMA, Virginia/VA",148,0,13,0,0,0,148,0,13,0,13,13,161,92,0,0,8,0,0,0,8,92,8,0,8
51,Virginia/VA,5151215,"Hanover, Powhatan, Goochland, New Kent, King William & Charles City Counties PUMA, Virginia/VA",509,0,71,0,0,0,509,0,71,0,71,71,580,88,0,0,12,0,0,0,12,88,12,0,12
51,Virginia/VA,5151224,"Henrico County (South & East)--Highland Springs, East Highland Park & Glen Allen PUMA, Virginia/VA",491,0,0,0,0,59,491,0,59,59,0,59,550,89,0,11,0,0,0,11,0,89,11,0,11
51,Virginia/VA,5151225,"Henrico County (West)--Tuckahoe, Short Pump & Wyndham PUMA, Virginia/VA",36,17,51,0,23,11,36,40,62,34,68,102,138,26,0,25,49,17,12,8,37,26,74,29,45
51,Virginia/VA,5151235,"Richmond City PUMA, Virginia/VA",744,0,80,58,0,0,802,0,80,0,80,80,882,84,7,0,9,0,0,0,9,91,9,0,9
51,Virginia/VA,5151244,"Prince William County (North & West)--Linton Hall & Gainesville PUMA, Virginia/VA",12,0,0,0,0,0,12,0,0,0,0,0,12,100,0,0,0,0,0,0,0,100,0,0,0
51,Virginia/VA,5151245,"Manassas, Manassas Park Cities & Prince William County (Central)--Buckhall & Sudley PUMA, Virginia/VA",0,0,0,21,0,0,21,0,0,0,0,0,21,0,100,0,0,0,0,0,0,100,0,0,0
51,Virginia/VA,5151246,"Prince William County (Southeast)--Dale City, Lake Ridge & Woodbridge PUMA, Virginia/VA",86,30,76,0,27,20,86,57,96,47,106,153,239,36,0,20,44,11,13,8,32,36,64,24,40
51,Virginia/VA,5151255,"Alexandria City PUMA, Virginia/VA",21,0,92,7,27,0,28,27,92,27,92,119,147,14,5,18,63,18,0,0,63,19,81,18,63
51,Virginia/VA,5155001,"Chesapeake City (Northeast) PUMA, Virginia/VA",75,0,49,0,0,0,75,0,49,0,49,49,124,60,0,0,40,0,0,0,40,60,40,0,40
51,Virginia/VA,5155002,"Chesapeake City (South & West) PUMA, Virginia/VA",110,0,0,0,0,0,110,0,0,0,0,0,110,100,0,0,0,0,0,0,0,100,0,0,0
51,Virginia/VA,5159301,"Fairfax County (East Central)--Annandale, West Falls Church & Bailey's Crossroads PUMA, Virginia/VA",55,22,19,0,54,32,55,76,51,86,41,127,182,30,0,47,23,30,12,18,10,30,70,42,28
51,Virginia/VA,5159302,"Fairfax County (Southeast)--Woodlawn, Rose Hill & Mount Vernon PUMA, Virginia/VA",8,0,37,0,19,27,8,19,64,46,37,83,91,9,0,51,41,21,0,30,41,9,91,21,70
51,Virginia/VA,5159303,"Fairfax County (Central) & Fairfax City--Burke PUMA, Virginia/VA",79,0,14,0,27,0,79,27,14,27,14,41,120,66,0,22,12,22,0,0,12,66,34,22,12
51,Virginia/VA,5159304,"Fairfax County (Southwest)--Centreville (Southeast) & Lorton PUMA, Virginia/VA",32,0,0,0,0,0,32,0,0,0,0,0,32,100,0,0,0,0,0,0,0,100,0,0,0
51,Virginia/VA,5159305,"Fairfax County (North Central)--Vienna Town, Oakton & Fair Oaks (East) PUMA, Virginia/VA",28,0,11,0,0,26,28,0,37,26,11,37,65,43,0,40,17,0,0,40,17,43,57,0,57
51,Virginia/VA,5159306,"Fairfax County (South Central)--Springfield (South), West Springfield & Franconia PUMA, Virginia/VA",54,0,0,24,0,100,78,0,100,100,0,100,178,30,13,56,0,0,0,56,0,44,56,0,56
51,Virginia/VA,5159307,"Fairfax County (Northwest)--Reston (North) & Franklin Farm PUMA, Virginia/VA",13,0,18,19,0,22,32,0,40,22,18,40,72,18,26,31,25,0,0,31,25,44,56,0,56
51,Virginia/VA,5159308,"Fairfax County (Northeast)--McLean & Idylwood PUMA, Virginia/VA",0,0,62,0,0,0,0,0,62,0,62,62,62,0,0,0,100,0,0,0,100,0,100,0,100
51,Virginia/VA,5159309,"Fairfax County (West Central)--Centreville (North & West) & Chantilly (South & West) PUMA, Virginia/VA",0,18,0,0,0,13,0,18,13,13,18,31,31,0,0,42,58,0,58,42,0,0,100,58,42
53,Washington/WA,5310100,"Whatcom County--Bellingham City PUMA, Washington/WA",1109,58,794,106,0,180,1215,58,974,180,852,1032,2247,49,5,8,38,0,3,8,35,54,46,3,43
53,Washington/WA,5310200,"Skagit, Island & San Juan Counties PUMA, Washington/WA",579,104,1278,243,94,75,822,198,1353,169,1382,1551,2373,24,10,7,58,4,4,3,54,35,65,8,57
53,Washington/WA,5310300,"Chelan & Douglas Counties PUMA, Washington/WA",589,871,3189,430,38,0,1019,909,3189,38,4060,4098,5117,12,8,1,79,1,17,0,62,20,80,18,62
53,Washington/WA,5310400,"Stevens, Okanogan, Pend Oreille & Ferry Counties PUMA, Washington/WA",526,87,1184,260,0,5,786,87,1189,5,1271,1276,2062,26,13,0,62,0,4,0,57,38,62,4,58
53,Washington/WA,5310501,"Spokane County (North Central)--Spokane City (North) PUMA, Washington/WA",480,0,24,70,0,0,550,0,24,0,24,24,574,84,12,0,4,0,0,0,4,96,4,0,4
53,Washington/WA,5310502,"Spokane County (South Central)--Spokane City (South) PUMA, Washington/WA",327,0,10,9,0,0,336,0,10,0,10,10,346,95,3,0,3,0,0,0,3,97,3,0,3
53,Washington/WA,5310503,"Spokane County (East Central)--Greater Spokane Valley City PUMA, Washington/WA",394,0,67,49,0,0,443,0,67,0,67,67,510,77,10,0,13,0,0,0,13,87,13,0,13
53,Washington/WA,5310504,"Spokane County (Outer)--Cheney City PUMA, Washington/WA",376,41,0,47,0,15,423,41,15,15,41,56,479,78,10,3,9,0,9,3,0,88,12,9,3
53,Washington/WA,5310600,"Whitman, Asotin, Adams, Lincoln, Columbia & Garfield Counties PUMA, Washington/WA",962,341,1775,244,0,20,1206,341,1795,20,2116,2136,3342,29,7,1,63,0,10,1,53,36,64,10,54
53,Washington/WA,5310701,"Benton & Franklin Counties--Pasco, Richland (North) & West Richland Cities PUMA, Washington/WA",277,648,2708,630,0,20,907,648,2728,20,3356,3376,4283,6,15,0,78,0,15,0,63,21,79,15,64
53,Washington/WA,5310702,"Benton County (East Central)--Kennewick & Richland (South) Cities PUMA, Washington/WA",297,171,1327,208,27,88,505,198,1415,115,1498,1613,2118,14,10,5,71,1,8,4,63,24,76,9,67
53,Washington/WA,5310703,"Walla Walla, Benton (Outer) & Franklin (Outer) Counties PUMA, Washington/WA",876,389,3102,387,94,11,1263,483,3113,105,3491,3596,4859,18,8,2,72,2,8,0,64,26,74,10,64
53,Washington/WA,5310800,"Grant & Kittitas Counties PUMA, Washington/WA",1276,733,6397,992,0,57,2268,733,6454,57,7130,7187,9455,13,10,1,75,0,8,1,68,24,76,8,68
53,Washington/WA,5310901,"Yakima County (Central)--Greater Yakima City PUMA, Washington/WA",589,653,3059,450,0,18,1039,653,3077,18,3712,3730,4769,12,9,0,78,0,14,0,64,22,78,14,65
53,Washington/WA,5310902,"Yakima County (Outer)--Sunnyside & Grandview Cities PUMA, Washington/WA",512,1205,7435,1468,0,19,1980,1205,7454,19,8640,8659,10639,5,14,0,81,0,11,0,70,19,81,11,70
53,Washington/WA,5311000,"Lewis, Klickitat & Skamania Counties PUMA, Washington/WA",342,34,595,114,33,9,456,67,604,42,629,671,1127,30,10,4,56,3,3,1,53,40,60,6,54
53,Washington/WA,5311101,"Clark County (Southwest)--Vancouver City (West & Central) PUMA, Washington/WA",171,15,58,56,10,0,227,25,58,10,73,83,310,55,18,3,24,3,5,0,19,73,27,8,19
53,Washington/WA,5311102,"Clark County (West Central)--Salmon Creek & Hazel Dell PUMA, Washington/WA",296,81,55,29,0,10,325,81,65,10,136,146,471,63,6,2,29,0,17,2,12,69,31,17,14
53,Washington/WA,5311103,"Clark County (Southeast)--Vancouver (East), Camas & Washougal Cities PUMA, Washington/WA",176,0,9,0,0,22,176,0,31,22,9,31,207,85,0,11,4,0,0,11,4,85,15,0,15
53,Washington/WA,5311104,"Clark County (North)--Battle Ground City & Orchards PUMA, Washington/WA",368,37,63,10,42,25,378,79,88,67,100,167,545,68,2,12,18,8,7,5,12,69,31,14,16
53,Washington/WA,5311200,"Cowlitz, Pacific & Wahkiakum Counties PUMA, Washington/WA",773,134,271,68,29,78,841,163,349,107,405,512,1353,57,5,8,30,2,10,6,20,62,38,12,26
53,Washington/WA,5311300,"Grays Harbor & Mason Counties PUMA, Washington/WA",572,58,835,218,0,0,790,58,835,0,893,893,1683,34,13,0,53,0,3,0,50,47,53,3,50
53,Washington/WA,5311401,"Thurston County (Central)--Olympia, Lacey & Tumwater Cities PUMA, Washington/WA",324,31,108,129,20,0,453,51,108,20,139,159,612,53,21,3,23,3,5,0,18,74,26,8,18
53,Washington/WA,5311402,"Thurston County (Outer) PUMA, Washington/WA",354,0,56,33,15,10,387,15,66,25,56,81,468,76,7,5,12,3,0,2,12,83,17,3,14
53,Washington/WA,5311501,"Pierce County (Central)--Tacoma City (Central) PUMA, Washington/WA",266,0,157,64,30,7,330,30,164,37,157,194,524,51,12,7,30,6,0,1,30,63,37,6,31
53,Washington/WA,5311502,"Pierce County (Northwest)--Peninsula Region & Tacoma City (West) PUMA, Washington/WA",47,0,0,20,0,0,67,0,0,0,0,0,67,70,30,0,0,0,0,0,0,100,0,0,0
53,Washington/WA,5311503,"Pierce County (West Central)--Lakewood City & Joint Base Lewis-McChord PUMA, Washington/WA",66,54,91,21,0,0,87,54,91,0,145,145,232,28,9,0,62,0,23,0,39,38,62,23,39
53,Washington/WA,5311504,"Pierce County (South Central)--Tacoma City (South), Parkland & Spanaway PUMA, Washington/WA",273,76,263,55,26,0,328,102,263,26,339,365,693,39,8,4,49,4,11,0,38,47,53,15,38
53,Washington/WA,5311505,"Pierce County (North Central)--Tacoma (Port) & Bonney Lake (Northwest) Cities PUMA, Washington/WA",200,21,56,41,4,43,241,25,99,47,77,124,365,55,11,13,21,1,6,12,15,66,34,7,27
53,Washington/WA,5311506,"Pierce County (East Central)--Puyallup City & South Hill PUMA, Washington/WA",134,0,116,0,103,39,134,103,155,142,116,258,392,34,0,36,30,26,0,10,30,34,66,26,40
53,Washington/WA,5311507,"Pierce County (Southeast)--Graham, Elk Plain & Prairie Ridge PUMA, Washington/WA",196,16,15,61,0,0,257,16,15,0,31,31,288,68,21,0,11,0,6,0,5,89,11,6,5
53,Washington/WA,5311601,"Seattle City (Northwest) PUMA, Washington/WA",153,0,0,0,0,0,153,0,0,0,0,0,153,100,0,0,0,0,0,0,0,100,0,0,0
53,Washington/WA,5311602,"Seattle City (Northeast) PUMA, Washington/WA",126,0,13,63,0,55,189,0,68,55,13,68,257,49,25,21,5,0,0,21,5,74,26,0,26
53,Washington/WA,5311603,"Seattle City (Downtown)--Queen Anne & Magnolia PUMA, Washington/WA",85,23,24,0,0,60,85,23,84,60,47,107,192,44,0,31,24,0,12,31,12,44,56,12,44
53,Washington/WA,5311604,"Seattle City (Southeast)--Capitol Hill PUMA, Washington/WA",155,0,72,26,14,221,181,14,293,235,72,307,488,32,5,48,15,3,0,45,15,37,63,3,60
53,Washington/WA,5311605,"Seattle City (West)--Duwamish & Beacon Hill PUMA, Washington/WA",191,0,199,141,136,46,332,136,245,182,199,381,713,27,20,26,28,19,0,6,28,47,53,19,34
53,Washington/WA,5311606,"King County (Northwest)--Shoreline, Kenmore & Bothell (South) Cities PUMA, Washington/WA",75,22,0,0,0,40,75,22,40,40,22,62,137,55,0,29,16,0,16,29,0,55,45,16,29
53,Washington/WA,5311607,"King County (Northwest)--Redmond, Kirkland Cities, Inglewood & Finn Hill PUMA, Washington/WA",166,0,5,100,20,24,266,20,29,44,5,49,315,53,32,14,2,6,0,8,2,84,16,6,9
53,Washington/WA,5311608,"King County (Northwest Central)--Greater Bellevue City PUMA, Washington/WA",88,25,14,0,40,15,88,65,29,55,39,94,182,48,0,30,21,22,14,8,8,48,52,36,16
53,Washington/WA,5311609,"King County (Central)--Sammamish, Issaquah, Mercer Island & Newcastle Cities PUMA, Washington/WA",236,0,25,0,0,0,236,0,25,0,25,25,261,90,0,0,10,0,0,0,10,90,10,0,10
53,Washington/WA,5311610,"King County (Central)--Renton City, Fairwood, Bryn Mawr & Skyway PUMA, Washington/WA",116,0,82,31,141,143,147,141,225,284,82,366,513,23,6,55,16,27,0,28,16,29,71,27,44
53,Washington/WA,5311611,"King County (West Central)--Burien, SeaTac, Tukwila Cities & White Center PUMA, Washington/WA",171,66,91,78,74,192,249,140,283,266,157,423,672,25,12,40,23,11,10,29,14,37,63,21,42
53,Washington/WA,5311612,"King County (Far Southwest)--Federal Way, Des Moines Cities & Vashon Island PUMA, Washington/WA",136,271,153,72,53,96,208,324,249,149,424,573,781,17,9,19,54,7,35,12,20,27,73,41,32
53,Washington/WA,5311613,"King County (Southwest Central)--Kent City PUMA, Washington/WA",188,95,155,47,127,331,235,222,486,458,250,708,943,20,5,49,27,13,10,35,16,25,75,24,52
53,Washington/WA,5311614,"King County (Southwest)--Auburn City & Lakeland PUMA, Washington/WA",387,0,200,37,31,33,424,31,233,64,200,264,688,56,5,9,29,5,0,5,29,62,38,5,34
53,Washington/WA,5311615,"King County (Southeast)--Maple Valley, Covington & Enumclaw Cities PUMA, Washington/WA",217,69,40,9,0,0,226,69,40,0,109,109,335,65,3,0,33,0,21,0,12,67,33,21,12
53,Washington/WA,5311616,"King County (Northeast)--Snoqualmie City, Cottage Lake, Union Hill & Novelty Hill PUMA, Washington/WA",78,81,27,42,0,0,120,81,27,0,108,108,228,34,18,0,47,0,36,0,12,53,47,36,12
53,Washington/WA,5311701,"Snohomish County (Southwest)--Edmonds, Lynnwood & Mountlake Terrace Cities PUMA, Washington/WA",94,93,62,0,37,14,94,130,76,51,155,206,300,31,0,17,52,12,31,5,21,31,69,43,25
53,Washington/WA,5311702,"Snohomish County (West Central)--Mukilteo & Everett (Southwest) Cities PUMA, Washington/WA",12,46,242,0,23,0,12,69,242,23,288,311,323,4,0,7,89,7,14,0,75,4,96,21,75
53,Washington/WA,5311703,"Snohomish County (Central)--Everett City (Central & East) & Eastmont PUMA, Washington/WA",65,97,83,103,134,159,168,231,242,293,180,473,641,10,16,46,28,21,15,25,13,26,74,36,38
53,Washington/WA,5311704,"Snohomish County (South Central)--Bothell (North), Mill Creek Cities & Silver Firs PUMA, Washington/WA",125,29,7,0,46,63,125,75,70,109,36,145,270,46,0,40,13,17,11,23,3,46,54,28,26
53,Washington/WA,5311705,"Snohomish County (Central & Southeast)--Lake Stevens & Monroe Cities PUMA, Washington/WA",236,0,24,51,0,0,287,0,24,0,24,24,311,76,16,0,8,0,0,0,8,92,8,0,8
53,Washington/WA,5311706,"Snohomish County (North)--Marysville & Arlington Cities PUMA, Washington/WA",277,51,98,57,14,0,334,65,98,14,149,163,497,56,11,3,30,3,10,0,20,67,33,13,20
53,Washington/WA,5311801,"Kitsap County (North)--Bainbridge Island City & Silverdale PUMA, Washington/WA",88,0,0,0,0,0,88,0,0,0,0,0,88,100,0,0,0,0,0,0,0,100,0,0,0
53,Washington/WA,5311802,"Kitsap County (South)--Bremerton & Port Orchard Cities PUMA, Washington/WA",98,0,0,0,0,0,98,0,0,0,0,0,98,100,0,0,0,0,0,0,0,100,0,0,0
53,Washington/WA,5311900,"Clallam & Jefferson Counties PUMA, Washington/WA",124,51,106,62,0,0,186,51,106,0,157,157,343,36,18,0,46,0,15,0,31,54,46,15,31
54,West Virginia/WV,5400100,"Ohio, Marshall, Hancock & Brooke Counties PUMA, West Virginia/WV",219,0,0,0,0,0,219,0,0,0,0,0,219,100,0,0,0,0,0,0,0,100,0,0,0
54,West Virginia/WV,5400200,"Harrison, Marion, Taylor & Doddridge Counties PUMA, West Virginia/WV",248,0,0,0,0,0,248,0,0,0,0,0,248,100,0,0,0,0,0,0,0,100,0,0,0
54,West Virginia/WV,5400300,"Monongalia & Preston Counties--Morgantown City PUMA, West Virginia/WV",138,0,0,0,0,0,138,0,0,0,0,0,138,100,0,0,0,0,0,0,0,100,0,0,0
54,West Virginia/WV,5400400,"Berkeley, Jefferson, Mineral, Hampshire & Morgan Counties PUMA, West Virginia/WV",654,0,145,4,6,0,658,6,145,6,145,151,809,81,0,1,18,1,0,0,18,81,19,1,18
54,West Virginia/WV,5400500,"Randolph, Upshur, Barbour, Lewis, Hardy, Grant, Pendleton & Tucker Counties PUMA, West Virginia/WV",1109,65,0,67,0,30,1176,65,30,30,65,95,1271,87,5,2,5,0,5,2,0,93,7,5,2
54,West Virginia/WV,5400600,"Jackson, Wetzel, Roane, Braxton, Ritchie, Tyler, Gilmer & Calhoun Counties PUMA, West Virginia/WV",128,0,0,0,0,0,128,0,0,0,0,0,128,100,0,0,0,0,0,0,0,100,0,0,0
54,West Virginia/WV,5400700,"Wood, Pleasants & Wirt Counties PUMA, West Virginia/WV",64,0,0,0,0,0,64,0,0,0,0,0,64,100,0,0,0,0,0,0,0,100,0,0,0
54,West Virginia/WV,5400800,"Cabell, Wayne & Mason Counties--Huntington City PUMA, West Virginia/WV",199,0,0,0,0,0,199,0,0,0,0,0,199,100,0,0,0,0,0,0,0,100,0,0,0
54,West Virginia/WV,5400900,"Putnam, Boone & Lincoln Counties PUMA, West Virginia/WV",18,0,0,0,0,0,18,0,0,0,0,0,18,100,0,0,0,0,0,0,0,100,0,0,0
54,West Virginia/WV,5401000,"Kanawha & Clay Counties--Charleston City PUMA, West Virginia/WV",190,0,0,0,0,0,190,0,0,0,0,0,190,100,0,0,0,0,0,0,0,100,0,0,0
54,West Virginia/WV,5401100,"Greenbrier, Nicholas, Summers, Monroe & Pocahontas Counties PUMA, West Virginia/WV",161,0,75,8,0,0,169,0,75,0,75,75,244,66,3,0,31,0,0,0,31,69,31,0,31
54,West Virginia/WV,5401200,"Raleigh, Mercer & Fayette Counties PUMA, West Virginia/WV",128,0,0,0,0,0,128,0,0,0,0,0,128,100,0,0,0,0,0,0,0,100,0,0,0
54,West Virginia/WV,5401300,"Logan, Mingo, Wyoming & McDowell Counties PUMA, West Virginia/WV",51,0,0,0,0,0,51,0,0,0,0,0,51,100,0,0,0,0,0,0,0,100,0,0,0
55,Wisconsin/WI,5500100,"Northwest Wisconsin PUMA, Wisconsin/WI",2143,43,195,22,0,34,2165,43,229,34,238,272,2437,88,1,1,10,0,2,1,8,89,11,2,9
55,Wisconsin/WI,5500101,"Madison City (Central) PUMA, Wisconsin/WI",293,0,0,0,0,88,293,0,88,88,0,88,381,77,0,23,0,0,0,23,0,77,23,0,23
55,Wisconsin/WI,5500102,"Dane County (East) PUMA, Wisconsin/WI",848,282,405,17,94,75,865,376,480,169,687,856,1721,49,1,10,40,5,16,4,24,50,50,22,28
55,Wisconsin/WI,5500103,"Dane County (West) PUMA, Wisconsin/WI",458,0,121,0,143,0,458,143,121,143,121,264,722,63,0,20,17,20,0,0,17,63,37,20,17
55,Wisconsin/WI,5500200,"Green Bay City PUMA, Wisconsin/WI",701,277,1472,410,22,226,1111,299,1698,248,1749,1997,3108,23,13,8,56,1,9,7,47,36,64,10,55
55,Wisconsin/WI,5500300,"Outer Green Bay City PUMA, Wisconsin/WI",1483,0,315,172,0,0,1655,0,315,0,315,315,1970,75,9,0,16,0,0,0,16,84,16,0,16
55,Wisconsin/WI,5500600,"Oneida, Lincoln, Vilas, Langlade & Forest Counties PUMA, Wisconsin/WI",867,0,88,56,17,0,923,17,88,17,88,105,1028,84,5,2,9,2,0,0,9,90,10,2,9
55,Wisconsin/WI,5500700,"West Central Wisconsin--Northern Mississippi Region PUMA, Wisconsin/WI",3663,31,633,33,77,0,3696,108,633,77,664,741,4437,83,1,2,15,2,1,0,14,83,17,2,14
55,Wisconsin/WI,5500800,"Grant, Green, Iowa, Richland & Lafayette Counties PUMA, Wisconsin/WI",3190,20,274,109,34,122,3299,54,396,156,294,450,3749,85,3,4,8,1,1,3,7,88,12,1,11
55,Wisconsin/WI,5500900,"La Crosse County PUMA, Wisconsin/WI",604,0,0,0,61,0,604,61,0,61,0,61,665,91,0,9,0,9,0,0,0,91,9,9,0
55,Wisconsin/WI,5501000,"Sauk & Columbia Counties PUMA, Wisconsin/WI",1472,0,185,56,0,9,1528,0,194,9,185,194,1722,85,3,1,11,0,0,1,11,89,11,0,11
55,Wisconsin/WI,5501001,"Dodge & Jefferson Counties PUMA, Wisconsin/WI",2194,62,545,6,0,130,2200,62,675,130,607,737,2937,75,0,4,21,0,2,4,19,75,25,2,23
55,Wisconsin/WI,5501300,"Marinette, Oconto, Door & Florence Counties PUMA, Wisconsin/WI",1080,47,173,0,0,0,1080,47,173,0,220,220,1300,83,0,0,17,0,4,0,13,83,17,4,13
55,Wisconsin/WI,5501301,"Manitowoc & Kewaunee Counties PUMA, Wisconsin/WI",1831,22,321,94,27,7,1925,49,328,34,343,377,2302,80,4,1,15,1,1,0,14,84,16,2,14
55,Wisconsin/WI,5501400,"East Central Wisconsin PUMA, Wisconsin/WI",3737,117,407,267,4,15,4004,121,422,19,524,543,4547,82,6,0,12,0,3,0,9,88,12,3,9
55,Wisconsin/WI,5501401,"Fond du Lac & Calumet Counties PUMA, Wisconsin/WI",2821,55,231,71,0,133,2892,55,364,133,286,419,3311,85,2,4,9,0,2,4,7,87,13,2,11
55,Wisconsin/WI,5501500,"Outagamie County PUMA, Wisconsin/WI",1403,121,373,38,74,219,1441,195,592,293,494,787,2228,63,2,13,22,3,5,10,17,65,35,9,27
55,Wisconsin/WI,5501501,"Winnebago County PUMA, Wisconsin/WI",547,0,136,100,0,93,647,0,229,93,136,229,876,62,11,11,16,0,0,11,16,74,26,0,26
55,Wisconsin/WI,5501600,"Marathon County PUMA, Wisconsin/WI",2028,33,569,66,179,69,2094,212,638,248,602,850,2944,69,2,8,20,6,1,2,19,71,29,7,22
55,Wisconsin/WI,5501601,"Central Sands--Wood, Portage, Juneau & Adams Counties PUMA, Wisconsin/WI",3581,6,484,228,54,5,3809,60,489,59,490,549,4358,82,5,1,11,1,0,0,11,87,13,1,11
55,Wisconsin/WI,5502400,"Rock County PUMA, Wisconsin/WI",1997,113,430,225,26,45,2222,139,475,71,543,614,2836,70,8,3,19,1,4,2,15,78,22,5,17
55,Wisconsin/WI,5502500,"Sheboygan County PUMA, Wisconsin/WI",1592,0,252,11,361,28,1603,361,280,389,252,641,2244,71,0,17,11,16,0,1,11,71,29,16,12
55,Wisconsin/WI,5510000,"Kenosha County PUMA, Wisconsin/WI",521,25,184,170,25,0,691,50,184,25,209,234,925,56,18,3,23,3,3,0,20,75,25,5,20
55,Wisconsin/WI,5520000,"Washington & Ozaukee Counties PUMA, Wisconsin/WI",615,0,81,27,0,0,642,0,81,0,81,81,723,85,4,0,11,0,0,0,11,89,11,0,11
55,Wisconsin/WI,5530000,"Racine County PUMA, Wisconsin/WI",857,14,95,226,0,0,1083,14,95,0,109,109,1192,72,19,0,9,0,1,0,8,91,9,1,8
55,Wisconsin/WI,5540101,"Milwaukee County (Northeast) PUMA, Wisconsin/WI",142,0,0,0,0,0,142,0,0,0,0,0,142,100,0,0,0,0,0,0,0,100,0,0,0
55,Wisconsin/WI,5540301,"Milwaukee County (South) PUMA, Wisconsin/WI",215,0,184,56,214,84,271,214,268,298,184,482,753,29,7,40,24,28,0,11,24,36,64,28,36
55,Wisconsin/WI,5540701,"Milwaukee County (West) PUMA, Wisconsin/WI",450,74,31,221,90,0,671,164,31,90,105,195,866,52,26,10,12,10,9,0,4,77,23,19,4
55,Wisconsin/WI,5541001,"Milwaukee City (North) PUMA, Wisconsin/WI",60,0,0,21,0,19,81,0,19,19,0,19,100,60,21,19,0,0,0,19,0,81,19,0,19
55,Wisconsin/WI,5541002,"Milwaukee City (North Central) PUMA, Wisconsin/WI",502,0,57,88,13,0,590,13,57,13,57,70,660,76,13,2,9,2,0,0,9,89,11,2,9
55,Wisconsin/WI,5541003,"Milwaukee City (Central) PUMA, Wisconsin/WI",258,0,0,21,0,57,279,0,57,57,0,57,336,77,6,17,0,0,0,17,0,83,17,0,17
55,Wisconsin/WI,5541004,"Milwaukee City (South Central) PUMA, Wisconsin/WI",174,120,760,470,0,0,644,120,760,0,880,880,1524,11,31,0,58,0,8,0,50,42,58,8,50
55,Wisconsin/WI,5541005,"Milwaukee City (South) PUMA, Wisconsin/WI",190,0,176,205,0,501,395,0,677,501,176,677,1072,18,19,47,16,0,0,47,16,37,63,0,63
55,Wisconsin/WI,5550000,"Walworth County PUMA, Wisconsin/WI",846,72,325,73,144,0,919,216,325,144,397,541,1460,58,5,10,27,10,5,0,22,63,37,15,22
55,Wisconsin/WI,5555101,"Barron, Polk, Clark & Chippewa (North) Counties PUMA, Wisconsin/WI",3750,109,457,141,61,155,3891,170,612,216,566,782,4673,80,3,5,12,1,2,3,10,83,17,4,13
55,Wisconsin/WI,5555102,"St. Croix & Dunn Counties PUMA, Wisconsin/WI",1313,0,140,10,0,0,1323,0,140,0,140,140,1463,90,1,0,10,0,0,0,10,90,10,0,10
55,Wisconsin/WI,5555103,"Eau Claire & Chippewa (South) Counties PUMA, Wisconsin/WI",1270,0,0,0,96,0,1270,96,0,96,0,96,1366,93,0,7,0,7,0,0,0,93,7,7,0
55,Wisconsin/WI,5570101,"Waukesha County (West) PUMA, Wisconsin/WI",198,0,3,0,91,26,198,91,29,117,3,120,318,62,0,37,1,29,0,8,1,62,38,29,9
55,Wisconsin/WI,5570201,"Waukesha County (East) PUMA, Wisconsin/WI",169,0,2,0,29,0,169,29,2,29,2,31,200,84,0,14,1,14,0,0,1,84,16,14,1
55,Wisconsin/WI,5570301,"Waukesha County (Central) PUMA, Wisconsin/WI",420,0,61,33,0,0,453,0,61,0,61,61,514,82,6,0,12,0,0,0,12,88,12,0,12
56,Wyoming/WY,5600100,"Sheridan, Park, Teton, Lincoln & Big Horn Counties PUMA, Wyoming/WY",578,0,21,0,0,0,578,0,21,0,21,21,599,96,0,0,4,0,0,0,4,96,4,0,4
56,Wyoming/WY,5600200,"Campbell, Goshen, Platte, Johnson, Washakie, Weston, Crook & Niobrara Counties PUMA, Wyoming/WY",984,0,65,166,11,0,1150,11,65,11,65,76,1226,80,14,1,5,1,0,0,5,94,6,1,5
56,Wyoming/WY,5600300,"Laramie & Albany Counties PUMA, Wyoming/WY",284,27,0,0,0,0,284,27,0,0,27,27,311,91,0,0,9,0,9,0,0,91,9,9,0
56,Wyoming/WY,5600400,"Natrona, Carbon & Converse Counties PUMA, Wyoming/WY",610,0,74,0,0,0,610,0,74,0,74,74,684,89,0,0,11,0,0,0,11,89,11,0,11
56,Wyoming/WY,5600500,"Sweetwater, Fremont, Uinta, Sublette & Hot Springs Counties--Wind River Reservation PUMA, Wyoming/WY",583,0,3,55,30,0,638,30,3,30,3,33,671,87,8,4,0,4,0,0,0,95,5,4,0
