state_code,state,puma_code,puma,county_code,county,population,cases,deaths,cases_per_100k,deaths_per_100k,allocation_factor,total_native_citizen_non_hispanic,total_naturalized_citizen_hispanic,total_non_citizen_hispanic,total_native_citizen_hispanic,total_naturalized_citizen_non_hispanic,total_non_citizen_non_hispanic,total_native_citizen,total_naturalized_citizen,total_non_citizen,total_foreign_non_hispanic,total_foreign_hispanic,total_foreign,total_employees,pct_native_citizen_non_hispanic,pct_native_citizen_hispanic,pct_total_foreign_non_hispanic,pct_total_foreign_hispanic,pct_naturalized_citizen_non_hispanic,pct_naturalized_citizen_hispanic,pct_non_citizen_non_hispanic,pct_non_citizen_hispanic,pct_native_citizen,pct_total_foreign,pct_naturalized_citizen,pct_non_citizen
01,Alabama/AL,0100100,"Lauderdale, Colbert, Franklin & Marion (Northeast) Counties PUMA, Alabama/AL",01033,"Colbert County, Alabama",54495,1641,26,3011,48,0.292,353,119,117,0,0,0,353,119,117,0,236,236,589,60,0,0,40,0,20,0,20,60,40,20,20
01,Alabama/AL,0100100,"Lauderdale, Colbert, Franklin & Marion (Northeast) Counties PUMA, Alabama/AL",01059,"Franklin County, Alabama",31542,1767,29,5602,92,0.17,206,69,68,0,0,0,206,69,68,0,137,137,343,60,0,0,40,0,20,0,20,60,40,20,20
01,Alabama/AL,0100100,"Lauderdale, Colbert, Franklin & Marion (Northeast) Counties PUMA, Alabama/AL",01077,"Lauderdale County, Alabama",92585,1698,33,1834,36,0.497,601,202,198,0,0,0,601,202,198,0,400,400,1001,60,0,0,40,0,20,0,20,60,40,20,20
01,Alabama/AL,0100100,"Lauderdale, Colbert, Franklin & Marion (Northeast) Counties PUMA, Alabama/AL",01093,"Marion County, Alabama",29965,957,29,3194,97,0.041,50,17,16,0,0,0,50,17,16,0,33,33,83,60,0,0,40,0,20,0,19,60,40,20,19
01,Alabama/AL,0100200,"Limestone & Madison (Outer) Counties--Huntsville City (Far West & Southwest) PUMA, Alabama/AL",01083,"Limestone County, Alabama",93052,2088,20,2244,21,0.494,262,10,33,0,0,0,262,10,33,0,43,43,305,86,0,0,14,0,3,0,11,86,14,3,11
01,Alabama/AL,0100200,"Limestone & Madison (Outer) Counties--Huntsville City (Far West & Southwest) PUMA, Alabama/AL",01089,"Madison County, Alabama",357560,7820,78,2187,22,0.506,268,11,34,0,0,0,268,11,34,0,45,45,313,86,0,0,14,0,4,0,11,86,14,4,11
01,Alabama/AL,0100301,"Huntsville (North) & Madison (East) Cities PUMA, Alabama/AL",01089,"Madison County, Alabama",357560,7820,78,2187,22,1,325,0,0,0,0,0,325,0,0,0,0,0,325,100,0,0,0,0,0,0,0,100,0,0,0
01,Alabama/AL,0100302,"Huntsville City (Central & South) PUMA, Alabama/AL",01089,"Madison County, Alabama",357560,7820,78,2187,22,1,178,0,11,36,0,0,214,0,11,0,11,11,225,79,16,0,5,0,0,0,5,95,5,0,5
01,Alabama/AL,0100400,"DeKalb & Jackson Counties PUMA, Alabama/AL",01049,"DeKalb County, Alabama",71200,2406,20,3379,28,0.576,401,22,363,188,0,0,589,22,363,0,385,385,974,41,19,0,40,0,2,0,37,60,40,2,37
01,Alabama/AL,0100400,"DeKalb & Jackson Counties PUMA, Alabama/AL",01071,"Jackson County, Alabama",52094,1560,11,2995,21,0.424,296,17,268,138,0,0,434,17,268,0,285,285,719,41,19,0,40,0,2,0,37,60,40,2,37
01,Alabama/AL,0100500,"Marshall & Madison (Southeast) Counties--Huntsville City (Far Southeast) PUMA, Alabama/AL",01089,"Madison County, Alabama",357560,7820,78,2187,22,0.221,266,31,197,23,3,65,289,34,262,68,228,296,585,45,4,12,39,1,5,11,34,49,51,6,45
01,Alabama/AL,0100500,"Marshall & Madison (Southeast) Counties--Huntsville City (Far Southeast) PUMA, Alabama/AL",01095,"Marshall County, Alabama",95145,3933,43,4134,45,0.779,936,108,696,82,10,229,1018,118,925,239,804,1043,2061,45,4,12,39,0,5,11,34,49,51,6,45
01,Alabama/AL,0100600,"Morgan & Lawrence Counties--Decatur City PUMA, Alabama/AL",01079,"Lawrence County, Alabama",33171,616,23,1857,69,0.218,234,0,24,15,0,26,249,0,50,26,24,50,299,78,5,9,8,0,0,9,8,83,17,0,17
01,Alabama/AL,0100600,"Morgan & Lawrence Counties--Decatur City PUMA, Alabama/AL",01103,"Morgan County, Alabama",119122,3273,28,2748,24,0.782,841,0,88,53,0,94,894,0,182,94,88,182,1076,78,5,9,8,0,0,9,8,83,17,0,17
01,Alabama/AL,0100700,"Cullman & Winston Counties PUMA, Alabama/AL",01043,"Cullman County, Alabama",82313,1890,20,2296,24,0.776,540,0,47,1,0,0,541,0,47,0,47,47,588,92,0,0,8,0,0,0,8,92,8,0,8
01,Alabama/AL,0100700,"Cullman & Winston Counties PUMA, Alabama/AL",01133,"Winston County, Alabama",23875,738,12,3091,50,0.224,156,0,14,0,0,0,156,0,14,0,14,14,170,92,0,0,8,0,0,0,8,92,8,0,8
01,Alabama/AL,0100800,"St. Clair & Blount Counties PUMA, Alabama/AL",01009,"Blount County, Alabama",57645,1608,15,2789,26,0.396,238,34,52,14,0,0,252,34,52,0,86,86,338,70,4,0,25,0,10,0,15,75,25,10,15
01,Alabama/AL,0100800,"St. Clair & Blount Counties PUMA, Alabama/AL",01115,"St. Clair County, Alabama",87306,2308,35,2644,40,0.604,364,53,79,21,0,0,385,53,79,0,132,132,517,70,4,0,26,0,10,0,15,74,26,10,15
01,Alabama/AL,0100900,"Etowah County PUMA, Alabama/AL",01055,"Etowah County, Alabama",102939,3439,45,3341,44,1,908,45,59,55,6,0,963,51,59,6,104,110,1073,85,5,1,10,1,4,0,5,90,10,5,5
01,Alabama/AL,0101000,"Talladega, Cherokee, Randolph, Cleburne & Clay Counties PUMA, Alabama/AL",01019,"Cherokee County, Alabama",25853,603,13,2332,50,0.164,113,0,0,8,0,0,121,0,0,0,0,0,121,93,7,0,0,0,0,0,0,100,0,0,0
01,Alabama/AL,0101000,"Talladega, Cherokee, Randolph, Cleburne & Clay Counties PUMA, Alabama/AL",01027,"Clay County, Alabama",13378,579,7,4328,52,0.086,59,0,0,4,0,0,63,0,0,0,0,0,63,94,6,0,0,0,0,0,0,100,0,0,0
01,Alabama/AL,0101000,"Talladega, Cherokee, Randolph, Cleburne & Clay Counties PUMA, Alabama/AL",01029,"Cleburne County, Alabama",14938,364,6,2437,40,0.095,66,0,0,4,0,0,70,0,0,0,0,0,70,94,6,0,0,0,0,0,0,100,0,0,0
01,Alabama/AL,0101000,"Talladega, Cherokee, Randolph, Cleburne & Clay Counties PUMA, Alabama/AL",01111,"Randolph County, Alabama",22574,642,13,2844,58,0.144,100,0,0,7,0,0,107,0,0,0,0,0,107,93,7,0,0,0,0,0,0,100,0,0,0
01,Alabama/AL,0101000,"Talladega, Cherokee, Randolph, Cleburne & Clay Counties PUMA, Alabama/AL",01121,"Talladega County, Alabama",80565,2146,28,2664,35,0.511,353,0,0,24,0,0,377,0,0,0,0,0,377,94,6,0,0,0,0,0,0,100,0,0,0
01,Alabama/AL,0101100,"Calhoun County PUMA, Alabama/AL",01015,"Calhoun County, Alabama",115098,3499,42,3040,36,1,574,0,47,4,0,0,578,0,47,0,47,47,625,92,1,0,8,0,0,0,8,92,8,0,8
01,Alabama/AL,0101200,"Shelby County PUMA, Alabama/AL",01117,"Shelby County, Alabama",211261,5923,49,2804,23,1,123,0,116,0,0,0,123,0,116,0,116,116,239,51,0,0,49,0,0,0,49,51,49,0,49
01,Alabama/AL,0101301,"Birmingham City (West) PUMA, Alabama/AL",01073,"Jefferson County, Alabama",659892,19572,348,2966,53,1,203,0,19,0,0,0,203,0,19,0,19,19,222,91,0,0,9,0,0,0,9,91,9,0,9
01,Alabama/AL,0101302,"Birmingham City (East) PUMA, Alabama/AL",01073,"Jefferson County, Alabama",659892,19572,348,2966,53,1,234,0,109,0,0,0,234,0,109,0,109,109,343,68,0,0,32,0,0,0,32,68,32,0,32
01,Alabama/AL,0101303,"Jefferson County (Southeast)--Hoover (North), Vestavia Hills & Homewood Cities PUMA, Alabama/AL",01073,"Jefferson County, Alabama",659892,19572,348,2966,53,1,136,0,33,13,0,0,149,0,33,0,33,33,182,75,7,0,18,0,0,0,18,82,18,0,18
01,Alabama/AL,0101304,"Jefferson County (Northeast)--Trussville, Center Point & Gardendale Cities PUMA, Alabama/AL",01073,"Jefferson County, Alabama",659892,19572,348,2966,53,1,363,17,0,0,0,0,363,17,0,0,17,17,380,96,0,0,4,0,4,0,0,96,4,4,0
01,Alabama/AL,0101305,"Jefferson County (West)--Bessemer, Hueytown & Pleasant Grove Cities PUMA, Alabama/AL",01073,"Jefferson County, Alabama",659892,19572,348,2966,53,1,74,0,0,0,0,0,74,0,0,0,0,0,74,100,0,0,0,0,0,0,0,100,0,0,0
01,Alabama/AL,0101400,"Walker, Marion (South & West), Fayette & Lamar Counties PUMA, Alabama/AL",01057,"Fayette County, Alabama",16585,450,8,2713,48,0.14,47,0,0,0,0,0,47,0,0,0,0,0,47,100,0,0,0,0,0,0,0,100,0,0,0
01,Alabama/AL,0101400,"Walker, Marion (South & West), Fayette & Lamar Counties PUMA, Alabama/AL",01075,"Lamar County, Alabama",13933,366,2,2627,14,0.118,40,0,0,0,0,0,40,0,0,0,0,0,40,100,0,0,0,0,0,0,0,100,0,0,0
01,Alabama/AL,0101400,"Walker, Marion (South & West), Fayette & Lamar Counties PUMA, Alabama/AL",01093,"Marion County, Alabama",29965,957,29,3194,97,0.19,64,0,0,0,0,0,64,0,0,0,0,0,64,100,0,0,0,0,0,0,0,100,0,0,0
01,Alabama/AL,0101400,"Walker, Marion (South & West), Fayette & Lamar Counties PUMA, Alabama/AL",01127,"Walker County, Alabama",64493,2306,83,3576,129,0.552,187,0,0,0,0,0,187,0,0,0,0,0,187,100,0,0,0,0,0,0,0,100,0,0,0
01,Alabama/AL,0101500,"Tuscaloosa (Outer) & Pickens Counties--Northport City (North & West) PUMA, Alabama/AL",01107,"Pickens County, Alabama",20298,656,14,3232,69,0.186,65,2,0,0,0,0,65,2,0,0,2,2,67,97,0,0,3,0,3,0,0,97,3,3,0
01,Alabama/AL,0101500,"Tuscaloosa (Outer) & Pickens Counties--Northport City (North & West) PUMA, Alabama/AL",01125,"Tuscaloosa County, Alabama",206213,8586,117,4164,57,0.814,287,8,0,0,0,0,287,8,0,0,8,8,295,97,0,0,3,0,3,0,0,97,3,3,0
01,Alabama/AL,0101600,"Tuscaloosa & Northport (Southeast) Cities PUMA, Alabama/AL",01125,"Tuscaloosa County, Alabama",206213,8586,117,4164,57,1,247,0,0,0,0,0,247,0,0,0,0,0,247,100,0,0,0,0,0,0,0,100,0,0,0
01,Alabama/AL,0101700,"Dallas, Bibb, Marengo, Hale, Sumter, Perry & Greene Counties PUMA, Alabama/AL",01007,"Bibb County, Alabama",22527,652,10,2894,44,0.176,153,0,1,1,0,0,154,0,1,0,1,1,155,99,1,0,1,0,0,0,1,99,1,0,1
01,Alabama/AL,0101700,"Dallas, Bibb, Marengo, Hale, Sumter, Perry & Greene Counties PUMA, Alabama/AL",01047,"Dallas County, Alabama",40029,1783,26,4454,65,0.312,271,0,2,1,0,0,272,0,2,0,2,2,274,99,0,0,1,0,0,0,1,99,1,0,1
01,Alabama/AL,0101700,"Dallas, Bibb, Marengo, Hale, Sumter, Perry & Greene Counties PUMA, Alabama/AL",01063,"Greene County, Alabama",8426,303,15,3596,178,0.066,57,0,0,0,0,0,57,0,0,0,0,0,57,100,0,0,0,0,0,0,0,100,0,0,0
01,Alabama/AL,0101700,"Dallas, Bibb, Marengo, Hale, Sumter, Perry & Greene Counties PUMA, Alabama/AL",01065,"Hale County, Alabama",14887,634,28,4259,188,0.117,102,0,1,0,0,0,102,0,1,0,1,1,103,99,0,0,1,0,0,0,1,99,1,0,1
01,Alabama/AL,0101700,"Dallas, Bibb, Marengo, Hale, Sumter, Perry & Greene Counties PUMA, Alabama/AL",01091,"Marengo County, Alabama",19538,716,20,3665,102,0.153,133,0,1,1,0,0,134,0,1,0,1,1,135,99,1,0,1,0,0,0,1,99,1,0,1
01,Alabama/AL,0101700,"Dallas, Bibb, Marengo, Hale, Sumter, Perry & Greene Counties PUMA, Alabama/AL",01105,"Perry County, Alabama",9486,541,6,5703,63,0.075,65,0,0,0,0,0,65,0,0,0,0,0,65,100,0,0,0,0,0,0,0,100,0,0,0
01,Alabama/AL,0101700,"Dallas, Bibb, Marengo, Hale, Sumter, Perry & Greene Counties PUMA, Alabama/AL",01119,"Sumter County, Alabama",12985,435,19,3350,146,0.102,89,0,1,0,0,0,89,0,1,0,1,1,90,99,0,0,1,0,0,0,1,99,1,0,1
01,Alabama/AL,0101800,"Chilton, Tallapoosa, Chambers & Coosa Counties PUMA, Alabama/AL",01017,"Chambers County, Alabama",33826,1161,42,3432,124,0.262,91,0,0,0,0,0,91,0,0,0,0,0,91,100,0,0,0,0,0,0,0,100,0,0,0
01,Alabama/AL,0101800,"Chilton, Tallapoosa, Chambers & Coosa Counties PUMA, Alabama/AL",01021,"Chilton County, Alabama",43930,1564,31,3560,71,0.34,118,0,0,0,0,0,118,0,0,0,0,0,118,100,0,0,0,0,0,0,0,100,0,0,0
01,Alabama/AL,0101800,"Chilton, Tallapoosa, Chambers & Coosa Counties PUMA, Alabama/AL",01037,"Coosa County, Alabama",10855,168,3,1548,28,0.082,29,0,0,0,0,0,29,0,0,0,0,0,29,100,0,0,0,0,0,0,0,100,0,0,0
01,Alabama/AL,0101800,"Chilton, Tallapoosa, Chambers & Coosa Counties PUMA, Alabama/AL",01123,"Tallapoosa County, Alabama",40636,1156,85,2845,209,0.315,110,0,0,0,0,0,110,0,0,0,0,0,110,100,0,0,0,0,0,0,0,100,0,0,0
01,Alabama/AL,0101900,"Lee County--Auburn City PUMA, Alabama/AL",01081,"Lee County, Alabama",159287,5887,59,3696,37,1,600,0,65,0,0,0,600,0,65,0,65,65,665,90,0,0,10,0,0,0,10,90,10,0,10
01,Alabama/AL,0102000,"Montgomery City & Pike Road Town (North) PUMA, Alabama/AL",01101,"Montgomery County, Alabama",226941,8811,183,3883,81,1,311,0,0,23,0,0,334,0,0,0,0,0,334,93,7,0,0,0,0,0,0,100,0,0,0
01,Alabama/AL,0102100,"Elmore, Autauga, Montgomery (Outer) & Lowndes Counties PUMA, Alabama/AL",01001,"Autauga County, Alabama",55200,1757,25,3183,45,0.308,100,0,3,0,5,10,100,5,13,15,3,18,118,85,0,13,3,4,0,8,3,85,15,4,11
01,Alabama/AL,0102100,"Elmore, Autauga, Montgomery (Outer) & Lowndes Counties PUMA, Alabama/AL",01051,"Elmore County, Alabama",81212,2659,47,3274,58,0.455,147,0,5,0,7,15,147,7,20,22,5,27,174,84,0,13,3,4,0,9,3,84,16,4,11
01,Alabama/AL,0102100,"Elmore, Autauga, Montgomery (Outer) & Lowndes Counties PUMA, Alabama/AL",01085,"Lowndes County, Alabama",10236,653,27,6379,264,0.058,19,0,1,0,1,2,19,1,3,3,1,4,23,83,0,13,4,4,0,9,4,83,17,4,13
01,Alabama/AL,0102100,"Elmore, Autauga, Montgomery (Outer) & Lowndes Counties PUMA, Alabama/AL",01101,"Montgomery County, Alabama",226941,8811,183,3883,81,0.18,58,0,2,0,3,6,58,3,8,9,2,11,69,84,0,13,3,4,0,9,3,84,16,4,12
01,Alabama/AL,0102200,"Southwest Alabama PUMA, Alabama/AL",01023,"Choctaw County, Alabama",13075,349,12,2669,92,0.095,32,0,0,3,0,0,35,0,0,0,0,0,35,91,9,0,0,0,0,0,0,100,0,0,0
01,Alabama/AL,0102200,"Southwest Alabama PUMA, Alabama/AL",01025,"Clarke County, Alabama",24387,1089,16,4465,66,0.178,60,0,0,5,0,0,65,0,0,0,0,0,65,92,8,0,0,0,0,0,0,100,0,0,0
01,Alabama/AL,0102200,"Southwest Alabama PUMA, Alabama/AL",01035,"Conecuh County, Alabama",12514,535,11,4275,88,0.091,31,0,0,2,0,0,33,0,0,0,0,0,33,94,6,0,0,0,0,0,0,100,0,0,0
01,Alabama/AL,0102200,"Southwest Alabama PUMA, Alabama/AL",01053,"Escambia County, Alabama",37328,1603,24,4294,64,0.276,93,0,0,7,0,0,100,0,0,0,0,0,100,93,7,0,0,0,0,0,0,100,0,0,0
01,Alabama/AL,0102200,"Southwest Alabama PUMA, Alabama/AL",01099,"Monroe County, Alabama",21512,584,8,2715,37,0.157,53,0,0,4,0,0,57,0,0,0,0,0,57,93,7,0,0,0,0,0,0,100,0,0,0
01,Alabama/AL,0102200,"Southwest Alabama PUMA, Alabama/AL",01129,"Washington County, Alabama",16643,556,13,3341,78,0.123,42,0,0,3,0,0,45,0,0,0,0,0,45,93,7,0,0,0,0,0,0,100,0,0,0
01,Alabama/AL,0102200,"Southwest Alabama PUMA, Alabama/AL",01131,"Wilcox County, Alabama",10809,531,11,4913,102,0.08,27,0,0,2,0,0,29,0,0,0,0,0,29,93,7,0,0,0,0,0,0,100,0,0,0
01,Alabama/AL,0102300,"Coffee, Covington, Butler & Crenshaw Counties PUMA, Alabama/AL",01013,"Butler County, Alabama",20025,916,39,4574,195,0.163,223,0,2,5,0,0,228,0,2,0,2,2,230,97,2,0,1,0,0,0,1,99,1,0,1
01,Alabama/AL,0102300,"Coffee, Covington, Butler & Crenshaw Counties PUMA, Alabama/AL",01031,"Coffee County, Alabama",51288,1320,6,2574,12,0.418,573,0,6,13,0,0,586,0,6,0,6,6,592,97,2,0,1,0,0,0,1,99,1,0,1
01,Alabama/AL,0102300,"Coffee, Covington, Butler & Crenshaw Counties PUMA, Alabama/AL",01039,"Covington County, Alabama",37351,1385,27,3708,72,0.306,420,0,4,9,0,0,429,0,4,0,4,4,433,97,2,0,1,0,0,0,1,99,1,0,1
01,Alabama/AL,0102300,"Coffee, Covington, Butler & Crenshaw Counties PUMA, Alabama/AL",01041,"Crenshaw County, Alabama",13865,536,32,3866,231,0.113,155,0,2,3,0,0,158,0,2,0,2,2,160,97,2,0,1,0,0,0,1,99,1,0,1
01,Alabama/AL,0102400,"Russell, Pike, Barbour, Macon & Bullock Counties PUMA, Alabama/AL",01005,"Barbour County, Alabama",25782,873,7,3386,27,0.177,312,0,0,5,0,0,317,0,0,0,0,0,317,98,2,0,0,0,0,0,0,100,0,0,0
01,Alabama/AL,0102400,"Russell, Pike, Barbour, Macon & Bullock Counties PUMA, Alabama/AL",01011,"Bullock County, Alabama",10352,599,14,5786,135,0.071,125,0,0,2,0,0,127,0,0,0,0,0,127,98,2,0,0,0,0,0,0,100,0,0,0
01,Alabama/AL,0102400,"Russell, Pike, Barbour, Macon & Bullock Counties PUMA, Alabama/AL",01087,"Macon County, Alabama",19054,481,19,2524,100,0.129,227,0,0,4,0,0,231,0,0,0,0,0,231,98,2,0,0,0,0,0,0,100,0,0,0
01,Alabama/AL,0102400,"Russell, Pike, Barbour, Macon & Bullock Counties PUMA, Alabama/AL",01109,"Pike County, Alabama",33403,1194,10,3575,30,0.227,400,0,0,7,0,0,407,0,0,0,0,0,407,98,2,0,0,0,0,0,0,100,0,0,0
01,Alabama/AL,0102400,"Russell, Pike, Barbour, Macon & Bullock Counties PUMA, Alabama/AL",01113,"Russell County, Alabama",58213,1757,3,3018,5,0.396,697,0,0,12,0,0,709,0,0,0,0,0,709,98,2,0,0,0,0,0,0,100,0,0,0
01,Alabama/AL,0102500,"Houston, Dale, Geneva & Henry Counties--Dothan City PUMA, Alabama/AL",01045,"Dale County, Alabama",49255,1358,44,2757,89,0.25,390,2,6,24,1,20,414,3,26,21,8,29,443,88,5,5,2,0,0,5,1,93,7,1,6
01,Alabama/AL,0102500,"Houston, Dale, Geneva & Henry Counties--Dothan City PUMA, Alabama/AL",01061,"Geneva County, Alabama",26491,607,4,2291,15,0.135,210,1,3,13,1,11,223,2,14,12,4,16,239,88,5,5,2,0,0,5,1,93,7,1,6
01,Alabama/AL,0102500,"Houston, Dale, Geneva & Henry Counties--Dothan City PUMA, Alabama/AL",01067,"Henry County, Alabama",17124,493,5,2879,29,0.087,136,1,2,8,0,7,144,1,9,7,3,10,154,88,5,5,2,0,1,5,1,94,6,1,6
01,Alabama/AL,0102500,"Houston, Dale, Geneva & Henry Counties--Dothan City PUMA, Alabama/AL",01069,"Houston County, Alabama",104352,2802,21,2685,20,0.528,823,4,12,51,3,41,874,7,53,44,16,60,934,88,5,5,2,0,0,4,1,94,6,1,6
01,Alabama/AL,0102600,"Baldwin County PUMA, Alabama/AL",01003,"Baldwin County, Alabama",208107,5456,50,2622,24,1,350,0,0,9,0,0,359,0,0,0,0,0,359,97,3,0,0,0,0,0,0,100,0,0,0
01,Alabama/AL,0102701,"Mobile City (East) PUMA, Alabama/AL",01097,"Mobile County, Alabama",414659,13320,292,3212,70,1,79,0,0,0,0,0,79,0,0,0,0,0,79,100,0,0,0,0,0,0,0,100,0,0,0
01,Alabama/AL,0102702,"Mobile City (West) PUMA, Alabama/AL",01097,"Mobile County, Alabama",414659,13320,292,3212,70,1,96,0,0,0,0,67,96,0,67,67,0,67,163,59,0,41,0,0,0,41,0,59,41,0,41
01,Alabama/AL,0102703,"Mobile County (Outer)--Prichard City, Tillmans Corner & Saraland City PUMA, Alabama/AL",01097,"Mobile County, Alabama",414659,13320,292,3212,70,1,522,0,0,0,87,20,522,87,20,107,0,107,629,83,0,17,0,14,0,3,0,83,17,14,3
02,Alaska/AK,0200101,"Anchorage Municipality (North) PUMA, Alaska/AK",02020,"Anchorage Municipality, Alaska",296112,4224,31,1426,10,1,28,0,0,0,0,0,28,0,0,0,0,0,28,100,0,0,0,0,0,0,0,100,0,0,0
02,Alaska/AK,0200102,"Anchorage Municipality (South) PUMA, Alaska/AK",02020,"Anchorage Municipality, Alaska",296112,4224,31,1426,10,1,162,29,0,0,0,30,162,29,30,30,29,59,221,73,0,14,13,0,13,14,0,73,27,13,14
02,Alaska/AK,0200200,"Matanuska-Susitna & Kenai Peninsula Boroughs PUMA, Alaska/AK",02122,"Kenai Peninsula Borough, Alaska",58220,615,1,1056,2,0.359,67,1,0,4,0,30,71,1,30,30,1,31,102,66,4,29,1,0,1,29,0,70,30,1,29
02,Alaska/AK,0200200,"Matanuska-Susitna & Kenai Peninsula Boroughs PUMA, Alaska/AK",02170,"Matanuska-Susitna Borough, Alaska",103464,604,2,584,2,0.641,119,3,0,8,1,54,127,4,54,55,3,58,185,64,4,30,2,1,2,29,0,69,31,2,29
02,Alaska/AK,0200300,"Greater Fairbanks, Greater Juneau, Ketchikan Gateway Borough & Road-Connected Alaska PUMA, Alaska/AK",02068,"Denali Borough, Alaska",2232,7,0,314,0,0.012,3,0,0,0,2,3,3,2,3,5,0,5,8,38,0,62,0,25,0,38,0,38,62,25,38
02,Alaska/AK,0200300,"Greater Fairbanks, Greater Juneau, Ketchikan Gateway Borough & Road-Connected Alaska PUMA, Alaska/AK",02090,"Fairbanks North Star Borough, Alaska",99653,1097,11,1101,11,0.597,149,0,0,0,110,136,149,110,136,246,0,246,395,38,0,62,0,28,0,34,0,38,62,28,34
02,Alaska/AK,0200300,"Greater Fairbanks, Greater Juneau, Ketchikan Gateway Borough & Road-Connected Alaska PUMA, Alaska/AK",02100,"Haines Borough, Alaska",2518,10,0,397,0,0.015,4,0,0,0,3,3,4,3,3,6,0,6,10,40,0,60,0,30,0,30,0,40,60,30,30
02,Alaska/AK,0200300,"Greater Fairbanks, Greater Juneau, Ketchikan Gateway Borough & Road-Connected Alaska PUMA, Alaska/AK",02110,"Juneau City and Borough, Alaska",32330,366,0,1132,0,0.193,48,0,0,0,36,44,48,36,44,80,0,80,128,38,0,62,0,28,0,34,0,38,62,28,34
02,Alaska/AK,0200300,"Greater Fairbanks, Greater Juneau, Ketchikan Gateway Borough & Road-Connected Alaska PUMA, Alaska/AK",02130,"Ketchikan Gateway Borough, Alaska",13804,68,0,493,0,0.082,20,0,0,0,15,19,20,15,19,34,0,34,54,37,0,63,0,28,0,35,0,37,63,28,35
02,Alaska/AK,0200300,"Greater Fairbanks, Greater Juneau, Ketchikan Gateway Borough & Road-Connected Alaska PUMA, Alaska/AK",02240,"Southeast Fairbanks Census Area, Alaska",6876,38,0,553,0,0.041,10,0,0,0,8,9,10,8,9,17,0,17,27,37,0,63,0,30,0,33,0,37,63,30,33
02,Alaska/AK,0200300,"Greater Fairbanks, Greater Juneau, Ketchikan Gateway Borough & Road-Connected Alaska PUMA, Alaska/AK",02261,"Valdez-Cordova Census Area, Alaska",9301,124,0,1333,0,0.055,14,0,0,0,10,12,14,10,12,22,0,22,36,39,0,61,0,28,0,33,0,39,61,28,33
02,Alaska/AK,0200300,"Greater Fairbanks, Greater Juneau, Ketchikan Gateway Borough & Road-Connected Alaska PUMA, Alaska/AK",02230,"Skagway Municipality, Alaska",1061,NA,NA,NA,NA,0.006,2,0,0,0,1,1,2,1,1,2,0,2,4,50,0,50,0,25,0,25,0,50,50,25,25
02,Alaska/AK,0200400,"Subsistence Alaska PUMA, Alaska/AK",02013,"Aleutians East Borough, Alaska",3425,11,0,321,0,0.029,12,4,14,1,14,59,13,18,73,73,18,91,104,12,1,70,17,13,4,57,13,12,88,17,70
02,Alaska/AK,0200400,"Subsistence Alaska PUMA, Alaska/AK",02016,"Aleutians West Census Area, Alaska",5750,95,0,1652,0,0.05,20,6,24,2,23,101,22,29,125,124,30,154,176,11,1,70,17,13,3,57,14,12,88,16,71
02,Alaska/AK,0200400,"Subsistence Alaska PUMA, Alaska/AK",02050,"Bethel Census Area, Alaska",18040,110,1,610,6,0.16,64,21,77,6,75,324,70,96,401,399,98,497,567,11,1,70,17,13,4,57,14,12,88,17,71
02,Alaska/AK,0200400,"Subsistence Alaska PUMA, Alaska/AK",02060,"Bristol Bay Borough, Alaska",890,76,0,8539,0,0.008,3,1,4,0,4,16,3,5,20,20,5,25,28,11,0,71,18,14,4,57,14,11,89,18,71
02,Alaska/AK,0200400,"Subsistence Alaska PUMA, Alaska/AK",02070,"Dillingham Census Area, Alaska",4975,29,0,583,0,0.044,18,6,21,2,21,89,20,27,110,110,27,137,157,11,1,70,17,13,4,57,13,13,87,17,70
02,Alaska/AK,0200400,"Subsistence Alaska PUMA, Alaska/AK",02150,"Kodiak Island Borough, Alaska",13649,65,0,476,0,0.122,49,16,59,5,57,247,54,73,306,304,75,379,433,11,1,70,17,13,4,57,14,12,88,17,71
02,Alaska/AK,0200400,"Subsistence Alaska PUMA, Alaska/AK",02164,"Lake and Peninsula Borough, Alaska",1375,5,0,364,0,0.014,6,2,7,1,7,28,7,9,35,35,9,44,51,12,2,69,18,14,4,55,14,14,86,18,69
02,Alaska/AK,0200400,"Subsistence Alaska PUMA, Alaska/AK",02180,"Nome Census Area, Alaska",9925,68,0,685,0,0.088,35,11,43,3,41,178,38,52,221,219,54,273,311,11,1,70,17,13,4,57,14,12,88,17,71
02,Alaska/AK,0200400,"Subsistence Alaska PUMA, Alaska/AK",02185,"North Slope Borough, Alaska",9797,122,0,1245,0,0.086,34,11,42,3,40,174,37,51,216,214,53,267,304,11,1,70,17,13,4,57,14,12,88,17,71
02,Alaska/AK,0200400,"Subsistence Alaska PUMA, Alaska/AK",02188,"Northwest Arctic Borough, Alaska",7734,107,0,1384,0,0.068,27,9,33,3,32,138,30,41,171,170,42,212,242,11,1,70,17,13,4,57,14,12,88,17,71
02,Alaska/AK,0200400,"Subsistence Alaska PUMA, Alaska/AK",02195,"Petersburg Borough, Alaska",3255,10,0,307,0,0.028,11,4,14,1,13,57,12,17,71,70,18,88,100,11,1,70,18,13,4,57,14,12,88,17,71
02,Alaska/AK,0200400,"Subsistence Alaska PUMA, Alaska/AK",02198,"Prince of Wales-Hyder Census Area, Alaska",6474,31,0,479,0,0.057,23,7,28,2,27,115,25,34,143,142,35,177,202,11,1,70,17,13,3,57,14,12,88,17,71
02,Alaska/AK,0200400,"Subsistence Alaska PUMA, Alaska/AK",02220,"Sitka City and Borough, Alaska",8738,60,0,687,0,0.079,32,10,38,3,37,160,35,47,198,197,48,245,280,11,1,70,17,13,4,57,14,12,88,17,71
02,Alaska/AK,0200400,"Subsistence Alaska PUMA, Alaska/AK",02275,"Wrangell City and Borough, Alaska",2484,19,0,765,0,0.021,8,3,10,1,10,43,9,13,53,53,13,66,75,11,1,71,17,13,4,57,13,12,88,17,71
02,Alaska/AK,0200400,"Subsistence Alaska PUMA, Alaska/AK",02290,"Yukon-Koyukuk Census Area, Alaska",5415,82,2,1514,37,0.049,20,6,24,2,23,99,22,29,123,122,30,152,174,11,1,70,17,13,3,57,14,13,87,17,71
02,Alaska/AK,0200400,"Subsistence Alaska PUMA, Alaska/AK",02105,"Hoonah-Angoon Census Area, Alaska",2132,NA,NA,NA,NA,0.019,8,2,9,1,9,38,9,11,47,47,11,58,67,12,1,70,16,13,3,57,13,13,87,16,70
02,Alaska/AK,0200400,"Subsistence Alaska PUMA, Alaska/AK",02282,"Yakutat City and Borough, Alaska",689,NA,NA,NA,NA,0.005,2,1,2,0,2,10,2,3,12,12,3,15,17,12,0,71,18,12,6,59,12,12,88,18,71
02,Alaska/AK,0200400,"Subsistence Alaska PUMA, Alaska/AK",02270,NA,NA,NA,NA,NA,NA,0.072,29,9,35,3,34,146,32,43,181,180,44,224,256,11,1,70,17,13,4,57,14,12,88,17,71
04,Arizona/AZ,0400100,"Maricopa County--Gilbert (South) & Queen Creek Towns PUMA, Arizona/AZ",04013,"Maricopa County, Arizona",4253913,140753,3343,3309,79,1,56,28,55,0,18,0,56,46,55,18,83,101,157,36,0,11,53,11,18,0,35,36,64,29,35
04,Arizona/AZ,0400101,"Maricopa County--Mesa City (East) PUMA, Arizona/AZ",04013,"Maricopa County, Arizona",4253913,140753,3343,3309,79,1,24,2,64,97,21,0,121,23,64,21,66,87,208,12,47,10,32,10,1,0,31,58,42,11,31
04,Arizona/AZ,0400102,"Maricopa County--Mesa City (North Central) PUMA, Arizona/AZ",04013,"Maricopa County, Arizona",4253913,140753,3343,3309,79,1,17,0,4,84,43,0,101,43,4,43,4,47,148,11,57,29,3,29,0,0,3,68,32,29,3
04,Arizona/AZ,0400103,"Maricopa County--Mesa City (West) PUMA, Arizona/AZ",04013,"Maricopa County, Arizona",4253913,140753,3343,3309,79,1,34,0,56,126,37,0,160,37,56,37,56,93,253,13,50,15,22,15,0,0,22,63,37,15,22
04,Arizona/AZ,0400104,"Maricopa County--Mesa City (South Central) PUMA, Arizona/AZ",04013,"Maricopa County, Arizona",4253913,140753,3343,3309,79,1,116,0,138,0,0,0,116,0,138,0,138,138,254,46,0,0,54,0,0,0,54,46,54,0,54
04,Arizona/AZ,0400105,"Maricopa County--Gilbert Town (North) PUMA, Arizona/AZ",04013,"Maricopa County, Arizona",4253913,140753,3343,3309,79,1,49,0,5,68,0,0,117,0,5,0,5,5,122,40,56,0,4,0,0,0,4,96,4,0,4
04,Arizona/AZ,0400106,"Maricopa County--Chandler City (Northeast) PUMA, Arizona/AZ",04013,"Maricopa County, Arizona",4253913,140753,3343,3309,79,1,0,85,44,16,0,31,16,85,75,31,129,160,176,0,9,18,73,0,48,18,25,9,91,48,43
04,Arizona/AZ,0400107,"Maricopa County--Chandler City (South) PUMA, Arizona/AZ",04013,"Maricopa County, Arizona",4253913,140753,3343,3309,79,1,72,0,0,63,0,0,135,0,0,0,0,0,135,53,47,0,0,0,0,0,0,100,0,0,0
04,Arizona/AZ,0400108,"Maricopa County--Tempe (South) & Chandler (Northwest) Cities PUMA, Arizona/AZ",04013,"Maricopa County, Arizona",4253913,140753,3343,3309,79,1,80,0,19,25,42,0,105,42,19,42,19,61,166,48,15,25,11,25,0,0,11,63,37,25,11
04,Arizona/AZ,0400109,"Maricopa County--Tempe City (North) PUMA, Arizona/AZ",04013,"Maricopa County, Arizona",4253913,140753,3343,3309,79,1,71,0,102,0,0,20,71,0,122,20,102,122,193,37,0,10,53,0,0,10,53,37,63,0,63
04,Arizona/AZ,0400110,"Maricopa County--Scottsdale City (Southwest) & Paradise Valley Town PUMA, Arizona/AZ",04013,"Maricopa County, Arizona",4253913,140753,3343,3309,79,1,0,0,105,53,0,0,53,0,105,0,105,105,158,0,34,0,66,0,0,0,66,34,66,0,66
04,Arizona/AZ,0400111,"Maricopa County (Northeast)--Scottsdale City (Southeast) & Fountain Hills Town PUMA, Arizona/AZ",04013,"Maricopa County, Arizona",4253913,140753,3343,3309,79,1,60,23,59,44,0,0,104,23,59,0,82,82,186,32,24,0,44,0,12,0,32,56,44,12,32
04,Arizona/AZ,0400112,"Maricopa County--Scottsdale (North), Phoenix (Far Northeast) Cities & Cave Creek PUMA, Arizona/AZ",04013,"Maricopa County, Arizona",4253913,140753,3343,3309,79,1,28,61,0,0,0,0,28,61,0,0,61,61,89,31,0,0,69,0,69,0,0,31,69,69,0
04,Arizona/AZ,0400113,"Phoenix City (Northeast) PUMA, Arizona/AZ",04013,"Maricopa County, Arizona",4253913,140753,3343,3309,79,1,38,0,121,0,0,0,38,0,121,0,121,121,159,24,0,0,76,0,0,0,76,24,76,0,76
04,Arizona/AZ,0400114,"Phoenix City (Northeast Central) PUMA, Arizona/AZ",04013,"Maricopa County, Arizona",4253913,140753,3343,3309,79,1,0,0,61,0,0,0,0,0,61,0,61,61,61,0,0,0,100,0,0,0,100,0,100,0,100
04,Arizona/AZ,0400115,"Phoenix City (Northwest Central) PUMA, Arizona/AZ",04013,"Maricopa County, Arizona",4253913,140753,3343,3309,79,1,176,0,89,126,41,0,302,41,89,41,89,130,432,41,29,9,21,9,0,0,21,70,30,9,21
04,Arizona/AZ,0400116,"Phoenix City (Uptown) PUMA, Arizona/AZ",04013,"Maricopa County, Arizona",4253913,140753,3343,3309,79,1,7,0,189,84,32,121,91,32,310,153,189,342,433,2,19,35,44,7,0,28,44,21,79,7,72
04,Arizona/AZ,0400117,"Phoenix City (East) PUMA, Arizona/AZ",04013,"Maricopa County, Arizona",4253913,140753,3343,3309,79,1,0,0,92,31,0,0,31,0,92,0,92,92,123,0,25,0,75,0,0,0,75,25,75,0,75
04,Arizona/AZ,0400118,"Phoenix City--Downtown & Sky Harbor International Airport PUMA, Arizona/AZ",04013,"Maricopa County, Arizona",4253913,140753,3343,3309,79,1,43,70,172,153,30,0,196,100,172,30,242,272,468,9,33,6,52,6,15,0,37,42,58,21,37
04,Arizona/AZ,0400119,"Phoenix City (South) PUMA, Arizona/AZ",04013,"Maricopa County, Arizona",4253913,140753,3343,3309,79,1,38,0,338,84,0,0,122,0,338,0,338,338,460,8,18,0,73,0,0,0,73,27,73,0,73
04,Arizona/AZ,0400120,"Phoenix City--Ahwatukee & South Mountain PUMA, Arizona/AZ",04013,"Maricopa County, Arizona",4253913,140753,3343,3309,79,1,110,0,2,0,0,0,110,0,2,0,2,2,112,98,0,0,2,0,0,0,2,98,2,0,2
04,Arizona/AZ,0400121,"Phoenix (Southwest) & Tolleson Cities PUMA, Arizona/AZ",04013,"Maricopa County, Arizona",4253913,140753,3343,3309,79,1,108,146,328,166,0,15,274,146,343,15,474,489,763,14,22,2,62,0,19,2,43,36,64,19,45
04,Arizona/AZ,0400122,"Phoenix City--Maryvale (East) PUMA, Arizona/AZ",04013,"Maricopa County, Arizona",4253913,140753,3343,3309,79,1,67,6,271,121,0,0,188,6,271,0,277,277,465,14,26,0,60,0,1,0,58,40,60,1,58
04,Arizona/AZ,0400123,"Phoenix City--Maryvale (West) PUMA, Arizona/AZ",04013,"Maricopa County, Arizona",4253913,140753,3343,3309,79,1,80,155,648,394,0,0,474,155,648,0,803,803,1277,6,31,0,63,0,12,0,51,37,63,12,51
04,Arizona/AZ,0400124,"Maricopa County--Glendale City (South) PUMA, Arizona/AZ",04013,"Maricopa County, Arizona",4253913,140753,3343,3309,79,1,130,102,136,119,42,59,249,144,195,101,238,339,588,22,20,17,40,7,17,10,23,42,58,24,33
04,Arizona/AZ,0400125,"Phoenix City (West) PUMA, Arizona/AZ",04013,"Maricopa County, Arizona",4253913,140753,3343,3309,79,1,118,0,119,0,11,0,118,11,119,11,119,130,248,48,0,4,48,4,0,0,48,48,52,4,48
04,Arizona/AZ,0400126,"Maricopa County--Glendale City (North) PUMA, Arizona/AZ",04013,"Maricopa County, Arizona",4253913,140753,3343,3309,79,1,80,44,22,23,58,0,103,102,22,58,66,124,227,35,10,26,29,26,19,0,10,45,55,45,10
04,Arizona/AZ,0400127,"Maricopa County--Peoria City (South & Central) PUMA, Arizona/AZ",04013,"Maricopa County, Arizona",4253913,140753,3343,3309,79,1,109,0,76,30,14,59,139,14,135,73,76,149,288,38,10,25,26,5,0,20,26,48,52,5,47
04,Arizona/AZ,0400128,"Phoenix City (North) PUMA, Arizona/AZ",04013,"Maricopa County, Arizona",4253913,140753,3343,3309,79,1,50,4,0,0,0,0,50,4,0,0,4,4,54,93,0,0,7,0,7,0,0,93,7,7,0
04,Arizona/AZ,0400129,"Phoenix (Far North) & Peoria (Northwest) Cities PUMA, Arizona/AZ",04013,"Maricopa County, Arizona",4253913,140753,3343,3309,79,1,21,0,0,0,0,0,21,0,0,0,0,0,21,100,0,0,0,0,0,0,0,100,0,0,0
04,Arizona/AZ,0400130,"Maricopa County--El Mirage City & Sun City PUMA, Arizona/AZ",04013,"Maricopa County, Arizona",4253913,140753,3343,3309,79,1,13,34,16,53,0,0,66,34,16,0,50,50,116,11,46,0,43,0,29,0,14,57,43,29,14
04,Arizona/AZ,0400131,"Maricopa County--Surprise City (Central) PUMA, Arizona/AZ",04013,"Maricopa County, Arizona",4253913,140753,3343,3309,79,1,77,0,2,58,0,0,135,0,2,0,2,2,137,56,42,0,1,0,0,0,1,99,1,0,1
04,Arizona/AZ,0400132,"Maricopa County--Goodyear, Glendale (West) & Litchfield Park (Northwest) Cities PUMA, Arizona/AZ",04013,"Maricopa County, Arizona",4253913,140753,3343,3309,79,1,102,9,41,16,0,0,118,9,41,0,50,50,168,61,10,0,30,0,5,0,24,70,30,5,24
04,Arizona/AZ,0400133,"Maricopa County--Avondale (Central) & Litchfield Park (Central) Cities PUMA, Arizona/AZ",04013,"Maricopa County, Arizona",4253913,140753,3343,3309,79,1,49,80,386,201,28,0,250,108,386,28,466,494,744,7,27,4,63,4,11,0,52,34,66,15,52
04,Arizona/AZ,0400134,"Maricopa County (West) & Gila River Indian Community (Northwest) PUMA, Arizona/AZ",04013,"Maricopa County, Arizona",4253913,140753,3343,3309,79,1,246,176,986,188,0,0,434,176,986,0,1162,1162,1596,15,12,0,73,0,11,0,62,27,73,11,62
04,Arizona/AZ,0400201,"Pima County (West) PUMA, Arizona/AZ",04019,"Pima County, Arizona",1019722,25265,622,2478,61,1,59,46,3,63,0,0,122,46,3,0,49,49,171,35,37,0,29,0,27,0,2,71,29,27,2
04,Arizona/AZ,0400202,"Tucson (West) & Marana Cities PUMA, Arizona/AZ",04019,"Pima County, Arizona",1019722,25265,622,2478,61,1,39,26,105,60,0,0,99,26,105,0,131,131,230,17,26,0,57,0,11,0,46,43,57,11,46
04,Arizona/AZ,0400203,"Pima County (North Central)--Oro Valley Town PUMA, Arizona/AZ",04019,"Pima County, Arizona",1019722,25265,622,2478,61,1,82,0,28,49,0,0,131,0,28,0,28,28,159,52,31,0,18,0,0,0,18,82,18,0,18
04,Arizona/AZ,0400204,"Pima County (Northeast) PUMA, Arizona/AZ",04019,"Pima County, Arizona",1019722,25265,622,2478,61,1,12,0,44,0,0,0,12,0,44,0,44,44,56,21,0,0,79,0,0,0,79,21,79,0,79
04,Arizona/AZ,0400205,"Pima County (Southeast)--Tucson City (Far Southeast) & Sahuarita Town PUMA, Arizona/AZ",04019,"Pima County, Arizona",1019722,25265,622,2478,61,1,72,40,0,0,0,0,72,40,0,0,40,40,112,64,0,0,36,0,36,0,0,64,36,36,0
04,Arizona/AZ,0400206,"Tucson City (Northeast) PUMA, Arizona/AZ",04019,"Pima County, Arizona",1019722,25265,622,2478,61,1,45,0,12,9,0,0,54,0,12,0,12,12,66,68,14,0,18,0,0,0,18,82,18,0,18
04,Arizona/AZ,0400207,"Tucson City (Northwest) PUMA, Arizona/AZ",04019,"Pima County, Arizona",1019722,25265,622,2478,61,1,11,0,22,17,0,0,28,0,22,0,22,22,50,22,34,0,44,0,0,0,44,56,44,0,44
04,Arizona/AZ,0400208,"Tucson City (South) PUMA, Arizona/AZ",04019,"Pima County, Arizona",1019722,25265,622,2478,61,1,12,34,62,57,0,0,69,34,62,0,96,96,165,7,35,0,58,0,21,0,38,42,58,21,38
04,Arizona/AZ,0400209,"Tucson City (Southeast) PUMA, Arizona/AZ",04019,"Pima County, Arizona",1019722,25265,622,2478,61,1,50,0,73,0,0,0,50,0,73,0,73,73,123,41,0,0,59,0,0,0,59,41,59,0,59
04,Arizona/AZ,0400300,"Navajo & Apache Counties PUMA, Arizona/AZ",04001,"Apache County, Arizona",71522,3507,164,4903,229,0.399,63,0,25,14,0,0,77,0,25,0,25,25,102,62,14,0,25,0,0,0,25,75,25,0,25
04,Arizona/AZ,0400300,"Navajo & Apache Counties PUMA, Arizona/AZ",04017,"Navajo County, Arizona",108705,5781,234,5318,215,0.601,96,0,37,20,0,0,116,0,37,0,37,37,153,63,13,0,24,0,0,0,24,76,24,0,24
04,Arizona/AZ,0400400,"Coconino County--Flagstaff City PUMA, Arizona/AZ",04005,"Coconino County, Arizona",140217,3985,134,2842,96,1,130,42,58,163,0,0,293,42,58,0,100,100,393,33,41,0,25,0,11,0,15,75,25,11,15
04,Arizona/AZ,0400500,"Yavapai County PUMA, Arizona/AZ",04025,"Yavapai County, Arizona",224645,2518,82,1121,37,1,134,26,37,83,0,0,217,26,37,0,63,63,280,48,30,0,22,0,9,0,13,78,22,9,13
04,Arizona/AZ,0400600,"Mohave & La Paz Counties--Lake Havasu City PUMA, Arizona/AZ",04012,"La Paz County, Arizona",20701,545,15,2633,72,0.09,16,5,21,14,0,4,30,5,25,4,26,30,60,27,23,7,43,0,8,7,35,50,50,8,42
04,Arizona/AZ,0400600,"Mohave & La Paz Counties--Lake Havasu City PUMA, Arizona/AZ",04015,"Mohave County, Arizona",206064,3957,222,1920,108,0.91,162,49,213,140,0,36,302,49,249,36,262,298,600,27,23,6,44,0,8,6,36,50,50,8,42
04,Arizona/AZ,0400700,"Yuma County--Yuma City PUMA, Arizona/AZ",04027,"Yuma County, Arizona",207829,12664,345,6093,166,1,228,1366,4529,972,0,0,1200,1366,4529,0,5895,5895,7095,3,14,0,83,0,19,0,64,17,83,19,64
04,Arizona/AZ,0400800,"Gila, Graham, Greenlee & Pinal (East) Counties PUMA, Arizona/AZ",04007,"Gila County, Arizona",53400,1287,56,2410,105,0.475,101,0,12,89,0,0,190,0,12,0,12,12,202,50,44,0,6,0,0,0,6,94,6,0,6
04,Arizona/AZ,0400800,"Gila, Graham, Greenlee & Pinal (East) Counties PUMA, Arizona/AZ",04009,"Graham County, Arizona",37879,815,25,2152,66,0.333,71,0,8,62,0,0,133,0,8,0,8,8,141,50,44,0,6,0,0,0,6,94,6,0,6
04,Arizona/AZ,0400800,"Gila, Graham, Greenlee & Pinal (East) Counties PUMA, Arizona/AZ",04011,"Greenlee County, Arizona",9504,59,2,621,21,0.085,18,0,2,16,0,0,34,0,2,0,2,2,36,50,44,0,6,0,0,0,6,94,6,0,6
04,Arizona/AZ,0400800,"Gila, Graham, Greenlee & Pinal (East) Counties PUMA, Arizona/AZ",04021,"Pinal County, Arizona",419721,10504,209,2503,50,0.107,23,0,3,20,0,0,43,0,3,0,3,3,46,50,43,0,7,0,0,0,7,93,7,0,7
04,Arizona/AZ,0400803,"Pinal County (North)--Apache Junction City PUMA, Arizona/AZ",04021,"Pinal County, Arizona",419721,10504,209,2503,50,1,21,74,0,166,0,0,187,74,0,0,74,74,261,8,64,0,28,0,28,0,0,72,28,28,0
04,Arizona/AZ,0400805,"Pinal County (Central)--Florence Town, Eloy (Northeast) & Coolidge Cities PUMA, Arizona/AZ",04021,"Pinal County, Arizona",419721,10504,209,2503,50,1,228,0,333,127,0,0,355,0,333,0,333,333,688,33,18,0,48,0,0,0,48,52,48,0,48
04,Arizona/AZ,0400807,"Pinal County (West)--Maricopa, Casa Grande & Eloy (Southeast) Cities PUMA, Arizona/AZ",04021,"Pinal County, Arizona",419721,10504,209,2503,50,1,106,324,755,514,0,0,620,324,755,0,1079,1079,1699,6,30,0,64,0,19,0,44,36,64,19,44
04,Arizona/AZ,0400900,"Cochise & Santa Cruz Counties--Sierra Vista City PUMA, Arizona/AZ",04003,"Cochise County, Arizona",126279,1893,72,1499,57,0.732,140,119,140,242,25,3,382,144,143,28,259,287,669,21,36,4,39,4,18,0,21,57,43,22,21
04,Arizona/AZ,0400900,"Cochise & Santa Cruz Counties--Sierra Vista City PUMA, Arizona/AZ",04023,"Santa Cruz County, Arizona",46584,2834,63,6084,135,0.268,51,44,51,89,9,1,140,53,52,10,95,105,245,21,36,4,39,4,18,0,21,57,43,22,21
05,Arkansas/AR,0500100,"Benton County PUMA, Arkansas/AR",05007,"Benton County, Arkansas",258980,6500,84,2510,32,1,1531,708,2338,521,27,582,2052,735,2920,609,3046,3655,5707,27,9,11,53,0,12,10,41,36,64,13,51
05,Arkansas/AR,0500200,"Washington County PUMA, Arkansas/AR",05143,"Washington County, Arkansas",228529,9328,114,4082,50,1,1934,851,1697,565,56,558,2499,907,2255,614,2548,3162,5661,34,10,11,45,1,15,10,30,44,56,16,40
05,Arkansas/AR,0500300,"Baxter, Boone, Carroll, Marion, Madison, Newton & Searcy Counties PUMA, Arkansas/AR",05005,"Baxter County, Arkansas",41219,331,2,803,5,0.266,449,16,106,93,1,12,542,17,118,13,122,135,677,66,14,2,18,0,2,2,16,80,20,3,17
05,Arkansas/AR,0500300,"Baxter, Boone, Carroll, Marion, Madison, Newton & Searcy Counties PUMA, Arkansas/AR",05009,"Boone County, Arkansas",37288,706,10,1893,27,0.242,408,15,96,85,1,11,493,16,107,12,111,123,616,66,14,2,18,0,2,2,16,80,20,3,17
05,Arkansas/AR,0500300,"Baxter, Boone, Carroll, Marion, Madison, Newton & Searcy Counties PUMA, Arkansas/AR",05015,"Carroll County, Arkansas",27887,650,9,2331,32,0.179,302,11,71,63,1,8,365,12,79,9,82,91,456,66,14,2,18,0,2,2,16,80,20,3,17
05,Arkansas/AR,0500300,"Baxter, Boone, Carroll, Marion, Madison, Newton & Searcy Counties PUMA, Arkansas/AR",05087,"Madison County, Arkansas",16076,346,3,2152,19,0.104,176,6,41,37,0,5,213,6,46,5,47,52,265,66,14,2,18,0,2,2,15,80,20,2,17
05,Arkansas/AR,0500300,"Baxter, Boone, Carroll, Marion, Madison, Newton & Searcy Counties PUMA, Arkansas/AR",05089,"Marion County, Arkansas",16438,89,0,541,0,0.106,179,7,42,37,0,5,216,7,47,5,49,54,270,66,14,2,18,0,3,2,16,80,20,3,17
05,Arkansas/AR,0500300,"Baxter, Boone, Carroll, Marion, Madison, Newton & Searcy Counties PUMA, Arkansas/AR",05101,"Newton County, Arkansas",7848,236,18,3007,229,0.051,86,3,20,18,0,2,104,3,22,2,23,25,129,67,14,2,18,0,2,2,16,81,19,2,17
05,Arkansas/AR,0500300,"Baxter, Boone, Carroll, Marion, Madison, Newton & Searcy Counties PUMA, Arkansas/AR",05129,"Searcy County, Arkansas",7923,141,1,1780,13,0.052,88,3,21,18,0,2,106,3,23,2,24,26,132,67,14,2,18,0,2,2,16,80,20,2,17
05,Arkansas/AR,0500400,"Independence, Cleburne, Van Buren, Sharp, Izard, Stone & Fulton Counties PUMA, Arkansas/AR",05023,"Cleburne County, Arkansas",25230,324,8,1284,32,0.188,315,4,12,10,7,2,325,11,14,9,16,25,350,90,3,3,5,2,1,1,3,93,7,3,4
05,Arkansas/AR,0500400,"Independence, Cleburne, Van Buren, Sharp, Izard, Stone & Fulton Counties PUMA, Arkansas/AR",05049,"Fulton County, Arkansas",12139,153,3,1260,25,0.09,151,2,6,5,3,1,156,5,7,4,8,12,168,90,3,2,5,2,1,1,4,93,7,3,4
05,Arkansas/AR,0500400,"Independence, Cleburne, Van Buren, Sharp, Izard, Stone & Fulton Counties PUMA, Arkansas/AR",05063,"Independence County, Arkansas",37264,1076,19,2888,51,0.277,465,6,18,14,11,2,479,17,20,13,24,37,516,90,3,3,5,2,1,0,3,93,7,3,4
05,Arkansas/AR,0500400,"Independence, Cleburne, Van Buren, Sharp, Izard, Stone & Fulton Counties PUMA, Arkansas/AR",05065,"Izard County, Arkansas",13559,238,0,1755,0,0.1,168,2,6,5,4,1,173,6,7,5,8,13,186,90,3,3,4,2,1,1,3,93,7,3,4
05,Arkansas/AR,0500400,"Independence, Cleburne, Van Buren, Sharp, Izard, Stone & Fulton Counties PUMA, Arkansas/AR",05135,"Sharp County, Arkansas",17043,216,6,1267,35,0.128,215,3,8,7,5,1,222,8,9,6,11,17,239,90,3,3,5,2,1,0,3,93,7,3,4
05,Arkansas/AR,0500400,"Independence, Cleburne, Van Buren, Sharp, Izard, Stone & Fulton Counties PUMA, Arkansas/AR",05137,"Stone County, Arkansas",12446,342,9,2748,72,0.093,156,2,6,5,4,1,161,6,7,5,8,13,174,90,3,3,5,2,1,1,3,93,7,3,4
05,Arkansas/AR,0500400,"Independence, Cleburne, Van Buren, Sharp, Izard, Stone & Fulton Counties PUMA, Arkansas/AR",05141,"Van Buren County, Arkansas",16684,173,3,1037,18,0.124,208,3,8,6,5,1,214,8,9,6,11,17,231,90,3,3,5,2,1,0,3,93,7,3,4
05,Arkansas/AR,0500500,"Craighead (West), Greene, Randolph, Lawrence & Clay Counties PUMA, Arkansas/AR",05021,"Clay County, Arkansas",15061,286,8,1899,53,0.079,177,0,12,6,0,0,183,0,12,0,12,12,195,91,3,0,6,0,0,0,6,94,6,0,6
05,Arkansas/AR,0500500,"Craighead (West), Greene, Randolph, Lawrence & Clay Counties PUMA, Arkansas/AR",05031,"Craighead County, Arkansas",105701,2876,22,2721,21,0.504,1128,0,80,39,0,0,1167,0,80,0,80,80,1247,90,3,0,6,0,0,0,6,94,6,0,6
05,Arkansas/AR,0500500,"Craighead (West), Greene, Randolph, Lawrence & Clay Counties PUMA, Arkansas/AR",05055,"Greene County, Arkansas",44623,859,10,1925,22,0.236,528,0,37,18,0,0,546,0,37,0,37,37,583,91,3,0,6,0,0,0,6,94,6,0,6
05,Arkansas/AR,0500500,"Craighead (West), Greene, Randolph, Lawrence & Clay Counties PUMA, Arkansas/AR",05075,"Lawrence County, Arkansas",16669,424,12,2544,72,0.089,199,0,14,7,0,0,206,0,14,0,14,14,220,90,3,0,6,0,0,0,6,94,6,0,6
05,Arkansas/AR,0500500,"Craighead (West), Greene, Randolph, Lawrence & Clay Counties PUMA, Arkansas/AR",05121,"Randolph County, Arkansas",17603,411,22,2335,125,0.092,206,0,15,7,0,0,213,0,15,0,15,15,228,90,3,0,7,0,0,0,7,93,7,0,7
05,Arkansas/AR,0500600,"Crittenden, Mississippi & Craighead (East) Counties PUMA, Arkansas/AR",05031,"Craighead County, Arkansas",105701,2876,22,2721,21,0.104,186,2,19,9,1,9,195,3,28,10,21,31,226,82,4,4,9,0,1,4,8,86,14,1,12
05,Arkansas/AR,0500600,"Crittenden, Mississippi & Craighead (East) Counties PUMA, Arkansas/AR",05035,"Crittenden County, Arkansas",49013,1923,46,3923,94,0.479,855,11,87,40,4,41,895,15,128,45,98,143,1038,82,4,4,9,0,1,4,8,86,14,1,12
05,Arkansas/AR,0500600,"Crittenden, Mississippi & Craighead (East) Counties PUMA, Arkansas/AR",05093,"Mississippi County, Arkansas",42831,1657,50,3869,117,0.417,745,10,75,35,4,36,780,14,111,40,85,125,905,82,4,4,9,0,1,4,8,86,14,2,12
05,Arkansas/AR,0500700,"St. Francis, Poinsett, Phillips, Cross, Lee & Monroe Counties PUMA, Arkansas/AR",05037,"Cross County, Arkansas",16998,430,11,2530,65,0.166,449,1,4,2,0,6,451,1,10,6,5,11,462,97,0,1,1,0,0,1,1,98,2,0,2
05,Arkansas/AR,0500700,"St. Francis, Poinsett, Phillips, Cross, Lee & Monroe Counties PUMA, Arkansas/AR",05077,"Lee County, Arkansas",9398,1054,18,11215,192,0.091,246,1,2,1,0,3,247,1,5,3,3,6,253,97,0,1,1,0,0,1,1,98,2,0,2
05,Arkansas/AR,0500700,"St. Francis, Poinsett, Phillips, Cross, Lee & Monroe Counties PUMA, Arkansas/AR",05095,"Monroe County, Arkansas",7249,128,0,1766,0,0.07,189,0,2,1,0,2,190,0,4,2,2,4,194,97,1,1,1,0,0,1,1,98,2,0,2
05,Arkansas/AR,0500700,"St. Francis, Poinsett, Phillips, Cross, Lee & Monroe Counties PUMA, Arkansas/AR",05107,"Phillips County, Arkansas",19034,485,11,2548,58,0.185,500,1,5,2,0,6,502,1,11,6,6,12,514,97,0,1,1,0,0,1,1,98,2,0,2
05,Arkansas/AR,0500700,"St. Francis, Poinsett, Phillips, Cross, Lee & Monroe Counties PUMA, Arkansas/AR",05111,"Poinsett County, Arkansas",24054,645,11,2681,46,0.234,633,1,6,3,0,8,636,1,14,8,7,15,651,97,0,1,1,0,0,1,1,98,2,0,2
05,Arkansas/AR,0500700,"St. Francis, Poinsett, Phillips, Cross, Lee & Monroe Counties PUMA, Arkansas/AR",05123,"St. Francis County, Arkansas",26294,1498,6,5697,23,0.255,689,2,6,3,0,9,692,2,15,9,8,17,709,97,0,1,1,0,0,1,1,98,2,0,2
05,Arkansas/AR,0500800,"White, Jackson, Prairie & Woodruff Counties PUMA, Arkansas/AR",05067,"Jackson County, Arkansas",17225,321,1,1864,6,0.155,290,2,43,0,0,8,290,2,51,8,45,53,343,85,0,2,13,0,1,2,13,85,15,1,15
05,Arkansas/AR,0500800,"White, Jackson, Prairie & Woodruff Counties PUMA, Arkansas/AR",05117,"Prairie County, Arkansas",8244,146,1,1771,12,0.074,139,1,20,0,0,4,139,1,24,4,21,25,164,85,0,2,13,0,1,2,12,85,15,1,15
05,Arkansas/AR,0500800,"White, Jackson, Prairie & Woodruff Counties PUMA, Arkansas/AR",05145,"White County, Arkansas",78804,828,21,1051,27,0.712,1333,9,197,0,0,36,1333,9,233,36,206,242,1575,85,0,2,13,0,1,2,13,85,15,1,15
05,Arkansas/AR,0500800,"White, Jackson, Prairie & Woodruff Counties PUMA, Arkansas/AR",05147,"Woodruff County, Arkansas",6660,52,0,781,0,0.06,112,1,17,0,0,3,112,1,20,3,18,21,133,84,0,2,14,0,1,2,13,84,16,1,15
05,Arkansas/AR,0500900,"Pulaski County (Outer)--North Little Rock, Sherwood & Jacksonville Cities PUMA, Arkansas/AR",05119,"Pulaski County, Arkansas",393463,9059,147,2302,37,1,793,0,21,70,0,0,863,0,21,0,21,21,884,90,8,0,2,0,0,0,2,98,2,0,2
05,Arkansas/AR,0501000,"Pulaski County (Central)--Little Rock City PUMA, Arkansas/AR",05119,"Pulaski County, Arkansas",393463,9059,147,2302,37,1,628,134,204,0,0,0,628,134,204,0,338,338,966,65,0,0,35,0,14,0,21,65,35,14,21
05,Arkansas/AR,0501100,"Faulkner & Lonoke Counties PUMA, Arkansas/AR",05045,"Faulkner County, Arkansas",122416,2432,19,1987,16,0.629,522,4,21,98,0,0,620,4,21,0,25,25,645,81,15,0,4,0,1,0,3,96,4,1,3
05,Arkansas/AR,0501100,"Faulkner & Lonoke Counties PUMA, Arkansas/AR",05085,"Lonoke County, Arkansas",72206,1153,11,1597,15,0.371,308,3,12,58,0,0,366,3,12,0,15,15,381,81,15,0,4,0,1,0,3,96,4,1,3
05,Arkansas/AR,0501200,"Saline County PUMA, Arkansas/AR",05125,"Saline County, Arkansas",118009,2030,23,1720,19,1,230,0,0,0,0,0,230,0,0,0,0,0,230,100,0,0,0,0,0,0,0,100,0,0,0
05,Arkansas/AR,0501300,"Pope, Johnson, Yell, Conway & Perry Counties PUMA, Arkansas/AR",05029,"Conway County, Arkansas",20906,263,3,1258,14,0.147,365,28,142,39,2,26,404,30,168,28,170,198,602,61,6,5,28,0,5,4,24,67,33,5,28
05,Arkansas/AR,0501300,"Pope, Johnson, Yell, Conway & Perry Counties PUMA, Arkansas/AR",05071,"Johnson County, Arkansas",26291,837,5,3184,19,0.184,457,35,178,49,2,32,506,37,210,34,213,247,753,61,7,5,28,0,5,4,24,67,33,5,28
05,Arkansas/AR,0501300,"Pope, Johnson, Yell, Conway & Perry Counties PUMA, Arkansas/AR",05105,"Perry County, Arkansas",10322,88,0,853,0,0.071,176,13,69,19,1,12,195,14,81,13,82,95,290,61,7,4,28,0,4,4,24,67,33,5,28
05,Arkansas/AR,0501300,"Pope, Johnson, Yell, Conway & Perry Counties PUMA, Arkansas/AR",05115,"Pope County, Arkansas",63644,2096,30,3293,47,0.447,1110,84,432,118,6,78,1228,90,510,84,516,600,1828,61,6,5,28,0,5,4,24,67,33,5,28
05,Arkansas/AR,0501300,"Pope, Johnson, Yell, Conway & Perry Counties PUMA, Arkansas/AR",05149,"Yell County, Arkansas",21573,1250,29,5794,134,0.151,375,29,146,40,2,26,415,31,172,28,175,203,618,61,6,5,28,0,5,4,24,67,33,5,28
05,Arkansas/AR,0501400,"Sebastian & Crawford Counties PUMA, Arkansas/AR",05033,"Crawford County, Arkansas",62472,1361,15,2179,24,0.328,626,154,404,65,87,129,691,241,533,216,558,774,1465,43,4,15,38,6,11,9,28,47,53,16,36
05,Arkansas/AR,0501400,"Sebastian & Crawford Counties PUMA, Arkansas/AR",05131,"Sebastian County, Arkansas",127461,3638,59,2854,46,0.672,1282,317,829,133,178,265,1415,495,1094,443,1146,1589,3004,43,4,15,38,6,11,9,28,47,53,16,36
05,Arkansas/AR,0501500,"Logan, Polk, Franklin, Sevier, Howard & Scott Counties PUMA, Arkansas/AR",05047,"Franklin County, Arkansas",17780,273,2,1535,11,0.176,449,52,151,41,12,18,490,64,169,30,203,233,723,62,6,4,28,2,7,2,21,68,32,9,23
05,Arkansas/AR,0501500,"Logan, Polk, Franklin, Sevier, Howard & Scott Counties PUMA, Arkansas/AR",05061,"Howard County, Arkansas",13389,468,9,3495,67,0.134,342,40,115,31,9,14,373,49,129,23,155,178,551,62,6,4,28,2,7,3,21,68,32,9,23
05,Arkansas/AR,0501500,"Logan, Polk, Franklin, Sevier, Howard & Scott Counties PUMA, Arkansas/AR",05083,"Logan County, Arkansas",21757,403,1,1852,5,0.218,556,64,187,51,15,22,607,79,209,37,251,288,895,62,6,4,28,2,7,2,21,68,32,9,23
05,Arkansas/AR,0501500,"Logan, Polk, Franklin, Sevier, Howard & Scott Counties PUMA, Arkansas/AR",05113,"Polk County, Arkansas",20163,258,4,1280,20,0.201,512,59,172,47,14,20,559,73,192,34,231,265,824,62,6,4,28,2,7,2,21,68,32,9,23
05,Arkansas/AR,0501500,"Logan, Polk, Franklin, Sevier, Howard & Scott Counties PUMA, Arkansas/AR",05127,"Scott County, Arkansas",10442,100,1,958,10,0.103,263,30,88,24,7,10,287,37,98,17,118,135,422,62,6,4,28,2,7,2,21,68,32,9,23
05,Arkansas/AR,0501500,"Logan, Polk, Franklin, Sevier, Howard & Scott Counties PUMA, Arkansas/AR",05133,"Sevier County, Arkansas",17193,1201,16,6985,93,0.169,431,50,145,40,12,17,471,62,162,29,195,224,695,62,6,4,28,2,7,2,21,68,32,9,23
05,Arkansas/AR,0501600,"Garland, Hot Spring, Clark & Montgomery Counties PUMA, Arkansas/AR",05019,"Clark County, Arkansas",22385,332,4,1483,18,0.14,44,0,8,2,0,10,46,0,18,10,8,18,64,69,3,16,12,0,0,16,12,72,28,0,28
05,Arkansas/AR,0501600,"Garland, Hot Spring, Clark & Montgomery Counties PUMA, Arkansas/AR",05051,"Garland County, Arkansas",98296,1865,51,1897,52,0.6,188,0,36,9,0,42,197,0,78,42,36,78,275,68,3,15,13,0,0,15,13,72,28,0,28
05,Arkansas/AR,0501600,"Garland, Hot Spring, Clark & Montgomery Counties PUMA, Arkansas/AR",05059,"Hot Spring County, Arkansas",33520,1884,26,5621,78,0.206,65,0,12,3,0,14,68,0,26,14,12,26,94,69,3,15,13,0,0,15,13,72,28,0,28
05,Arkansas/AR,0501600,"Garland, Hot Spring, Clark & Montgomery Counties PUMA, Arkansas/AR",05097,"Montgomery County, Arkansas",8993,145,4,1612,44,0.055,17,0,3,1,0,4,18,0,7,4,3,7,25,68,4,16,12,0,0,16,12,72,28,0,28
05,Arkansas/AR,0501700,"Jefferson, Grant & Arkansas (Northwest) Counties PUMA, Arkansas/AR",05001,"Arkansas County, Arkansas",18124,391,6,2157,33,0.111,182,8,9,1,0,0,183,8,9,0,17,17,200,91,0,0,8,0,4,0,4,92,8,4,4
05,Arkansas/AR,0501700,"Jefferson, Grant & Arkansas (Northwest) Counties PUMA, Arkansas/AR",05053,"Grant County, Arkansas",18086,256,2,1415,11,0.183,301,13,14,2,0,0,303,13,14,0,27,27,330,91,1,0,8,0,4,0,4,92,8,4,4
05,Arkansas/AR,0501700,"Jefferson, Grant & Arkansas (Northwest) Counties PUMA, Arkansas/AR",05069,"Jefferson County, Arkansas",70424,3107,68,4412,97,0.707,1162,49,55,6,0,0,1168,49,55,0,104,104,1272,91,0,0,8,0,4,0,4,92,8,4,4
05,Arkansas/AR,0501800,"Southeast Arkansas PUMA, Arkansas/AR",05001,"Arkansas County, Arkansas",18124,391,6,2157,33,0.071,97,5,17,5,0,1,102,5,18,1,22,23,125,78,4,1,18,0,4,1,14,82,18,4,14
05,Arkansas/AR,0501800,"Southeast Arkansas PUMA, Arkansas/AR",05003,"Ashley County, Arkansas",20537,431,10,2099,49,0.201,274,13,48,15,0,2,289,13,50,2,61,63,352,78,4,1,17,0,4,1,14,82,18,4,14
05,Arkansas/AR,0501800,"Southeast Arkansas PUMA, Arkansas/AR",05011,"Bradley County, Arkansas",10948,342,8,3124,73,0.108,147,7,26,8,0,1,155,7,27,1,33,34,189,78,4,1,17,0,4,1,14,82,18,4,14
05,Arkansas/AR,0501800,"Southeast Arkansas PUMA, Arkansas/AR",05017,"Chicot County, Arkansas",10826,1004,19,9274,176,0.107,146,7,25,8,0,1,154,7,26,1,32,33,187,78,4,1,17,0,4,1,13,82,18,4,14
05,Arkansas/AR,0501800,"Southeast Arkansas PUMA, Arkansas/AR",05025,"Cleveland County, Arkansas",8226,184,10,2237,122,0.081,110,5,19,6,0,1,116,5,20,1,24,25,141,78,4,1,17,0,4,1,13,82,18,4,14
05,Arkansas/AR,0501800,"Southeast Arkansas PUMA, Arkansas/AR",05041,"Desha County, Arkansas",11887,290,5,2440,42,0.116,158,8,28,9,0,1,167,8,29,1,36,37,204,77,4,0,18,0,4,0,14,82,18,4,14
05,Arkansas/AR,0501800,"Southeast Arkansas PUMA, Arkansas/AR",05043,"Drew County, Arkansas",18502,355,6,1919,32,0.183,250,12,44,14,0,2,264,12,46,2,56,58,322,78,4,1,17,0,4,1,14,82,18,4,14
05,Arkansas/AR,0501800,"Southeast Arkansas PUMA, Arkansas/AR",05079,"Lincoln County, Arkansas",13695,1961,15,14319,110,0.134,183,9,32,10,0,1,193,9,33,1,41,42,235,78,4,0,17,0,4,0,14,82,18,4,14
05,Arkansas/AR,0501900,"South Central Arkansas PUMA, Arkansas/AR",05013,"Calhoun County, Arkansas",5202,35,0,673,0,0.051,33,0,0,1,0,0,34,0,0,0,0,0,34,97,3,0,0,0,0,0,0,100,0,0,0
05,Arkansas/AR,0501900,"South Central Arkansas PUMA, Arkansas/AR",05027,"Columbia County, Arkansas",23892,434,18,1817,75,0.238,155,0,0,5,0,0,160,0,0,0,0,0,160,97,3,0,0,0,0,0,0,100,0,0,0
05,Arkansas/AR,0501900,"South Central Arkansas PUMA, Arkansas/AR",05039,"Dallas County, Arkansas",7432,162,3,2180,40,0.074,48,0,0,2,0,0,50,0,0,0,0,0,50,96,4,0,0,0,0,0,0,100,0,0,0
05,Arkansas/AR,0501900,"South Central Arkansas PUMA, Arkansas/AR",05103,"Ouachita County, Arkansas",24106,255,6,1058,25,0.24,156,0,0,5,0,0,161,0,0,0,0,0,161,97,3,0,0,0,0,0,0,100,0,0,0
05,Arkansas/AR,0501900,"South Central Arkansas PUMA, Arkansas/AR",05139,"Union County, Arkansas",39732,880,34,2215,86,0.397,258,0,0,8,0,0,266,0,0,0,0,0,266,97,3,0,0,0,0,0,0,100,0,0,0
05,Arkansas/AR,0502000,"Southwest Arkansas PUMA, Arkansas/AR",05057,"Hempstead County, Arkansas",22018,363,4,1649,18,0.211,428,20,7,16,3,0,444,23,7,3,27,30,474,90,3,1,6,1,4,0,1,94,6,5,1
05,Arkansas/AR,0502000,"Southwest Arkansas PUMA, Arkansas/AR",05073,"Lafayette County, Arkansas",6915,104,2,1504,29,0.066,134,6,2,5,1,0,139,7,2,1,8,9,148,91,3,1,5,1,4,0,1,94,6,5,1
05,Arkansas/AR,0502000,"Southwest Arkansas PUMA, Arkansas/AR",05081,"Little River County, Arkansas",12417,354,25,2851,201,0.119,241,11,4,9,1,0,250,12,4,1,15,16,266,91,3,0,6,0,4,0,2,94,6,5,2
05,Arkansas/AR,0502000,"Southwest Arkansas PUMA, Arkansas/AR",05091,"Miller County, Arkansas",43759,818,11,1869,25,0.42,851,39,14,32,5,0,883,44,14,5,53,58,941,90,3,1,6,1,4,0,1,94,6,5,1
05,Arkansas/AR,0502000,"Southwest Arkansas PUMA, Arkansas/AR",05099,"Nevada County, Arkansas",8440,220,13,2607,154,0.081,164,8,3,6,1,0,170,9,3,1,11,12,182,90,3,1,6,1,4,0,2,93,7,5,2
05,Arkansas/AR,0502000,"Southwest Arkansas PUMA, Arkansas/AR",05109,"Pike County, Arkansas",10808,226,3,2091,28,0.104,211,10,4,8,1,0,219,11,4,1,14,15,234,90,3,0,6,0,4,0,2,94,6,5,2
06,California/CA,0600101,"Alameda County (North)--Berkeley & Albany Cities PUMA, California/CA",06001,"Alameda County, California",1643700,21049,404,1281,25,1,58,33,19,65,0,0,123,33,19,0,52,52,175,33,37,0,30,0,19,0,11,70,30,19,11
06,California/CA,0600102,"Alameda County (Northwest)--Oakland (Northwest) & Emeryville Cities PUMA, California/CA",06001,"Alameda County, California",1643700,21049,404,1281,25,1,221,30,287,105,97,147,326,127,434,244,317,561,887,25,12,28,36,11,3,17,32,37,63,14,49
06,California/CA,0600103,"Alameda County (Northeast)--Oakland (East) & Piedmont Cities PUMA, California/CA",06001,"Alameda County, California",1643700,21049,404,1281,25,1,84,13,34,12,11,0,96,24,34,11,47,58,154,55,8,7,31,7,8,0,22,62,38,16,22
06,California/CA,0600104,"Alameda County (North Central)--Oakland City (South Central) PUMA, California/CA",06001,"Alameda County, California",1643700,21049,404,1281,25,1,288,99,646,255,57,92,543,156,738,149,745,894,1437,20,18,10,52,4,7,6,45,38,62,11,51
06,California/CA,0600105,"Alameda County (West)--San Leandro, Alameda & Oakland (Southwest) Cities PUMA, California/CA",06001,"Alameda County, California",1643700,21049,404,1281,25,1,49,30,103,19,59,103,68,89,206,162,133,295,363,13,5,45,37,16,8,28,28,19,81,25,57
06,California/CA,0600106,"Alameda County (North Central)--Castro Valley, San Lorenzo & Ashland PUMA, California/CA",06001,"Alameda County, California",1643700,21049,404,1281,25,1,120,125,135,228,43,0,348,168,135,43,260,303,651,18,35,7,40,7,19,0,21,53,47,26,21
06,California/CA,0600107,"Alameda County (Central)--Hayward City PUMA, California/CA",06001,"Alameda County, California",1643700,21049,404,1281,25,1,88,72,402,256,69,23,344,141,425,92,474,566,910,10,28,10,52,8,8,3,44,38,62,15,47
06,California/CA,0600108,"Alameda County (Southwest)--Union City, Newark & Fremont (West) Cities PUMA, California/CA",06001,"Alameda County, California",1643700,21049,404,1281,25,1,147,76,58,155,18,49,302,94,107,67,134,201,503,29,31,13,27,4,15,10,12,60,40,19,21
06,California/CA,0600109,"Alameda County (South Central)--Fremont City (East) PUMA, California/CA",06001,"Alameda County, California",1643700,21049,404,1281,25,1,50,0,44,35,47,0,85,47,44,47,44,91,176,28,20,27,25,27,0,0,25,48,52,27,25
06,California/CA,0600110,"Alameda County (East)--Livermore, Pleasanton & Dublin Cities PUMA, California/CA",06001,"Alameda County, California",1643700,21049,404,1281,25,1,43,19,3,14,0,0,57,19,3,0,22,22,79,54,18,0,28,0,24,0,4,72,28,24,4
06,California/CA,0600300,"Alpine, Amador, Calaveras, Inyo, Mariposa, Mono & Tuolumne Counties PUMA, California/CA",06003,"Alpine County, California",1146,2,0,175,0,0.006,2,0,1,0,0,0,2,0,1,0,1,1,3,67,0,0,33,0,0,0,33,67,33,0,33
06,California/CA,0600300,"Alpine, Amador, Calaveras, Inyo, Mariposa, Mono & Tuolumne Counties PUMA, California/CA",06005,"Amador County, California",37829,287,16,759,42,0.2,65,11,47,16,0,1,81,11,48,1,58,59,140,46,11,1,41,0,8,1,34,58,42,8,34
06,California/CA,0600300,"Alpine, Amador, Calaveras, Inyo, Mariposa, Mono & Tuolumne Counties PUMA, California/CA",06009,"Calaveras County, California",45235,317,14,701,31,0.242,78,14,57,19,0,1,97,14,58,1,71,72,169,46,11,1,42,0,8,1,34,57,43,8,34
06,California/CA,0600300,"Alpine, Amador, Calaveras, Inyo, Mariposa, Mono & Tuolumne Counties PUMA, California/CA",06027,"Inyo County, California",18085,187,15,1034,83,0.097,31,6,23,8,0,0,39,6,23,0,29,29,68,46,12,0,43,0,9,0,34,57,43,9,34
06,California/CA,0600300,"Alpine, Amador, Calaveras, Inyo, Mariposa, Mono & Tuolumne Counties PUMA, California/CA",06043,"Mariposa County, California",17540,75,2,428,11,0.093,30,5,22,7,0,0,37,5,22,0,27,27,64,47,11,0,42,0,8,0,34,58,42,8,34
06,California/CA,0600300,"Alpine, Amador, Calaveras, Inyo, Mariposa, Mono & Tuolumne Counties PUMA, California/CA",06051,"Mono County, California",14174,165,2,1164,14,0.075,24,4,18,6,0,0,30,4,18,0,22,22,52,46,12,0,42,0,8,0,35,58,42,8,35
06,California/CA,0600300,"Alpine, Amador, Calaveras, Inyo, Mariposa, Mono & Tuolumne Counties PUMA, California/CA",06109,"Tuolumne County, California",53932,227,4,421,7,0.288,93,16,68,22,0,1,115,16,69,1,84,85,200,46,11,0,42,0,8,0,34,57,42,8,34
06,California/CA,0600701,"Butte County (Northwest)--Chico City PUMA, California/CA",06007,"Butte County, California",227075,2803,44,1234,19,1,395,35,237,221,9,0,616,44,237,9,272,281,897,44,25,1,30,1,4,0,26,69,31,5,26
06,California/CA,0600702,"Butte County (Southeast)--Oroville City & Paradise Town PUMA, California/CA",06007,"Butte County, California",227075,2803,44,1234,19,1,479,135,612,331,29,27,810,164,639,56,747,803,1613,30,21,3,46,2,8,2,38,50,50,10,40
06,California/CA,0601100,"Colusa, Glenn, Tehama & Trinity Counties PUMA, California/CA",06011,"Colusa County, California",21464,529,6,2465,28,0.172,144,141,511,117,2,0,261,143,511,2,652,654,915,16,13,0,71,0,15,0,56,29,71,16,56
06,California/CA,0601100,"Colusa, Glenn, Tehama & Trinity Counties PUMA, California/CA",06021,"Glenn County, California",27897,567,3,2032,11,0.223,187,183,663,152,3,0,339,186,663,3,846,849,1188,16,13,0,71,0,15,0,56,29,71,16,56
06,California/CA,0601100,"Colusa, Glenn, Tehama & Trinity Counties PUMA, California/CA",06103,"Tehama County, California",63373,540,4,852,6,0.503,422,413,1494,342,7,0,764,420,1494,7,1907,1914,2678,16,13,0,71,0,15,0,56,29,71,16,56
06,California/CA,0601100,"Colusa, Glenn, Tehama & Trinity Counties PUMA, California/CA",06105,"Trinity County, California",12862,16,0,124,0,0.102,86,84,303,69,1,0,155,85,303,1,387,388,543,16,13,0,71,0,15,0,56,29,71,16,56
06,California/CA,0601301,"Contra Costa County (Far Southwest)--Richmond (Southwest) & San Pablo Cities PUMA, California/CA",06013,"Contra Costa County, California",1133247,16469,205,1453,18,1,44,90,452,102,69,0,146,159,452,69,542,611,757,6,13,9,72,9,12,0,60,19,81,21,60
06,California/CA,0601302,"Contra Costa County (Far Northwest)--Richmond (North), Hercules & El Cerrito Cites PUMA, California/CA",06013,"Contra Costa County, California",1133247,16469,205,1453,18,1,190,54,77,53,22,29,243,76,106,51,131,182,425,45,12,12,31,5,13,7,18,57,43,18,25
06,California/CA,0601303,"Contra Costa County (Northwest)--Concord (West), Martinez & Pleasant Hill Cities PUMA, California/CA",06013,"Contra Costa County, California",1133247,16469,205,1453,18,1,0,0,159,123,41,17,123,41,176,58,159,217,340,0,36,17,47,12,0,5,47,36,64,12,52
06,California/CA,0601304,"Contra Costa County--Walnut Creek (West), Lafayette, Orinda Cities & Moraga Town PUMA, California/CA",06013,"Contra Costa County, California",1133247,16469,205,1453,18,1,0,0,17,59,0,0,59,0,17,0,17,17,76,0,78,0,22,0,0,0,22,78,22,0,22
06,California/CA,0601305,"Contra Costa County (South)--San Ramon City & Danville Town PUMA, California/CA",06013,"Contra Costa County, California",1133247,16469,205,1453,18,1,2,0,16,0,0,14,2,0,30,14,16,30,32,6,0,44,50,0,0,44,50,6,94,0,94
06,California/CA,0601306,"Contra Costa County (Central)--Concord (South), Walnut Creek (East) & Clayton Cities PUMA, California/CA",06013,"Contra Costa County, California",1133247,16469,205,1453,18,1,71,36,107,23,0,0,94,36,107,0,143,143,237,30,10,0,60,0,15,0,45,40,60,15,45
06,California/CA,0601307,"Contra Costa County (North Central)--Pittsburg & Concord (North & East) Cities PUMA, California/CA",06013,"Contra Costa County, California",1133247,16469,205,1453,18,1,0,101,78,67,0,0,67,101,78,0,179,179,246,0,27,0,73,0,41,0,32,27,73,41,32
06,California/CA,0601308,"Contra Costa County (Northeast)--Antioch City PUMA, California/CA",06013,"Contra Costa County, California",1133247,16469,205,1453,18,1,0,0,140,74,0,0,74,0,140,0,140,140,214,0,35,0,65,0,0,0,65,35,65,0,65
06,California/CA,0601309,"Contra Costa County (East)--Brentwood & Oakley Cities PUMA, California/CA",06013,"Contra Costa County, California",1133247,16469,205,1453,18,1,23,37,51,37,0,0,60,37,51,0,88,88,148,16,25,0,59,0,25,0,34,41,59,25,34
06,California/CA,0601500,"Del Norte, Lassen, Modoc, Plumas & Siskiyou Counties PUMA, California/CA",06015,"Del Norte County, California",27424,139,1,507,4,0.213,171,23,62,65,4,3,236,27,65,7,85,92,328,52,20,2,26,1,7,1,19,72,28,8,20
06,California/CA,0601500,"Del Norte, Lassen, Modoc, Plumas & Siskiyou Counties PUMA, California/CA",06035,"Lassen County, California",31185,740,0,2373,0,0.238,191,25,69,73,5,4,264,30,73,9,94,103,367,52,20,2,26,1,7,1,19,72,28,8,20
06,California/CA,0601500,"Del Norte, Lassen, Modoc, Plumas & Siskiyou Counties PUMA, California/CA",06049,"Modoc County, California",8938,24,0,269,0,0.068,54,7,20,21,1,1,75,8,21,2,27,29,104,52,20,2,26,1,7,1,19,72,28,8,20
06,California/CA,0601500,"Del Norte, Lassen, Modoc, Plumas & Siskiyou Counties PUMA, California/CA",06063,"Plumas County, California",18699,48,0,257,0,0.144,115,15,42,44,3,2,159,18,44,5,57,62,221,52,20,2,26,1,7,1,19,72,28,8,20
06,California/CA,0601500,"Del Norte, Lassen, Modoc, Plumas & Siskiyou Counties PUMA, California/CA",06093,"Siskiyou County, California",43540,165,0,379,0,0.337,270,36,98,103,6,5,373,42,103,11,134,145,518,52,20,2,26,1,7,1,19,72,28,8,20
06,California/CA,0601700,"El Dorado County--El Dorado Hills PUMA, California/CA",06017,"El Dorado County, California",186661,1109,4,594,2,1,245,0,85,10,0,0,255,0,85,0,85,85,340,72,3,0,25,0,0,0,25,75,25,0,25
06,California/CA,0601901,"Fresno County (West)--Selma, Kerman & Coalinga Cities PUMA, California/CA",06019,"Fresno County, California",978130,28106,382,2873,39,1,376,1412,10924,2137,69,127,2513,1481,11051,196,12336,12532,15045,2,14,1,82,0,9,1,73,17,83,10,73
06,California/CA,0601902,"Fresno County (North Central)--Fresno City (North) PUMA, California/CA",06019,"Fresno County, California",978130,28106,382,2873,39,1,477,238,305,224,182,11,701,420,316,193,543,736,1437,33,16,13,38,13,17,1,21,49,51,29,22
06,California/CA,0601903,"Fresno County (Central)--Fresno City (East Central) PUMA, California/CA",06019,"Fresno County, California",978130,28106,382,2873,39,1,235,94,758,441,78,54,676,172,812,132,852,984,1660,14,27,8,51,5,6,3,46,41,59,10,49
06,California/CA,0601904,"Fresno County (Central)--Fresno City (Southwest) PUMA, California/CA",06019,"Fresno County, California",978130,28106,382,2873,39,1,299,648,2570,1307,162,228,1606,810,2798,390,3218,3608,5214,6,25,7,62,3,12,4,49,31,69,16,54
06,California/CA,0601905,"Fresno County (Central)--Fresno City (Southeast) PUMA, California/CA",06019,"Fresno County, California",978130,28106,382,2873,39,1,116,549,3690,782,157,254,898,706,3944,411,4239,4650,5548,2,14,7,76,3,10,5,67,16,84,13,71
06,California/CA,0601906,"Fresno County (Central)--Clovis City PUMA, California/CA",06019,"Fresno County, California",978130,28106,382,2873,39,1,156,121,303,172,56,45,328,177,348,101,424,525,853,18,20,12,50,7,14,5,36,38,62,21,41
06,California/CA,0601907,"Fresno County (East)--Sanger, Reedley & Parlier Cities PUMA, California/CA",06019,"Fresno County, California",978130,28106,382,2873,39,1,205,927,6805,1469,61,0,1674,988,6805,61,7732,7793,9467,2,16,1,82,1,10,0,72,18,82,10,72
06,California/CA,0602300,"Humboldt County PUMA, California/CA",06023,"Humboldt County, California",135768,501,7,369,5,1,508,30,618,14,0,77,522,30,695,77,648,725,1247,41,1,6,52,0,2,6,50,42,58,2,56
06,California/CA,0602500,"Imperial County--El Centro City PUMA, California/CA",06025,"Imperial County, California",180216,11781,316,6537,175,1,179,962,2120,1221,24,0,1400,986,2120,24,3082,3106,4506,4,27,1,68,1,21,0,47,31,69,22,47
06,California/CA,0602901,"Kern County (West)--Delano, Wasco & Shafter Cities PUMA, California/CA",06029,"Kern County, California",883053,31865,367,3609,42,1,348,1534,10405,2786,235,244,3134,1769,10649,479,11939,12418,15552,2,18,3,77,2,10,2,67,20,80,11,68
06,California/CA,0602902,"Kern County (Central)--Bakersfield City (West) PUMA, California/CA",06029,"Kern County, California",883053,31865,367,3609,42,1,531,493,836,1029,259,251,1560,752,1087,510,1329,1839,3399,16,30,15,39,8,15,7,25,46,54,22,32
06,California/CA,0602903,"Kern County (Central)--Bakersfield City (Northeast) PUMA, California/CA",06029,"Kern County, California",883053,31865,367,3609,42,1,218,763,4359,1783,0,12,2001,763,4371,12,5122,5134,7135,3,25,0,72,0,11,0,61,28,72,11,61
06,California/CA,0602904,"Kern County (Central)--Bakersfield City (Southeast) PUMA, California/CA",06029,"Kern County, California",883053,31865,367,3609,42,1,193,614,5760,1236,5,0,1429,619,5760,5,6374,6379,7808,2,16,0,82,0,8,0,74,18,82,8,74
06,California/CA,0602905,"Kern County (East)--Ridgecrest, Arvin, Tehachapi & California City Cities PUMA, California/CA",06029,"Kern County, California",883053,31865,367,3609,42,1,361,399,3108,1077,0,0,1438,399,3108,0,3507,3507,4945,7,22,0,71,0,8,0,63,29,71,8,63
06,California/CA,0603100,"Kings County--Hanford City PUMA, California/CA",06031,"Kings County, California",150075,7645,77,5094,51,1,963,822,4837,1575,24,29,2538,846,4866,53,5659,5712,8250,12,19,1,69,0,10,0,59,31,69,10,59
06,California/CA,0603300,"Lake & Mendocino Counties PUMA, California/CA",06033,"Lake County, California",64148,531,11,828,17,0.423,114,133,604,190,9,14,304,142,618,23,737,760,1064,11,18,2,69,1,12,1,57,29,71,13,58
06,California/CA,0603300,"Lake & Mendocino Counties PUMA, California/CA",06045,"Mendocino County, California",87422,908,18,1039,21,0.577,155,182,824,258,12,19,413,194,843,31,1006,1037,1450,11,18,2,69,1,13,1,57,28,72,13,58
06,California/CA,0603701,"Los Angeles County (North/Unincorporated)--Castaic PUMA, California/CA",06037,"Los Angeles County, California",10098052,265775,6488,2632,64,1,88,26,133,128,0,0,216,26,133,0,159,159,375,23,34,0,42,0,7,0,35,58,42,7,35
06,California/CA,0603702,"Los Angeles County (Northwest)--Santa Clarita City PUMA, California/CA",06037,"Los Angeles County, California",10098052,265775,6488,2632,64,1,0,71,0,62,9,0,62,80,0,9,71,80,142,0,44,6,50,6,50,0,0,44,56,56,0
06,California/CA,0603703,"Los Angeles County (North Central)--Lancaster City PUMA, California/CA",06037,"Los Angeles County, California",10098052,265775,6488,2632,64,1,91,46,88,161,17,0,252,63,88,17,134,151,403,23,40,4,33,4,11,0,22,63,37,16,22
06,California/CA,0603704,"Los Angeles County (North Central)--Palmdale City PUMA, California/CA",06037,"Los Angeles County, California",10098052,265775,6488,2632,64,1,80,93,288,180,0,0,260,93,288,0,381,381,641,12,28,0,59,0,15,0,45,41,59,15,45
06,California/CA,0603705,"Los Angeles County (North)--LA City (Northwest/Chatsworth & Porter Ranch) PUMA, California/CA",06037,"Los Angeles County, California",10098052,265775,6488,2632,64,1,46,76,40,59,13,0,105,89,40,13,116,129,234,20,25,6,50,6,32,0,17,45,55,38,17
06,California/CA,0603706,"Los Angeles County (North)--LA City (North Central/Granada Hills & Sylmar) PUMA, California/CA",06037,"Los Angeles County, California",10098052,265775,6488,2632,64,1,33,137,187,304,16,0,337,153,187,16,324,340,677,5,45,2,48,2,20,0,28,50,50,23,28
06,California/CA,0603707,"Los Angeles County--LA (North Central/Arleta & Pacoima) & San Fernando Cities PUMA, California/CA",06037,"Los Angeles County, California",10098052,265775,6488,2632,64,1,14,373,399,519,0,0,533,373,399,0,772,772,1305,1,40,0,59,0,29,0,31,41,59,29,31
06,California/CA,0603708,"Los Angeles County (North)--LA City (Northeast/Sunland, Sun Valley & Tujunga) PUMA, California/CA",06037,"Los Angeles County, California",10098052,265775,6488,2632,64,1,72,76,179,40,39,13,112,115,192,52,255,307,419,17,10,12,61,9,18,3,43,27,73,27,46
06,California/CA,0603709,"Los Angeles County (Central)--San Gabriel Valley Region (North) PUMA, California/CA",06037,"Los Angeles County, California",10098052,265775,6488,2632,64,1,37,28,0,49,23,0,86,51,0,23,28,51,137,27,36,17,20,17,20,0,0,63,37,37,0
06,California/CA,0603710,"Los Angeles County--Baldwin Park, Azusa, Duarte & Irwindale Cities PUMA, California/CA",06037,"Los Angeles County, California",10098052,265775,6488,2632,64,1,68,282,531,328,12,61,396,294,592,73,813,886,1282,5,26,6,63,1,22,5,41,31,69,23,46
06,California/CA,0603711,"Los Angeles County (East Central)--Glendora, Claremont, San Dimas & La Verne Cities PUMA, California/CA",06037,"Los Angeles County, California",10098052,265775,6488,2632,64,1,99,103,6,146,25,0,245,128,6,25,109,134,379,26,39,7,29,7,27,0,2,65,35,34,2
06,California/CA,0603712,"Los Angeles County (East Central)--Pomona City PUMA, California/CA",06037,"Los Angeles County, California",10098052,265775,6488,2632,64,1,17,174,497,400,0,12,417,174,509,12,671,683,1100,2,36,1,61,0,16,1,45,38,62,16,46
06,California/CA,0603713,"Los Angeles County (East Central)--Covina & Walnut Cities PUMA, California/CA",06037,"Los Angeles County, California",10098052,265775,6488,2632,64,1,89,74,134,132,0,0,221,74,134,0,208,208,429,21,31,0,48,0,17,0,31,52,48,17,31
06,California/CA,0603714,"Los Angeles County--Diamond Bar, La Habra Heights (East) Cities & Rowland Heights PUMA, California/CA",06037,"Los Angeles County, California",10098052,265775,6488,2632,64,1,25,31,0,52,48,50,77,79,50,98,31,129,206,12,25,48,15,23,15,24,0,37,63,38,24
06,California/CA,0603715,"Los Angeles County (East Central)--West Covina City PUMA, California/CA",06037,"Los Angeles County, California",10098052,265775,6488,2632,64,1,22,254,241,281,8,5,303,262,246,13,495,508,811,3,35,2,61,1,31,1,30,37,63,32,30
06,California/CA,0603716,"Los Angeles County (East Central)--La Puente & Industry Cities PUMA, California/CA",06037,"Los Angeles County, California",10098052,265775,6488,2632,64,1,53,285,576,176,24,0,229,309,576,24,861,885,1114,5,16,2,77,2,26,0,52,21,79,28,52
06,California/CA,0603717,"Los Angeles County (East Central)--Arcadia, San Gabriel & Temple City Cities PUMA, California/CA",06037,"Los Angeles County, California",10098052,265775,6488,2632,64,1,17,48,166,84,55,135,101,103,301,190,214,404,505,3,17,38,42,11,10,27,33,20,80,20,60
06,California/CA,0603718,"Los Angeles County (Central)--Pasadena City PUMA, California/CA",06037,"Los Angeles County, California",10098052,265775,6488,2632,64,1,22,51,65,0,38,0,22,89,65,38,116,154,176,12,0,22,66,22,29,0,37,12,88,51,37
06,California/CA,0603719,"Los Angeles County (Central)--Glendale City PUMA, California/CA",06037,"Los Angeles County, California",10098052,265775,6488,2632,64,1,0,27,117,64,85,117,64,112,234,202,144,346,410,0,16,49,35,21,7,29,29,16,84,27,57
06,California/CA,0603720,"Los Angeles County (Central)--Burbank City PUMA, California/CA",06037,"Los Angeles County, California",10098052,265775,6488,2632,64,1,0,13,119,11,0,23,11,13,142,23,132,155,166,0,7,14,80,0,8,14,72,7,93,8,86
06,California/CA,0603721,"Los Angeles County (North)--LA City (Northeast/North Hollywood & Valley Village) PUMA, California/CA",06037,"Los Angeles County, California",10098052,265775,6488,2632,64,1,0,44,113,113,43,0,113,87,113,43,157,200,313,0,36,14,50,14,14,0,36,36,64,28,36
06,California/CA,0603722,"Los Angeles County (Northwest)--LA City (North Central/Van Nuys & North Sherman Oaks) PUMA, California/CA",06037,"Los Angeles County, California",10098052,265775,6488,2632,64,1,28,136,366,53,0,17,81,136,383,17,502,519,600,5,9,3,84,0,23,3,61,14,86,23,64
06,California/CA,0603723,"Los Angeles County (North)--LA City (North Central/Mission Hills & Panorama City) PUMA, California/CA",06037,"Los Angeles County, California",10098052,265775,6488,2632,64,1,0,166,465,172,7,0,172,173,465,7,631,638,810,0,21,1,78,1,20,0,57,21,79,21,57
06,California/CA,0603724,"Los Angeles County (Northwest)--LA City (Northwest/Encino & Tarzana) PUMA, California/CA",06037,"Los Angeles County, California",10098052,265775,6488,2632,64,1,13,72,145,251,0,20,264,72,165,20,217,237,501,3,50,4,43,0,14,4,29,53,47,14,33
06,California/CA,0603725,"Los Angeles County--LA City (Northwest/Canoga Park, Winnetka & Woodland Hills) PUMA, California/CA",06037,"Los Angeles County, California",10098052,265775,6488,2632,64,1,0,46,229,242,0,0,242,46,229,0,275,275,517,0,47,0,53,0,9,0,44,47,53,9,44
06,California/CA,0603726,"Los Angeles County--Calabasas, Agoura Hills, Malibu & Westlake Village Cities PUMA, California/CA",06037,"Los Angeles County, California",10098052,265775,6488,2632,64,1,30,15,26,0,52,0,30,67,26,52,41,93,123,24,0,42,33,42,12,0,21,24,76,54,21
06,California/CA,0603727,"Los Angeles County (Central)--LA City (Central/Pacific Palisades) PUMA, California/CA",06037,"Los Angeles County, California",10098052,265775,6488,2632,64,1,33,0,0,0,0,0,33,0,0,0,0,0,33,100,0,0,0,0,0,0,0,100,0,0,0
06,California/CA,0603728,"Los Angeles County (Southwest)--Santa Monica City PUMA, California/CA",06037,"Los Angeles County, California",10098052,265775,6488,2632,64,1,0,0,0,16,0,0,16,0,0,0,0,0,16,0,100,0,0,0,0,0,0,100,0,0,0
06,California/CA,0603729,"Los Angeles County (West Central)--LA City (West Central/Westwood & West Los Angeles) PUMA, California/CA",06037,"Los Angeles County, California",10098052,265775,6488,2632,64,1,88,0,26,0,0,0,88,0,26,0,26,26,114,77,0,0,23,0,0,0,23,77,23,0,23
06,California/CA,0603730,"Los Angeles County (West Central)--LA City (Central/Hancock Park & Mid-Wilshire) PUMA, California/CA",06037,"Los Angeles County, California",10098052,265775,6488,2632,64,1,51,23,66,21,7,39,72,30,105,46,89,135,207,25,10,22,43,3,11,19,32,35,65,14,51
06,California/CA,0603731,"Los Angeles County (Central)--West Hollywood & Beverly Hills Cities PUMA, California/CA",06037,"Los Angeles County, California",10098052,265775,6488,2632,64,1,0,0,0,35,0,0,35,0,0,0,0,0,35,0,100,0,0,0,0,0,0,100,0,0,0
06,California/CA,0603732,"Los Angeles County (Central)--LA City (East Central/Hollywood) PUMA, California/CA",06037,"Los Angeles County, California",10098052,265775,6488,2632,64,1,0,70,223,105,0,0,105,70,223,0,293,293,398,0,26,0,74,0,18,0,56,26,74,18,56
06,California/CA,0603733,"Los Angeles County (Central)--LA City (Central/Koreatown) PUMA, California/CA",06037,"Los Angeles County, California",10098052,265775,6488,2632,64,1,23,20,324,34,0,18,57,20,342,18,344,362,419,5,8,4,82,0,5,4,77,14,86,5,82
06,California/CA,0603734,"Los Angeles County--LA City (East Central/Silver Lake, Echo Park & Westlake) PUMA, California/CA",06037,"Los Angeles County, California",10098052,265775,6488,2632,64,1,0,95,432,90,13,32,90,108,464,45,527,572,662,0,14,7,80,2,14,5,65,14,86,16,70
06,California/CA,0603735,"Los Angeles County--LA City (Mount Washington, Highland Park & Glassell Park) PUMA, California/CA",06037,"Los Angeles County, California",10098052,265775,6488,2632,64,1,28,174,306,78,13,15,106,187,321,28,480,508,614,5,13,5,78,2,28,2,50,17,83,30,52
06,California/CA,0603736,"Los Angeles County (Central)--Alhambra & South Pasadena Cities PUMA, California/CA",06037,"Los Angeles County, California",10098052,265775,6488,2632,64,1,13,54,145,112,31,40,125,85,185,71,199,270,395,3,28,18,50,8,14,10,37,32,68,22,47
06,California/CA,0603737,"Los Angeles County (Central)--Monterey Park & Rosemead Cities PUMA, California/CA",06037,"Los Angeles County, California",10098052,265775,6488,2632,64,1,34,11,143,98,160,54,132,171,197,214,154,368,500,7,20,43,31,32,2,11,29,26,74,34,39
06,California/CA,0603738,"Los Angeles County (Central)--El Monte & South El Monte Cities PUMA, California/CA",06037,"Los Angeles County, California",10098052,265775,6488,2632,64,1,37,89,417,253,35,45,290,124,462,80,506,586,876,4,29,9,58,4,10,5,48,33,67,14,53
06,California/CA,0603739,"Los Angeles County (Southeast)--Whittier City & Hacienda Heights PUMA, California/CA",06037,"Los Angeles County, California",10098052,265775,6488,2632,64,1,53,80,179,236,16,59,289,96,238,75,259,334,623,9,38,12,42,3,13,9,29,46,54,15,38
06,California/CA,0603740,"Los Angeles County (Central)--Pico Rivera & Montebello Cities PUMA, California/CA",06037,"Los Angeles County, California",10098052,265775,6488,2632,64,1,0,160,195,254,0,59,254,160,254,59,355,414,668,0,38,9,53,0,24,9,29,38,62,24,38
06,California/CA,0603741,"Los Angeles County (Central)--Bell Gardens, Bell, Maywood, Cudahy & Commerce Cities PUMA, California/CA",06037,"Los Angeles County, California",10098052,265775,6488,2632,64,1,0,259,1079,152,0,0,152,259,1079,0,1338,1338,1490,0,10,0,90,0,17,0,72,10,90,17,72
06,California/CA,0603742,"Los Angeles County (Central)--Huntington Park City, Florence-Graham & Walnut Park PUMA, California/CA",06037,"Los Angeles County, California",10098052,265775,6488,2632,64,1,11,352,1044,354,0,0,365,352,1044,0,1396,1396,1761,1,20,0,79,0,20,0,59,21,79,20,59
06,California/CA,0603743,"Los Angeles County (Central)--East Los Angeles PUMA, California/CA",06037,"Los Angeles County, California",10098052,265775,6488,2632,64,1,0,167,712,204,0,0,204,167,712,0,879,879,1083,0,19,0,81,0,15,0,66,19,81,15,66
06,California/CA,0603744,"Los Angeles County (Central)--LA City (East Central/Central City & Boyle Heights) PUMA, California/CA",06037,"Los Angeles County, California",10098052,265775,6488,2632,64,1,0,81,1084,211,33,40,211,114,1124,73,1165,1238,1449,0,15,5,80,2,6,3,75,15,85,8,78
06,California/CA,0603745,"Los Angeles County (Central)--LA City (Southeast/East Vernon) PUMA, California/CA",06037,"Los Angeles County, California",10098052,265775,6488,2632,64,1,0,76,815,97,0,0,97,76,815,0,891,891,988,0,10,0,90,0,8,0,82,10,90,8,82
06,California/CA,0603746,"Los Angeles County--LA City (Central/Univ. of Southern California & Exposition Park) PUMA, California/CA",06037,"Los Angeles County, California",10098052,265775,6488,2632,64,1,54,76,207,77,0,27,131,76,234,27,283,310,441,12,17,6,64,0,17,6,47,30,70,17,53
06,California/CA,0603747,"Los Angeles County (Central)--LA City (Central/West Adams & Baldwin Hills) PUMA, California/CA",06037,"Los Angeles County, California",10098052,265775,6488,2632,64,1,80,151,157,7,21,0,87,172,157,21,308,329,416,19,2,5,74,5,36,0,38,21,79,41,38
06,California/CA,0603748,"Los Angeles County--LA (Southwest/Marina del Rey & Westchester) & Culver City Cities PUMA, California/CA",06037,"Los Angeles County, California",10098052,265775,6488,2632,64,1,62,0,23,0,0,10,62,0,33,10,23,33,95,65,0,11,24,0,0,11,24,65,35,0,35
06,California/CA,0603749,"Los Angeles County (Central)--Inglewood City PUMA, California/CA",06037,"Los Angeles County, California",10098052,265775,6488,2632,64,1,73,39,83,152,0,0,225,39,83,0,122,122,347,21,44,0,35,0,11,0,24,65,35,11,24
06,California/CA,0603750,"Los Angeles County (South Central)--LA City (South Central/Westmont) PUMA, California/CA",06037,"Los Angeles County, California",10098052,265775,6488,2632,64,1,140,267,395,229,13,0,369,280,395,13,662,675,1044,13,22,1,63,1,26,0,38,35,65,27,38
06,California/CA,0603751,"Los Angeles County (South Central)--LA City (South Central/Watts) PUMA, California/CA",06037,"Los Angeles County, California",10098052,265775,6488,2632,64,1,52,229,576,240,0,0,292,229,576,0,805,805,1097,5,22,0,73,0,21,0,53,27,73,21,53
06,California/CA,0603752,"Los Angeles County (South)--South Gate & Lynwood Cities PUMA, California/CA",06037,"Los Angeles County, California",10098052,265775,6488,2632,64,1,16,251,582,191,0,0,207,251,582,0,833,833,1040,2,18,0,80,0,24,0,56,20,80,24,56
06,California/CA,0603753,"Los Angeles County (South)--Downey City PUMA, California/CA",06037,"Los Angeles County, California",10098052,265775,6488,2632,64,1,62,68,78,166,0,0,228,68,78,0,146,146,374,17,44,0,39,0,18,0,21,61,39,18,21
06,California/CA,0603754,"Los Angeles County (Southeast)--La Mirada & Santa Fe Springs Cities PUMA, California/CA",06037,"Los Angeles County, California",10098052,265775,6488,2632,64,1,62,28,43,275,0,9,337,28,52,9,71,80,417,15,66,2,17,0,7,2,10,81,19,7,12
06,California/CA,0603755,"Los Angeles County (Southeast)--Norwalk City PUMA, California/CA",06037,"Los Angeles County, California",10098052,265775,6488,2632,64,1,45,211,228,120,29,36,165,240,264,65,439,504,669,7,18,10,66,4,32,5,34,25,75,36,39
06,California/CA,0603756,"Los Angeles County (Southeast)--Bellflower & Paramount Cities PUMA, California/CA",06037,"Los Angeles County, California",10098052,265775,6488,2632,64,1,34,13,236,158,0,13,192,13,249,13,249,262,454,7,35,3,55,0,3,3,52,42,58,3,55
06,California/CA,0603757,"Los Angeles County (South Central)--Compton City & West Rancho Dominguez PUMA, California/CA",06037,"Los Angeles County, California",10098052,265775,6488,2632,64,1,41,184,661,145,0,0,186,184,661,0,845,845,1031,4,14,0,82,0,18,0,64,18,82,18,64
06,California/CA,0603758,"Los Angeles County (South Central)--Gardena, Lawndale Cities & West Athens PUMA, California/CA",06037,"Los Angeles County, California",10098052,265775,6488,2632,64,1,54,47,303,109,60,0,163,107,303,60,350,410,573,9,19,10,61,10,8,0,53,28,72,19,53
06,California/CA,0603759,"Los Angeles County (South Central)--Hawthorne City PUMA, California/CA",06037,"Los Angeles County, California",10098052,265775,6488,2632,64,1,29,77,259,47,0,0,76,77,259,0,336,336,412,7,11,0,82,0,19,0,63,18,82,19,63
06,California/CA,0603760,"Los Angeles County--Redondo Beach, Manhattan Beach & Hermosa Beach Cities PUMA, California/CA",06037,"Los Angeles County, California",10098052,265775,6488,2632,64,1,25,0,0,124,0,0,149,0,0,0,0,0,149,17,83,0,0,0,0,0,0,100,0,0,0
06,California/CA,0603761,"Los Angeles County (South Central)--Torrance City PUMA, California/CA",06037,"Los Angeles County, California",10098052,265775,6488,2632,64,1,12,0,0,0,12,0,12,12,0,12,0,12,24,50,0,50,0,50,0,0,0,50,50,50,0
06,California/CA,0603762,"Los Angeles County (South Central)--Carson City PUMA, California/CA",06037,"Los Angeles County, California",10098052,265775,6488,2632,64,1,45,8,113,153,21,53,198,29,166,74,121,195,393,11,39,19,31,5,2,13,29,50,50,7,42
06,California/CA,0603763,"Los Angeles County (South Central)--Long Beach City (North) PUMA, California/CA",06037,"Los Angeles County, California",10098052,265775,6488,2632,64,1,12,53,466,99,14,0,111,67,466,14,519,533,644,2,15,2,81,2,8,0,72,17,83,10,72
06,California/CA,0603764,"Los Angeles County (South)--Lakewood, Cerritos, Artesia & Hawaiian Gardens Cities PUMA, California/CA",06037,"Los Angeles County, California",10098052,265775,6488,2632,64,1,101,0,142,78,11,0,179,11,142,11,142,153,332,30,23,3,43,3,0,0,43,54,46,3,43
06,California/CA,0603765,"Los Angeles County (Southeast)--Long Beach City (East) PUMA, California/CA",06037,"Los Angeles County, California",10098052,265775,6488,2632,64,1,38,12,0,150,0,0,188,12,0,0,12,12,200,19,75,0,6,0,6,0,0,94,6,6,0
06,California/CA,0603766,"Los Angeles County (South)--Long Beach City (Southwest & Port) PUMA, California/CA",06037,"Los Angeles County, California",10098052,265775,6488,2632,64,1,72,40,281,77,15,0,149,55,281,15,321,336,485,15,16,3,66,3,8,0,58,31,69,11,58
06,California/CA,0603767,"Los Angeles County (South)--LA City (South/San Pedro) PUMA, California/CA",06037,"Los Angeles County, California",10098052,265775,6488,2632,64,1,14,118,159,121,0,0,135,118,159,0,277,277,412,3,29,0,67,0,29,0,39,33,67,29,39
06,California/CA,0603768,"Los Angeles County (Southwest)--Palos Verdes Peninsula PUMA, California/CA",06037,"Los Angeles County, California",10098052,265775,6488,2632,64,1,67,0,47,0,0,0,67,0,47,0,47,47,114,59,0,0,41,0,0,0,41,59,41,0,41
06,California/CA,0603769,"Los Angeles County (Southeast)--Long Beach (Central) & Signal Hill Cities PUMA, California/CA",06037,"Los Angeles County, California",10098052,265775,6488,2632,64,1,0,27,0,21,26,0,21,53,0,26,27,53,74,0,28,35,36,35,36,0,0,28,72,72,0
06,California/CA,0603900,"Madera County--Madera City PUMA, California/CA",06039,"Madera County, California",155013,4458,65,2876,42,1,245,715,6180,1369,0,82,1614,715,6262,82,6895,6977,8591,3,16,1,80,0,8,1,72,19,81,8,73
06,California/CA,0604101,"Marin County (North & West)--Novato & San Rafael (North) Cities PUMA, California/CA",06041,"Marin County, California",260295,6694,116,2572,45,1,227,40,12,0,13,0,227,53,12,13,52,65,292,78,0,4,18,4,14,0,4,78,22,18,4
06,California/CA,0604102,"Marin County (Southeast)--San Rafael (South), Mill Valley & Sausalito Cities PUMA, California/CA",06041,"Marin County, California",260295,6694,116,2572,45,1,110,41,57,32,0,0,142,41,57,0,98,98,240,46,13,0,41,0,17,0,24,59,41,17,24
06,California/CA,0604701,"Merced County (West & South)--Los Banos & Livingston Cities PUMA, California/CA",06047,"Merced County, California",269075,8872,142,3297,53,1,705,1102,4436,929,361,229,1634,1463,4665,590,5538,6128,7762,9,12,8,71,5,14,3,57,21,79,19,60
06,California/CA,0604702,"Merced County (Northeast)--Merced & Atwater Cities PUMA, California/CA",06047,"Merced County, California",269075,8872,142,3297,53,1,442,1004,5045,871,165,90,1313,1169,5135,255,6049,6304,7617,6,11,3,79,2,13,1,66,17,83,15,67
06,California/CA,0605301,"Monterey County (North Central)--Seaside, Monterey, Marina & Pacific Grove Cities PUMA, California/CA",06053,"Monterey County, California",433212,9807,71,2264,16,1,144,122,2533,422,0,223,566,122,2756,223,2655,2878,3444,4,12,6,77,0,4,6,74,16,84,4,80
06,California/CA,0605302,"Monterey County (Northeast)--Salinas City PUMA, California/CA",06053,"Monterey County, California",433212,9807,71,2264,16,1,200,627,13760,1283,61,24,1483,688,13784,85,14387,14472,15955,1,8,1,90,0,4,0,86,9,91,4,86
06,California/CA,0605303,"Monterey (South & East) & San Benito Counties PUMA, California/CA",06053,"Monterey County, California",433212,9807,71,2264,16,0.576,158,552,5214,885,2,27,1043,554,5241,29,5766,5795,6838,2,13,0,84,0,8,0,76,15,85,8,77
06,California/CA,0605303,"Monterey (South & East) & San Benito Counties PUMA, California/CA",06069,"San Benito County, California",59416,1331,11,2240,19,0.424,116,406,3838,651,1,20,767,407,3858,21,4244,4265,5032,2,13,0,84,0,8,0,76,15,85,8,77
06,California/CA,0605500,"Napa County--Napa City PUMA, California/CA",06055,"Napa County, California",140530,1662,13,1183,9,1,236,288,2161,192,76,36,428,364,2197,112,2449,2561,2989,8,6,4,82,3,10,1,72,14,86,12,74
06,California/CA,0605700,"Nevada & Sierra Counties PUMA, California/CA",06057,"Nevada County, California",99092,533,7,538,7,0.971,118,73,2,0,0,0,118,73,2,0,75,75,193,61,0,0,39,0,38,0,1,61,39,38,1
06,California/CA,0605700,"Nevada & Sierra Counties PUMA, California/CA",06091,"Sierra County, California",2930,6,0,205,0,0.029,4,2,0,0,0,0,4,2,0,0,2,2,6,67,0,0,33,0,33,0,0,67,33,33,0
06,California/CA,0605901,"Orange County (Southwest)--San Clemente, Laguna Niguel & San Juan Capistrano Cities PUMA, California/CA",06059,"Orange County, California",3164182,54328,1204,1717,38,1,70,0,41,40,0,0,110,0,41,0,41,41,151,46,26,0,27,0,0,0,27,73,27,0,27
06,California/CA,0605902,"Orange County (South Central)--Mission Viejo & Rancho Santa Margarita (West) Cities PUMA, California/CA",06059,"Orange County, California",3164182,54328,1204,1717,38,1,0,15,12,52,0,0,52,15,12,0,27,27,79,0,66,0,34,0,19,0,15,66,34,19,15
06,California/CA,0605903,"Orange County (West Central)--Newport Beach, Aliso Viejo & Laguna Hills Cities PUMA, California/CA",06059,"Orange County, California",3164182,54328,1204,1717,38,1,28,28,83,31,0,0,59,28,83,0,111,111,170,16,18,0,65,0,16,0,49,35,65,16,49
06,California/CA,0605904,"Orange County (Central)--Irvine City (Central) PUMA, California/CA",06059,"Orange County, California",3164182,54328,1204,1717,38,1,106,0,227,82,0,60,188,0,287,60,227,287,475,22,17,13,48,0,0,13,48,40,60,0,60
06,California/CA,0605905,"Orange County (Northeast)--Lake Forest, Irvine (North) Cities & Silverado PUMA, California/CA",06059,"Orange County, California",3164182,54328,1204,1717,38,1,68,30,461,140,0,20,208,30,481,20,491,511,719,9,19,3,68,0,4,3,64,29,71,4,67
06,California/CA,0605906,"Orange County (North)--Yorba Linda, La Habra & Brea Cities PUMA, California/CA",06059,"Orange County, California",3164182,54328,1204,1717,38,1,25,85,369,70,18,0,95,103,369,18,454,472,567,4,12,3,80,3,15,0,65,17,83,18,65
06,California/CA,0605907,"Orange County (North Central)--Fullerton & Placentia Cities PUMA, California/CA",06059,"Orange County, California",3164182,54328,1204,1717,38,1,15,77,365,141,30,0,156,107,365,30,442,472,628,2,22,5,70,5,12,0,58,25,75,17,58
06,California/CA,0605908,"Orange County (Northwest)--Buena Park, Cypress & Seal Beach Cities PUMA, California/CA",06059,"Orange County, California",3164182,54328,1204,1717,38,1,62,87,97,120,0,0,182,87,97,0,184,184,366,17,33,0,50,0,24,0,27,50,50,24,27
06,California/CA,0605909,"Orange County (North Central)--Anaheim City (West) PUMA, California/CA",06059,"Orange County, California",3164182,54328,1204,1717,38,1,12,117,297,111,99,86,123,216,383,185,414,599,722,2,15,26,57,14,16,12,41,17,83,30,53
06,California/CA,0605910,"Orange County (North Central)--Anaheim City (East) PUMA, California/CA",06059,"Orange County, California",3164182,54328,1204,1717,38,1,36,95,262,146,0,24,182,95,286,24,357,381,563,6,26,4,63,0,17,4,47,32,68,17,51
06,California/CA,0605911,"Orange County (Central)--Orange & Villa Park Cities PUMA, California/CA",06059,"Orange County, California",3164182,54328,1204,1717,38,1,0,20,227,12,0,0,12,20,227,0,247,247,259,0,5,0,95,0,8,0,88,5,95,8,88
06,California/CA,0605912,"Orange County (Northwest)--Westminster, Stanton & Garden Grove (West) Cities PUMA, California/CA",06059,"Orange County, California",3164182,54328,1204,1717,38,1,67,16,393,167,117,0,234,133,393,117,409,526,760,9,22,15,54,15,2,0,52,31,69,18,52
06,California/CA,0605913,"Orange County (Northwest)--Garden Grove City (East) PUMA, California/CA",06059,"Orange County, California",3164182,54328,1204,1717,38,1,0,120,209,230,72,86,230,192,295,158,329,487,717,0,32,22,46,10,17,12,29,32,68,27,41
06,California/CA,0605914,"Orange County (Northwest)--Huntington Beach City PUMA, California/CA",06059,"Orange County, California",3164182,54328,1204,1717,38,1,149,20,372,158,0,22,307,20,394,22,392,414,721,21,22,3,54,0,3,3,52,43,57,3,55
06,California/CA,0605915,"Orange County (Southeast)--Rancho Santa Margarita City (East) & Ladera Ranch PUMA, California/CA",06059,"Orange County, California",3164182,54328,1204,1717,38,1,31,0,48,0,27,0,31,27,48,27,48,75,106,29,0,25,45,25,0,0,45,29,71,25,45
06,California/CA,0605916,"Orange County (Central)--Santa Ana City (West) PUMA, California/CA",06059,"Orange County, California",3164182,54328,1204,1717,38,1,12,146,978,162,0,0,174,146,978,0,1124,1124,1298,1,12,0,87,0,11,0,75,13,87,11,75
06,California/CA,0605917,"Orange County (Central)--Santa Ana City (East) PUMA, California/CA",06059,"Orange County, California",3164182,54328,1204,1717,38,1,20,191,952,225,0,0,245,191,952,0,1143,1143,1388,1,16,0,82,0,14,0,69,18,82,14,69
06,California/CA,0605918,"Orange County (Central)--Costa Mesa & Fountain Valley Cities PUMA, California/CA",06059,"Orange County, California",3164182,54328,1204,1717,38,1,36,87,107,144,41,42,180,128,149,83,194,277,457,8,32,18,42,9,19,9,23,39,61,28,33
06,California/CA,0606101,"Placer County (Southwest)--Roseville City PUMA, California/CA",06061,"Placer County, California",380077,3542,44,932,12,1,68,58,25,78,0,0,146,58,25,0,83,83,229,30,34,0,36,0,25,0,11,64,36,25,11
06,California/CA,0606102,"Placer County (Central)--Rocklin, Lincoln Cities & Loomis Town PUMA, California/CA",06061,"Placer County, California",380077,3542,44,932,12,1,227,0,11,37,27,0,264,27,11,27,11,38,302,75,12,9,4,9,0,0,4,87,13,9,4
06,California/CA,0606103,"Placer County (East/High Country Region)--Auburn & Colfax Cities PUMA, California/CA",06061,"Placer County, California",380077,3542,44,932,12,1,18,0,58,0,0,0,18,0,58,0,58,58,76,24,0,0,76,0,0,0,76,24,76,0,76
06,California/CA,0606501,"Riverside County (East)--Indio, Coachella, Blythe & La Quinta (East) Cities PUMA, California/CA",06065,"Riverside County, California",2383286,58178,1189,2441,50,1,46,750,5073,634,0,35,680,750,5108,35,5823,5858,6538,1,10,1,89,0,11,1,78,10,90,11,78
06,California/CA,0606502,"Riverside County (Central)--Cathedral City, Palm Springs & Rancho Mirage Cities PUMA, California/CA",06065,"Riverside County, California",2383286,58178,1189,2441,50,1,56,82,193,128,18,0,184,100,193,18,275,293,477,12,27,4,58,4,17,0,40,39,61,21,40
06,California/CA,0606503,"Riverside County (Southwest)--Temecula City PUMA, California/CA",06065,"Riverside County, California",2383286,58178,1189,2441,50,1,11,16,66,20,0,0,31,16,66,0,82,82,113,10,18,0,73,0,14,0,58,27,73,14,58
06,California/CA,0606504,"Riverside County (Southwest)--Murrieta & Wildomar Cities PUMA, California/CA",06065,"Riverside County, California",2383286,58178,1189,2441,50,1,91,53,11,79,26,0,170,79,11,26,64,90,260,35,30,10,25,10,20,0,4,65,35,30,4
06,California/CA,0606505,"Riverside County (Southwest)--Menifee, Lake Elsinore & Canyon Lake Cities PUMA, California/CA",06065,"Riverside County, California",2383286,58178,1189,2441,50,1,47,49,81,157,0,0,204,49,81,0,130,130,334,14,47,0,39,0,15,0,24,61,39,15,24
06,California/CA,0606506,"Riverside County (Southwest)--Hemet City & East Hemet PUMA, California/CA",06065,"Riverside County, California",2383286,58178,1189,2441,50,1,86,80,232,156,0,0,242,80,232,0,312,312,554,16,28,0,56,0,14,0,42,44,56,14,42
06,California/CA,0606507,"Riverside County (North Central)--San Jacinto, Beaumont, Banning & Calimesa Cities PUMA, California/CA",06065,"Riverside County, California",2383286,58178,1189,2441,50,1,71,168,295,131,18,0,202,186,295,18,463,481,683,10,19,3,68,3,25,0,43,30,70,27,43
06,California/CA,0606508,"Riverside County (Northwest)--Moreno Valley City PUMA, California/CA",06065,"Riverside County, California",2383286,58178,1189,2441,50,1,76,69,242,179,0,0,255,69,242,0,311,311,566,13,32,0,55,0,12,0,43,45,55,12,43
06,California/CA,0606509,"Riverside County (West Central)--Perris City, Temescal Valley & Mead Valley PUMA, California/CA",06065,"Riverside County, California",2383286,58178,1189,2441,50,1,16,55,84,205,0,0,221,55,84,0,139,139,360,4,57,0,39,0,15,0,23,61,39,15,23
06,California/CA,0606510,"Riverside County (Northwest)--Riverside City (East) PUMA, California/CA",06065,"Riverside County, California",2383286,58178,1189,2441,50,1,27,66,160,164,35,0,191,101,160,35,226,261,452,6,36,8,50,8,15,0,35,42,58,22,35
06,California/CA,0606511,"Riverside County (Northwest)--Riverside City (West) PUMA, California/CA",06065,"Riverside County, California",2383286,58178,1189,2441,50,1,40,351,138,369,0,9,409,351,147,9,489,498,907,4,41,1,54,0,39,1,15,45,55,39,16
06,California/CA,0606512,"Riverside County (West Central)--Corona City (South), Woodcrest & Home Gardens PUMA, California/CA",06065,"Riverside County, California",2383286,58178,1189,2441,50,1,22,44,109,120,13,0,142,57,109,13,153,166,308,7,39,4,50,4,14,0,35,46,54,19,35
06,California/CA,0606513,"Riverside County (West Central)--Corona (Northwest) & Norco Cities PUMA, California/CA",06065,"Riverside County, California",2383286,58178,1189,2441,50,1,20,38,257,121,0,0,141,38,257,0,295,295,436,5,28,0,68,0,9,0,59,32,68,9,59
06,California/CA,0606514,"Riverside County (Northwest)--Jurupa Valley & Eastvale Cities PUMA, California/CA",06065,"Riverside County, California",2383286,58178,1189,2441,50,1,27,155,224,452,0,0,479,155,224,0,379,379,858,3,53,0,44,0,18,0,26,56,44,18,26
06,California/CA,0606515,"Riverside County--Palm Desert, La Quinta (West) & Desert Hot Springs Cities PUMA, California/CA",06065,"Riverside County, California",2383286,58178,1189,2441,50,1,185,88,52,74,0,31,259,88,83,31,140,171,430,43,17,7,33,0,20,7,12,60,40,20,19
06,California/CA,0606701,"Sacramento County (North Central)--Citrus Heights City PUMA, California/CA",06067,"Sacramento County, California",1510023,22182,406,1469,27,1,170,16,73,32,21,0,202,37,73,21,89,110,312,54,10,7,29,7,5,0,23,65,35,12,23
06,California/CA,0606702,"Sacramento County (Central)--Rancho Cordova City PUMA, California/CA",06067,"Sacramento County, California",1510023,22182,406,1469,27,1,21,0,60,34,25,0,55,25,60,25,60,85,140,15,24,18,43,18,0,0,43,39,61,18,43
06,California/CA,0606703,"Sacramento County (North Central)--Arden-Arcade, Carmichael & Fair Oaks (West) PUMA, California/CA",06067,"Sacramento County, California",1510023,22182,406,1469,27,1,107,0,0,0,0,35,107,0,35,35,0,35,142,75,0,25,0,0,0,25,0,75,25,0,25
06,California/CA,0606704,"Sacramento County (North Central)--North Highlands, Foothill Farms & McClellan Park PUMA, California/CA",06067,"Sacramento County, California",1510023,22182,406,1469,27,1,127,0,57,82,13,0,209,13,57,13,57,70,279,46,29,5,20,5,0,0,20,75,25,5,20
06,California/CA,0606705,"Sacramento County (Northwest)--Sacramento City (Northwest/Natomas) PUMA, California/CA",06067,"Sacramento County, California",1510023,22182,406,1469,27,1,200,0,65,93,8,0,293,8,65,8,65,73,366,55,25,2,18,2,0,0,18,80,20,2,18
06,California/CA,0606706,"Sacramento County (North)--Sacramento City (North), Antelope & Rio Linda PUMA, California/CA",06067,"Sacramento County, California",1510023,22182,406,1469,27,1,63,126,321,32,0,0,95,126,321,0,447,447,542,12,6,0,82,0,23,0,59,18,82,23,59
06,California/CA,0606707,"Sacramento County (West)--Sacramento City (Central/Downtown & Midtown) PUMA, California/CA",06067,"Sacramento County, California",1510023,22182,406,1469,27,1,126,0,31,62,0,0,188,0,31,0,31,31,219,58,28,0,14,0,0,0,14,86,14,0,14
06,California/CA,0606708,"Sacramento County--Sacramento City (Southeast/Fruitridge, Avondale & Depot Park) PUMA, California/CA",06067,"Sacramento County, California",1510023,22182,406,1469,27,1,133,82,423,269,90,12,402,172,435,102,505,607,1009,13,27,10,50,9,8,1,42,40,60,17,43
06,California/CA,0606709,"Sacramento County--Sacramento City (Southwest/Pocket, Meadowview & North Laguna) PUMA, California/CA",06067,"Sacramento County, California",1510023,22182,406,1469,27,1,169,159,140,58,8,0,227,167,140,8,299,307,534,32,11,1,56,1,30,0,26,43,57,31,26
06,California/CA,0606710,"Sacramento County (Central)--Elk Grove City PUMA, California/CA",06067,"Sacramento County, California",1510023,22182,406,1469,27,1,66,0,37,105,164,78,171,164,115,242,37,279,450,15,23,54,8,36,0,17,8,38,62,36,26
06,California/CA,0606711,"Sacramento County (South)--Galt, Isleton Cities & Delta Region PUMA, California/CA",06067,"Sacramento County, California",1510023,22182,406,1469,27,1,56,101,683,179,70,157,235,171,840,227,784,1011,1246,4,14,18,63,6,8,13,55,19,81,14,67
06,California/CA,0606712,"Sacramento County (Northeast)--Folsom City, Orangevale & Fair Oaks (East) PUMA, California/CA",06067,"Sacramento County, California",1510023,22182,406,1469,27,1,66,0,0,54,21,0,120,21,0,21,0,21,141,47,38,15,0,15,0,0,0,85,15,15,0
06,California/CA,0607101,"San Bernardino County (Northeast)--Twentynine Palms & Barstow Cities PUMA, California/CA",06071,"San Bernardino County, California",2135413,53669,922,2513,43,1,83,34,70,119,74,0,202,108,70,74,104,178,380,22,31,19,27,19,9,0,18,53,47,28,18
06,California/CA,0607102,"San Bernardino County (West Central)--Victorville & Adelanto Cities PUMA, California/CA",06071,"San Bernardino County, California",2135413,53669,922,2513,43,1,105,83,36,108,14,0,213,97,36,14,119,133,346,30,31,4,34,4,24,0,10,62,38,28,10
06,California/CA,0607103,"San Bernardino County (West Central)--Hesperia City & Apple Valley Town PUMA, California/CA",06071,"San Bernardino County, California",2135413,53669,922,2513,43,1,35,26,76,31,0,0,66,26,76,0,102,102,168,21,18,0,61,0,15,0,45,39,61,15,45
06,California/CA,0607104,"San Bernardino County (Southwest)--Phelan, Lake Arrowhead & Big Bear City PUMA, California/CA",06071,"San Bernardino County, California",2135413,53669,922,2513,43,1,119,7,67,126,0,0,245,7,67,0,74,74,319,37,39,0,23,0,2,0,21,77,23,2,21
06,California/CA,0607105,"San Bernardino County (Southwest)--Redlands & Yucaipa Cities PUMA, California/CA",06071,"San Bernardino County, California",2135413,53669,922,2513,43,1,124,136,150,75,0,0,199,136,150,0,286,286,485,26,15,0,59,0,28,0,31,41,59,28,31
06,California/CA,0607106,"San Bernardino County (Southwest)--Colton, Loma Linda & Grand Terrace Cities PUMA, California/CA",06071,"San Bernardino County, California",2135413,53669,922,2513,43,1,75,58,177,151,26,8,226,84,185,34,235,269,495,15,31,7,47,5,12,2,36,46,54,17,37
06,California/CA,0607107,"San Bernardino County (Southwest)--San Bernardino City (East) PUMA, California/CA",06071,"San Bernardino County, California",2135413,53669,922,2513,43,1,0,66,139,54,0,0,54,66,139,0,205,205,259,0,21,0,79,0,25,0,54,21,79,25,54
06,California/CA,0607108,"San Bernardino County (Southwest)--San Bernardino City (West) PUMA, California/CA",06071,"San Bernardino County, California",2135413,53669,922,2513,43,1,101,145,541,194,15,13,295,160,554,28,686,714,1009,10,19,3,68,1,14,1,54,29,71,16,55
06,California/CA,0607109,"San Bernardino County (Southwest)--Rialto City PUMA, California/CA",06071,"San Bernardino County, California",2135413,53669,922,2513,43,1,0,149,312,292,0,0,292,149,312,0,461,461,753,0,39,0,61,0,20,0,41,39,61,20,41
06,California/CA,0607110,"San Bernardino County (Southwest)--Fontana City (East) PUMA, California/CA",06071,"San Bernardino County, California",2135413,53669,922,2513,43,1,0,201,105,101,0,0,101,201,105,0,306,306,407,0,25,0,75,0,49,0,26,25,75,49,26
06,California/CA,0607111,"San Bernardino County (Southwest)--Rancho Cucamonga City PUMA, California/CA",06071,"San Bernardino County, California",2135413,53669,922,2513,43,1,15,84,15,78,0,0,93,84,15,0,99,99,192,8,41,0,52,0,44,0,8,48,52,44,8
06,California/CA,0607112,"San Bernardino County (Southwest)--Upland & Montclair Cities PUMA, California/CA",06071,"San Bernardino County, California",2135413,53669,922,2513,43,1,19,56,113,14,14,0,33,70,113,14,169,183,216,9,6,6,78,6,26,0,52,15,85,32,52
06,California/CA,0607113,"San Bernardino County (Southwest)--Ontario City PUMA, California/CA",06071,"San Bernardino County, California",2135413,53669,922,2513,43,1,87,109,990,217,40,0,304,149,990,40,1099,1139,1443,6,15,3,76,3,8,0,69,21,79,10,69
06,California/CA,0607114,"San Bernardino County (Southwest)--Chino & Chino Hills Cities PUMA, California/CA",06071,"San Bernardino County, California",2135413,53669,922,2513,43,1,75,87,69,203,59,0,278,146,69,59,156,215,493,15,41,12,32,12,18,0,14,56,44,30,14
06,California/CA,0607115,"San Bernardino County (Southwest)--Fontana City (West) PUMA, California/CA",06071,"San Bernardino County, California",2135413,53669,922,2513,43,1,84,157,232,252,0,12,336,157,244,12,389,401,737,11,34,2,53,0,21,2,31,46,54,21,33
06,California/CA,0607301,"San Diego County (Northwest)--Oceanside City & Camp Pendleton PUMA, California/CA",06073,"San Diego County, California",3302833,46064,775,1395,23,1,12,167,690,51,0,0,63,167,690,0,857,857,920,1,6,0,93,0,18,0,75,7,93,18,75
06,California/CA,0607302,"San Diego County (North & East)--Fallbrook, Alpine & Valley Center PUMA, California/CA",06073,"San Diego County, California",3302833,46064,775,1395,23,1,64,394,925,120,2,0,184,396,925,2,1319,1321,1505,4,8,0,88,0,26,0,61,12,88,26,61
06,California/CA,0607303,"San Diego County (Northwest)--Vista City PUMA, California/CA",06073,"San Diego County, California",3302833,46064,775,1395,23,1,76,282,1045,54,0,0,130,282,1045,0,1327,1327,1457,5,4,0,91,0,19,0,72,9,91,19,72
06,California/CA,0607304,"San Diego County (Northwest)--Carlsbad City PUMA, California/CA",06073,"San Diego County, California",3302833,46064,775,1395,23,1,0,95,0,0,0,0,0,95,0,0,95,95,95,0,0,0,100,0,100,0,0,0,100,100,0
06,California/CA,0607305,"San Diego County (Northwest)--San Marcos & Escondido (West) Cities PUMA, California/CA",06073,"San Diego County, California",3302833,46064,775,1395,23,1,112,13,641,349,36,0,461,49,641,36,654,690,1151,10,30,3,57,3,1,0,56,40,60,4,56
06,California/CA,0607306,"San Diego County (Northwest)--Escondido City (East) PUMA, California/CA",06073,"San Diego County, California",3302833,46064,775,1395,23,1,76,192,1095,113,14,0,189,206,1095,14,1287,1301,1490,5,8,1,86,1,13,0,73,13,87,14,73
06,California/CA,0607307,"San Diego County (Central)--Lakeside, Winter Gardens & Ramona PUMA, California/CA",06073,"San Diego County, California",3302833,46064,775,1395,23,1,161,0,25,63,0,0,224,0,25,0,25,25,249,65,25,0,10,0,0,0,10,90,10,0,10
06,California/CA,0607308,"San Diego County (Central)--San Diego (Northeast/Rancho Bernardo) & Poway Cities PUMA, California/CA",06073,"San Diego County, California",3302833,46064,775,1395,23,1,6,0,0,0,13,7,6,13,7,20,0,20,26,23,0,77,0,50,0,27,0,23,77,50,27
06,California/CA,0607309,"San Diego County (West)--San Diego (Northwest/San Dieguito) & Encinitas Cities PUMA, California/CA",06073,"San Diego County, California",3302833,46064,775,1395,23,1,27,0,20,21,0,0,48,0,20,0,20,20,68,40,31,0,29,0,0,0,29,71,29,0,29
06,California/CA,0607310,"San Diego County (West)--San Diego City (Southwest/Central Coastal) PUMA, California/CA",06073,"San Diego County, California",3302833,46064,775,1395,23,1,36,2,24,14,0,0,50,2,24,0,26,26,76,47,18,0,34,0,3,0,32,66,34,3,32
06,California/CA,0607311,"San Diego County (West Central)--San Diego City (Northwest/Del Mar Mesa) PUMA, California/CA",06073,"San Diego County, California",3302833,46064,775,1395,23,1,0,0,0,34,31,0,34,31,0,31,0,31,65,0,52,48,0,48,0,0,0,52,48,48,0
06,California/CA,0607312,"San Diego County (Central)--San Diego City (Central/Mira Mesa & University Heights) PUMA, California/CA",06073,"San Diego County, California",3302833,46064,775,1395,23,1,40,0,71,0,0,11,40,0,82,11,71,82,122,33,0,9,58,0,0,9,58,33,67,0,67
06,California/CA,0607313,"San Diego County (Central)--El Cajon & Santee Cities PUMA, California/CA",06073,"San Diego County, California",3302833,46064,775,1395,23,1,0,0,0,41,0,58,41,0,58,58,0,58,99,0,41,59,0,0,0,59,0,41,59,0,59
06,California/CA,0607314,"San Diego County (Central)--San Diego (East Central/Navajo) & La Mesa Cities PUMA, California/CA",06073,"San Diego County, California",3302833,46064,775,1395,23,1,95,0,0,56,0,0,151,0,0,0,0,0,151,63,37,0,0,0,0,0,0,100,0,0,0
06,California/CA,0607315,"San Diego County (West Central)--San Diego City (Central/Clairemont & Kearny Mesa) PUMA, California/CA",06073,"San Diego County, California",3302833,46064,775,1395,23,1,60,15,79,85,58,0,145,73,79,58,94,152,297,20,29,20,32,20,5,0,27,49,51,25,27
06,California/CA,0607316,"San Diego County (South Central)--San Diego City (Central/Centre City & Balboa Park) PUMA, California/CA",06073,"San Diego County, California",3302833,46064,775,1395,23,1,52,118,320,60,0,0,112,118,320,0,438,438,550,9,11,0,80,0,21,0,58,20,80,21,58
06,California/CA,0607317,"San Diego County (South Central)--San Diego City (Central/Mid-City) PUMA, California/CA",06073,"San Diego County, California",3302833,46064,775,1395,23,1,45,19,287,65,0,32,110,19,319,32,306,338,448,10,15,7,68,0,4,7,64,25,75,4,71
06,California/CA,0607318,"San Diego County (South)--San Diego City (Southeast/Encanto & Skyline) PUMA, California/CA",06073,"San Diego County, California",3302833,46064,775,1395,23,1,58,154,264,14,0,6,72,154,270,6,418,424,496,12,3,1,84,0,31,1,53,15,85,31,54
06,California/CA,0607319,"San Diego County (South Central)--Lemon Grove City, La Presa & Spring Valley PUMA, California/CA",06073,"San Diego County, California",3302833,46064,775,1395,23,1,51,37,15,22,0,0,73,37,15,0,52,52,125,41,18,0,42,0,30,0,12,58,42,30,12
06,California/CA,0607320,"San Diego County (Southwest)--Sweetwater Region--Chula Vista City (East) PUMA, California/CA",06073,"San Diego County, California",3302833,46064,775,1395,23,1,66,10,0,36,0,0,102,10,0,0,10,10,112,59,32,0,9,0,9,0,0,91,9,9,0
06,California/CA,0607321,"San Diego County (Southwest)--Chula Vista (West) & National City Cities PUMA, California/CA",06073,"San Diego County, California",3302833,46064,775,1395,23,1,10,78,296,151,23,0,161,101,296,23,374,397,558,2,27,4,67,4,14,0,53,29,71,18,53
06,California/CA,0607322,"San Diego County (South)--San Diego City (South/Otay Mesa & South Bay) PUMA, California/CA",06073,"San Diego County, California",3302833,46064,775,1395,23,1,0,130,185,61,0,0,61,130,185,0,315,315,376,0,16,0,84,0,35,0,49,16,84,35,49
06,California/CA,0607501,"San Francisco County (North & West)--Richmond District PUMA, California/CA",06075,"San Francisco County, California",870044,11041,99,1269,11,1,23,0,60,42,58,0,65,58,60,58,60,118,183,13,23,32,33,32,0,0,33,36,64,32,33
06,California/CA,0607502,"San Francisco County (North & East)--North Beach & Chinatown PUMA, California/CA",06075,"San Francisco County, California",870044,11041,99,1269,11,1,0,0,0,30,30,10,30,30,10,40,0,40,70,0,43,57,0,43,0,14,0,43,57,43,14
06,California/CA,0607503,"San Francisco County (Central)--South of Market & Potrero PUMA, California/CA",06075,"San Francisco County, California",870044,11041,99,1269,11,1,0,47,83,58,0,0,58,47,83,0,130,130,188,0,31,0,69,0,25,0,44,31,69,25,44
06,California/CA,0607504,"San Francisco County (Central)--Inner Mission & Castro PUMA, California/CA",06075,"San Francisco County, California",870044,11041,99,1269,11,1,0,14,68,34,63,0,34,77,68,63,82,145,179,0,19,35,46,35,8,0,38,19,81,43,38
06,California/CA,0607505,"San Francisco County (Central)--Sunset District (North) PUMA, California/CA",06075,"San Francisco County, California",870044,11041,99,1269,11,1,92,0,0,52,38,50,144,38,50,88,0,88,232,40,22,38,0,16,0,22,0,62,38,16,22
06,California/CA,0607506,"San Francisco County (South Central)--Sunset District (South) PUMA, California/CA",06075,"San Francisco County, California",870044,11041,99,1269,11,1,137,27,0,0,46,14,137,73,14,60,27,87,224,61,0,27,12,21,12,6,0,61,39,33,6
06,California/CA,0607507,"San Francisco County (South Central)--Bayview & Hunters Point PUMA, California/CA",06075,"San Francisco County, California",870044,11041,99,1269,11,1,0,40,136,0,77,82,0,117,218,159,176,335,335,0,0,47,53,23,12,24,41,0,100,35,65
06,California/CA,0607701,"San Joaquin County (Central)--Stockton City (North) PUMA, California/CA",06077,"San Joaquin County, California",732212,20194,441,2758,60,1,312,79,723,135,323,260,447,402,983,583,802,1385,1832,17,7,32,44,18,4,14,39,24,76,22,54
06,California/CA,0607702,"San Joaquin County (Central)--Stockton City (South) PUMA, California/CA",06077,"San Joaquin County, California",732212,20194,441,2758,60,1,133,662,3868,749,130,14,882,792,3882,144,4530,4674,5556,2,13,3,82,2,12,0,70,16,84,14,70
06,California/CA,0607703,"San Joaquin County (South)--Tracy, Manteca & Lathrop Cities PUMA, California/CA",06077,"San Joaquin County, California",732212,20194,441,2758,60,1,342,116,737,265,83,101,607,199,838,184,853,1037,1644,21,16,11,52,5,7,6,45,37,63,12,51
06,California/CA,0607704,"San Joaquin County (North)--Lodi, Ripon & Escalon Cities PUMA, California/CA",06077,"San Joaquin County, California",732212,20194,441,2758,60,1,645,680,4221,546,144,117,1191,824,4338,261,4901,5162,6353,10,9,4,77,2,11,2,66,19,81,13,68
06,California/CA,0607901,"San Luis Obispo County (West)--Coastal Region PUMA, California/CA",06079,"San Luis Obispo County, California",281455,3544,29,1259,10,1,565,167,688,157,0,18,722,167,706,18,855,873,1595,35,10,1,54,0,10,1,43,45,55,10,44
06,California/CA,0607902,"San Luis Obispo County (East)--Inland Region PUMA, California/CA",06079,"San Luis Obispo County, California",281455,3544,29,1259,10,1,162,129,610,203,0,0,365,129,610,0,739,739,1104,15,18,0,67,0,12,0,55,33,67,12,55
06,California/CA,0608101,"San Mateo County (North Central)--Daly City, Pacifica Cities & Colma Town PUMA, California/CA",06081,"San Mateo County, California",765935,9785,150,1278,20,1,69,59,97,22,144,23,91,203,120,167,156,323,414,17,5,40,38,35,14,6,23,22,78,49,29
06,California/CA,0608102,"San Mateo County (North Central)--South San Francisco, San Bruno & Brisbane Cities PUMA, California/CA",06081,"San Mateo County, California",765935,9785,150,1278,20,1,17,200,32,50,84,0,67,284,32,84,232,316,383,4,13,22,61,22,52,0,8,17,83,74,8
06,California/CA,0608103,"San Mateo County (Central)--San Mateo (North), Burlingame & Millbrae Cities PUMA, California/CA",06081,"San Mateo County, California",765935,9785,150,1278,20,1,0,0,76,0,0,0,0,0,76,0,76,76,76,0,0,0,100,0,0,0,100,0,100,0,100
06,California/CA,0608104,"San Mateo County (South & West)--San Mateo (South) & Half Moon Bay Cities PUMA, California/CA",06081,"San Mateo County, California",765935,9785,150,1278,20,1,157,0,271,0,0,0,157,0,271,0,271,271,428,37,0,0,63,0,0,0,63,37,63,0,63
06,California/CA,0608105,"San Mateo County (East Central)--Redwood City, San Carlos & Belmont Cities PUMA, California/CA",06081,"San Mateo County, California",765935,9785,150,1278,20,1,31,0,170,0,17,0,31,17,170,17,170,187,218,14,0,8,78,8,0,0,78,14,86,8,78
06,California/CA,0608106,"San Mateo County (Southeast)--Menlo Park, East Palo Alto Cities & Atherton Town PUMA, California/CA",06081,"San Mateo County, California",765935,9785,150,1278,20,1,17,7,272,21,0,0,38,7,272,0,279,279,317,5,7,0,88,0,2,0,86,12,88,2,86
06,California/CA,0608301,"Santa Barbara County (Northwest)--Santa Maria City & Orcutt PUMA, California/CA",06083,"Santa Barbara County, California",443738,9037,113,2037,25,1,9,260,10970,441,0,19,450,260,10989,19,11230,11249,11699,0,4,0,96,0,2,0,94,4,96,2,94
06,California/CA,0608302,"Santa Barbara County (North)--Lompoc, Guadalupe, Solvang & Buellton Cities PUMA, California/CA",06083,"Santa Barbara County, California",443738,9037,113,2037,25,1,117,187,1933,173,0,58,290,187,1991,58,2120,2178,2468,5,7,2,86,0,8,2,78,12,88,8,81
06,California/CA,0608303,"Santa Barbara County--South Coast Region PUMA, California/CA",06083,"Santa Barbara County, California",443738,9037,113,2037,25,1,82,141,210,37,0,0,119,141,210,0,351,351,470,17,8,0,75,0,30,0,45,25,75,30,45
06,California/CA,0608501,"Santa Clara County (Northwest)--Mountain View, Palo Alto & Los Altos Cities PUMA, California/CA",06085,"Santa Clara County, California",1922200,20882,307,1086,16,1,91,0,0,78,0,0,169,0,0,0,0,0,169,54,46,0,0,0,0,0,0,100,0,0,0
06,California/CA,0608502,"Santa Clara County (Northwest)--Sunnyvale & San Jose (North) Cities PUMA, California/CA",06085,"Santa Clara County, California",1922200,20882,307,1086,16,1,38,16,62,0,0,17,38,16,79,17,78,95,133,29,0,13,59,0,12,13,47,29,71,12,59
06,California/CA,0608503,"Santa Clara County (Northwest)--San Jose (Northwest) & Santa Clara Cities PUMA, California/CA",06085,"Santa Clara County, California",1922200,20882,307,1086,16,1,0,54,46,34,34,0,34,88,46,34,100,134,168,0,20,20,60,20,32,0,27,20,80,52,27
06,California/CA,0608504,"Santa Clara County (North Central)--Milpitas & San Jose (Northeast) Cities PUMA, California/CA",06085,"Santa Clara County, California",1922200,20882,307,1086,16,1,35,0,4,27,0,0,62,0,4,0,4,4,66,53,41,0,6,0,0,0,6,94,6,0,6
06,California/CA,0608505,"Santa Clara County (North Central)--San Jose City (East Central) & Alum Rock PUMA, California/CA",06085,"Santa Clara County, California",1922200,20882,307,1086,16,1,57,0,80,125,35,0,182,35,80,35,80,115,297,19,42,12,27,12,0,0,27,61,39,12,27
06,California/CA,0608506,"Santa Clara County (East)--Gilroy, Morgan Hill & San Jose (South) Cities PUMA, California/CA",06085,"Santa Clara County, California",1922200,20882,307,1086,16,1,62,358,852,330,7,23,392,365,875,30,1210,1240,1632,4,20,2,74,0,22,1,52,24,76,22,54
06,California/CA,0608507,"Santa Clara County (Southwest)--Cupertino, Saratoga Cities & Los Gatos Town PUMA, California/CA",06085,"Santa Clara County, California",1922200,20882,307,1086,16,1,58,0,0,0,0,0,58,0,0,0,0,0,58,100,0,0,0,0,0,0,0,100,0,0,0
06,California/CA,0608508,"Santa Clara County (Central)--San Jose (West Central) & Campbell Cities PUMA, California/CA",06085,"Santa Clara County, California",1922200,20882,307,1086,16,1,52,0,59,0,4,23,52,4,82,27,59,86,138,38,0,20,43,3,0,17,43,38,62,3,59
06,California/CA,0608509,"Santa Clara County (Central)--San Jose City (Northwest) PUMA, California/CA",06085,"Santa Clara County, California",1922200,20882,307,1086,16,1,26,64,318,305,42,0,331,106,318,42,382,424,755,3,40,6,51,6,8,0,42,44,56,14,42
06,California/CA,0608510,"Santa Clara County (Central)--San Jose City (Central) PUMA, California/CA",06085,"Santa Clara County, California",1922200,20882,307,1086,16,1,7,52,312,239,107,20,246,159,332,127,364,491,737,1,32,17,49,15,7,3,42,33,67,22,45
06,California/CA,0608511,"Santa Clara County (Central)--San Jose City (South Central/Branham) & Cambrian Park PUMA, California/CA",06085,"Santa Clara County, California",1922200,20882,307,1086,16,1,0,20,23,0,0,0,0,20,23,0,43,43,43,0,0,0,100,0,47,0,53,0,100,47,53
06,California/CA,0608512,"Santa Clara County (Central)--San Jose City (Southwest/Almaden Valley) PUMA, California/CA",06085,"Santa Clara County, California",1922200,20882,307,1086,16,1,38,16,17,0,44,0,38,60,17,44,33,77,115,33,0,38,29,38,14,0,15,33,67,52,15
06,California/CA,0608513,"Santa Clara County (Central)--San Jose City (Southeast/Evergreen) PUMA, California/CA",06085,"Santa Clara County, California",1922200,20882,307,1086,16,1,0,60,60,34,8,0,34,68,60,8,120,128,162,0,21,5,74,5,37,0,37,21,79,42,37
06,California/CA,0608514,"Santa Clara County (Central)--San Jose City (East Central/East Valley) PUMA, California/CA",06085,"Santa Clara County, California",1922200,20882,307,1086,16,1,0,70,240,161,43,0,161,113,240,43,310,353,514,0,31,8,60,8,14,0,47,31,69,22,47
06,California/CA,0608701,"Santa Cruz County (North)--Watsonville & Scotts Valley Cities PUMA, California/CA",06087,"Santa Cruz County, California",273765,2330,9,851,3,1,82,363,4260,739,0,0,821,363,4260,0,4623,4623,5444,2,14,0,85,0,7,0,78,15,85,7,78
06,California/CA,0608702,"Santa Cruz County (South & Coastal)--Santa Cruz City PUMA, California/CA",06087,"Santa Cruz County, California",273765,2330,9,851,3,1,94,15,219,32,0,0,126,15,219,0,234,234,360,26,9,0,65,0,4,0,61,35,65,4,61
06,California/CA,0608900,"Shasta County--Redding City PUMA, California/CA",06089,"Shasta County, California",179085,777,17,434,9,1,341,110,14,17,0,0,358,110,14,0,124,124,482,71,4,0,26,0,23,0,3,74,26,23,3
06,California/CA,0609501,"Solano County (Southwest)--Vallejo & Benicia Cities PUMA, California/CA",06095,"Solano County, California",438530,6314,63,1440,14,1,39,17,285,84,80,0,123,97,285,80,302,382,505,8,17,16,60,16,3,0,56,24,76,19,56
06,California/CA,0609502,"Solano County (Central)--Fairfield & Suisun City Cities PUMA, California/CA",06095,"Solano County, California",438530,6314,63,1440,14,1,272,62,911,204,59,42,476,121,953,101,973,1074,1550,18,13,7,63,4,4,3,59,31,69,8,61
06,California/CA,0609503,"Solano County (Northeast)--Vacaville & Dixon Cities PUMA, California/CA",06095,"Solano County, California",438530,6314,63,1440,14,1,296,157,594,119,0,24,415,157,618,24,751,775,1190,25,10,2,63,0,13,2,50,35,65,13,52
06,California/CA,0609701,"Sonoma County (North)--Windsor Town, Healdsburg & Sonoma Cities PUMA, California/CA",06097,"Sonoma County, California",501317,7320,120,1460,24,1,449,285,1193,166,0,13,615,285,1206,13,1478,1491,2106,21,8,1,70,0,14,1,57,29,71,14,57
06,California/CA,0609702,"Sonoma County (South)--Petaluma, Rohnert Park & Cotati Cities PUMA, California/CA",06097,"Sonoma County, California",501317,7320,120,1460,24,1,299,87,532,93,19,11,392,106,543,30,619,649,1041,29,9,3,59,2,8,1,51,38,62,10,52
06,California/CA,0609703,"Sonoma County (Central)--Santa Rosa City PUMA, California/CA",06097,"Sonoma County, California",501317,7320,120,1460,24,1,286,572,1991,235,0,0,521,572,1991,0,2563,2563,3084,9,8,0,83,0,19,0,65,17,83,19,65
06,California/CA,0609901,"Stanislaus County (Southwest)--Ceres, Patterson & Newman Cities PUMA, California/CA",06099,"Stanislaus County, California",539301,16452,348,3051,65,1,353,611,1763,741,21,19,1094,632,1782,40,2374,2414,3508,10,21,1,68,1,17,1,50,31,69,18,51
06,California/CA,0609902,"Stanislaus County (Central)--Modesto City (West) PUMA, California/CA",06099,"Stanislaus County, California",539301,16452,348,3051,65,1,89,276,1503,691,69,36,780,345,1539,105,1779,1884,2664,3,26,4,67,3,10,1,56,29,71,13,58
06,California/CA,0609903,"Stanislaus County (Northeast)--Turlock, Riverbank, Oakdale & Waterford Cities PUMA, California/CA",06099,"Stanislaus County, California",539301,16452,348,3051,65,1,1174,701,3354,1065,403,169,2239,1104,3523,572,4055,4627,6866,17,16,8,59,6,10,2,49,33,67,16,51
06,California/CA,0609904,"Stanislaus County (Central)--Modesto City (East) PUMA, California/CA",06099,"Stanislaus County, California",539301,16452,348,3051,65,1,256,149,512,123,31,0,379,180,512,31,661,692,1071,24,11,3,62,3,14,0,48,35,65,17,48
06,California/CA,0610100,"Sutter & Yuba Counties--Yuba City PUMA, California/CA",06101,"Sutter County, California",95872,1705,11,1778,11,0.562,409,261,1098,139,243,278,548,504,1376,521,1359,1880,2428,17,6,21,56,10,11,11,45,23,77,21,57
06,California/CA,0610100,"Sutter & Yuba Counties--Yuba City PUMA, California/CA",06115,"Yuba County, California",75493,1153,7,1527,9,0.438,319,203,855,108,189,217,427,392,1072,406,1058,1464,1891,17,6,21,56,10,11,11,45,23,77,21,57
06,California/CA,0610701,"Tulare County (Northwest)--Visalia City PUMA, California/CA",06107,"Tulare County, California",460477,15897,259,3452,56,1,447,394,1413,729,77,57,1176,471,1470,134,1807,1941,3117,14,23,4,58,2,13,2,45,38,62,15,47
06,California/CA,0610702,"Tulare County (West Central)--Tulare & Porterville Cities PUMA, California/CA",06107,"Tulare County, California",460477,15897,259,3452,56,1,569,815,5343,2397,185,105,2966,1000,5448,290,6158,6448,9414,6,25,3,65,2,9,1,57,32,68,11,58
06,California/CA,0610703,"Tulare County (Outside Visalia, Tulare & Porterville Cities) PUMA, California/CA",06107,"Tulare County, California",460477,15897,259,3452,56,1,618,2093,10503,3477,58,172,4095,2151,10675,230,12596,12826,16921,4,21,1,74,0,12,1,62,24,76,13,63
06,California/CA,0611101,"Ventura County (Southeast)--Simi Valley City PUMA, California/CA",06111,"Ventura County, California",848112,12617,150,1488,18,1,72,13,69,46,0,0,118,13,69,0,82,82,200,36,23,0,41,0,6,0,34,59,41,6,34
06,California/CA,0611102,"Ventura County (Southeast)--Thousand Oaks City PUMA, California/CA",06111,"Ventura County, California",848112,12617,150,1488,18,1,26,18,42,29,13,0,55,31,42,13,60,73,128,20,23,10,47,10,14,0,33,43,57,24,33
06,California/CA,0611103,"Ventura County (Southwest)--Oxnard & Port Hueneme Cities PUMA, California/CA",06111,"Ventura County, California",848112,12617,150,1488,18,1,117,848,10792,927,13,0,1044,861,10792,13,11640,11653,12697,1,7,0,92,0,7,0,85,8,92,7,85
06,California/CA,0611104,"Ventura County (Southwest)--San Buenaventura (Ventura) City PUMA, California/CA",06111,"Ventura County, California",848112,12617,150,1488,18,1,47,171,890,62,0,9,109,171,899,9,1061,1070,1179,4,5,1,90,0,15,1,75,9,91,15,76
06,California/CA,0611105,"Ventura County (North)--Santa Paula, Fillmore & Ojai Cities PUMA, California/CA",06111,"Ventura County, California",848112,12617,150,1488,18,1,274,444,2815,429,0,0,703,444,2815,0,3259,3259,3962,7,11,0,82,0,11,0,71,18,82,11,71
06,California/CA,0611106,"Ventura County (South Central)--Camarillo & Moorpark Cities PUMA, California/CA",06111,"Ventura County, California",848112,12617,150,1488,18,1,68,265,1319,252,31,0,320,296,1319,31,1584,1615,1935,4,13,2,82,2,14,0,68,17,83,15,68
06,California/CA,0611300,"Yolo County--Davis, Woodland & West Sacramento Cities PUMA, California/CA",06113,"Yolo County, California",214977,2789,55,1297,26,1,453,358,1498,560,45,0,1013,403,1498,45,1856,1901,2914,16,19,2,64,2,12,0,51,35,65,14,51
08,Colorado/CO,0800100,"Northeast Colorado--Eastern Plains Region PUMA, Colorado/CO",08011,"Bent County, Colorado",5809,11,0,189,0,0.053,112,12,38,29,2,15,141,14,53,17,50,67,208,54,14,8,24,1,6,7,18,68,32,7,25
08,Colorado/CO,0800100,"Northeast Colorado--Eastern Plains Region PUMA, Colorado/CO",08017,"Cheyenne County, Colorado",2039,14,0,687,0,0.017,36,4,12,9,1,5,45,5,17,6,16,22,67,54,13,9,24,1,6,7,18,67,33,7,25
08,Colorado/CO,0800100,"Northeast Colorado--Eastern Plains Region PUMA, Colorado/CO",08025,"Crowley County, Colorado",5630,73,1,1297,18,0.052,110,11,37,28,2,15,138,13,52,17,48,65,203,54,14,8,24,1,5,7,18,68,32,6,26
08,Colorado/CO,0800100,"Northeast Colorado--Eastern Plains Region PUMA, Colorado/CO",08039,"Elbert County, Colorado",25162,156,3,620,12,0.037,78,8,26,20,1,10,98,9,36,11,34,45,143,55,14,8,24,1,6,7,18,69,31,6,25
08,Colorado/CO,0800100,"Northeast Colorado--Eastern Plains Region PUMA, Colorado/CO",08061,"Kiowa County, Colorado",1449,1,0,69,0,0.012,25,3,9,6,0,3,31,3,12,3,12,15,46,54,13,7,26,0,7,7,20,67,33,7,26
08,Colorado/CO,0800100,"Northeast Colorado--Eastern Plains Region PUMA, Colorado/CO",08063,"Kit Carson County, Colorado",7635,79,3,1035,39,0.074,156,16,53,40,3,21,196,19,74,24,69,93,289,54,14,8,24,1,6,7,18,68,32,7,26
08,Colorado/CO,0800100,"Northeast Colorado--Eastern Plains Region PUMA, Colorado/CO",08073,"Lincoln County, Colorado",5548,10,0,180,0,0.051,108,11,36,27,2,14,135,13,50,16,47,63,198,55,14,8,24,1,6,7,18,68,32,7,25
08,Colorado/CO,0800100,"Northeast Colorado--Eastern Plains Region PUMA, Colorado/CO",08075,"Logan County, Colorado",21689,856,5,3947,23,0.199,420,43,142,107,8,56,527,51,198,64,185,249,776,54,14,8,24,1,6,7,18,68,32,7,26
08,Colorado/CO,0800100,"Northeast Colorado--Eastern Plains Region PUMA, Colorado/CO",08087,"Morgan County, Colorado",28257,743,48,2629,170,0.257,542,56,183,138,10,72,680,66,255,82,239,321,1001,54,14,8,24,1,6,7,18,68,32,7,25
08,Colorado/CO,0800100,"Northeast Colorado--Eastern Plains Region PUMA, Colorado/CO",08095,"Phillips County, Colorado",4318,34,0,787,0,0.039,82,9,28,21,2,11,103,11,39,13,37,50,153,54,14,8,24,1,6,7,18,67,33,7,25
08,Colorado/CO,0800100,"Northeast Colorado--Eastern Plains Region PUMA, Colorado/CO",08115,"Sedgwick County, Colorado",2350,15,1,638,43,0.022,46,5,16,12,1,6,58,6,22,7,21,28,86,53,14,8,24,1,6,7,19,67,33,7,26
08,Colorado/CO,0800100,"Northeast Colorado--Eastern Plains Region PUMA, Colorado/CO",08121,"Washington County, Colorado",4840,60,0,1240,0,0.045,95,10,32,24,2,13,119,12,45,15,42,57,176,54,14,9,24,1,6,7,18,68,32,7,26
08,Colorado/CO,0800100,"Northeast Colorado--Eastern Plains Region PUMA, Colorado/CO",08123,"Weld County, Colorado",295123,4655,149,1577,50,0.051,108,11,36,27,2,14,135,13,50,16,47,63,198,55,14,8,24,1,6,7,18,68,32,7,25
08,Colorado/CO,0800100,"Northeast Colorado--Eastern Plains Region PUMA, Colorado/CO",08125,"Yuma County, Colorado",10069,104,1,1033,10,0.092,194,20,66,49,4,26,243,24,92,30,86,116,359,54,14,8,24,1,6,7,18,68,32,7,26
08,Colorado/CO,0800102,"Larimer County (South)--Loveland City PUMA, Colorado/CO",08069,"Larimer County, Colorado",338161,2489,52,736,15,1,272,38,0,0,0,0,272,38,0,0,38,38,310,88,0,0,12,0,12,0,0,88,12,12,0
08,Colorado/CO,0800103,"Larimer County (North)--Fort Collins City PUMA, Colorado/CO",08069,"Larimer County, Colorado",338161,2489,52,736,15,1,454,0,94,84,0,0,538,0,94,0,94,94,632,72,13,0,15,0,0,0,15,85,15,0,15
08,Colorado/CO,0800200,"Northwest Colorado--Garfield, Routt, Moffat & Rio Blanco Counties PUMA, Colorado/CO",08045,"Garfield County, Colorado",58538,942,5,1609,9,0.571,261,0,35,7,0,0,268,0,35,0,35,35,303,86,2,0,12,0,0,0,12,88,12,0,12
08,Colorado/CO,0800200,"Northwest Colorado--Garfield, Routt, Moffat & Rio Blanco Counties PUMA, Colorado/CO",08081,"Moffat County, Colorado",13060,41,1,314,8,0.127,58,0,8,2,0,0,60,0,8,0,8,8,68,85,3,0,12,0,0,0,12,88,12,0,12
08,Colorado/CO,0800200,"Northwest Colorado--Garfield, Routt, Moffat & Rio Blanco Counties PUMA, Colorado/CO",08103,"Rio Blanco County, Colorado",6465,25,0,387,0,0.063,29,0,4,1,0,0,30,0,4,0,4,4,34,85,3,0,12,0,0,0,12,88,12,0,12
08,Colorado/CO,0800200,"Northwest Colorado--Garfield, Routt, Moffat & Rio Blanco Counties PUMA, Colorado/CO",08107,"Routt County, Colorado",24874,152,8,611,32,0.239,109,0,15,3,0,0,112,0,15,0,15,15,127,86,2,0,12,0,0,0,12,88,12,0,12
08,Colorado/CO,0800300,"Weld County (South Central)--Greeley, Windsor & Evans Cities PUMA, Colorado/CO",08123,"Weld County, Colorado",295123,4655,149,1577,50,1,696,349,1354,571,29,361,1267,378,1715,390,1703,2093,3360,21,17,12,51,1,10,11,40,38,62,11,51
08,Colorado/CO,0800400,"Eagle, Summit, Grand & Jackson Counties PUMA, Colorado/CO",08037,"Eagle County, Colorado",54357,1247,10,2294,18,0.456,212,3,44,0,0,0,212,3,44,0,47,47,259,82,0,0,18,0,1,0,17,82,18,1,17
08,Colorado/CO,0800400,"Eagle, Summit, Grand & Jackson Counties PUMA, Colorado/CO",08049,"Grand County, Colorado",15066,72,1,478,7,0.127,59,1,12,0,0,0,59,1,12,0,13,13,72,82,0,0,18,0,1,0,17,82,18,1,17
08,Colorado/CO,0800400,"Eagle, Summit, Grand & Jackson Counties PUMA, Colorado/CO",08057,"Jackson County, Colorado",1296,9,0,694,0,0.011,5,0,1,0,0,0,5,0,1,0,1,1,6,83,0,0,17,0,0,0,17,83,17,0,17
08,Colorado/CO,0800400,"Eagle, Summit, Grand & Jackson Counties PUMA, Colorado/CO",08097,"Pitkin County, Colorado",17909,222,2,1240,11,0.15,70,1,14,0,0,0,70,1,14,0,15,15,85,82,0,0,18,0,1,0,16,82,18,1,16
08,Colorado/CO,0800400,"Eagle, Summit, Grand & Jackson Counties PUMA, Colorado/CO",08117,"Summit County, Colorado",30429,451,4,1482,13,0.256,119,2,25,0,0,0,119,2,25,0,27,27,146,82,0,0,18,0,1,0,17,82,18,1,17
08,Colorado/CO,0800600,"Fremont, Chaffee, Park, Lake, Huerfano, Pueblo (Southwest) & Custer Counties PUMA, Colorado/CO",08015,"Chaffee County, Colorado",19164,332,19,1732,99,0.177,53,0,0,37,0,0,90,0,0,0,0,0,90,59,41,0,0,0,0,0,0,100,0,0,0
08,Colorado/CO,0800600,"Fremont, Chaffee, Park, Lake, Huerfano, Pueblo (Southwest) & Custer Counties PUMA, Colorado/CO",08027,"Custer County, Colorado",4640,17,0,366,0,0.043,13,0,0,9,0,0,22,0,0,0,0,0,22,59,41,0,0,0,0,0,0,100,0,0,0
08,Colorado/CO,0800600,"Fremont, Chaffee, Park, Lake, Huerfano, Pueblo (Southwest) & Custer Counties PUMA, Colorado/CO",08043,"Fremont County, Colorado",47002,173,1,368,2,0.442,132,0,0,93,0,0,225,0,0,0,0,0,225,59,41,0,0,0,0,0,0,100,0,0,0
08,Colorado/CO,0800600,"Fremont, Chaffee, Park, Lake, Huerfano, Pueblo (Southwest) & Custer Counties PUMA, Colorado/CO",08055,"Huerfano County, Colorado",6583,20,1,304,15,0.062,19,0,0,13,0,0,32,0,0,0,0,0,32,59,41,0,0,0,0,0,0,100,0,0,0
08,Colorado/CO,0800600,"Fremont, Chaffee, Park, Lake, Huerfano, Pueblo (Southwest) & Custer Counties PUMA, Colorado/CO",08065,"Lake County, Colorado",7585,93,0,1226,0,0.071,21,0,0,15,0,0,36,0,0,0,0,0,36,58,42,0,0,0,0,0,0,100,0,0,0
08,Colorado/CO,0800600,"Fremont, Chaffee, Park, Lake, Huerfano, Pueblo (Southwest) & Custer Counties PUMA, Colorado/CO",08093,"Park County, Colorado",17392,56,1,322,6,0.16,48,0,0,34,0,0,82,0,0,0,0,0,82,59,41,0,0,0,0,0,0,100,0,0,0
08,Colorado/CO,0800600,"Fremont, Chaffee, Park, Lake, Huerfano, Pueblo (Southwest) & Custer Counties PUMA, Colorado/CO",08101,"Pueblo County, Colorado",164685,1072,37,651,22,0.045,13,0,0,9,0,0,22,0,0,0,0,0,22,59,41,0,0,0,0,0,0,100,0,0,0
08,Colorado/CO,0800700,"Pueblo County (North)--Pueblo City & Pueblo West PUMA, Colorado/CO",08101,"Pueblo County, Colorado",164685,1072,37,651,22,1,281,96,202,306,0,0,587,96,202,0,298,298,885,32,35,0,34,0,11,0,23,66,34,11,23
08,Colorado/CO,0800800,"Southeast Colorado PUMA, Colorado/CO",08003,"Alamosa County, Colorado",16444,242,9,1472,55,0.169,128,26,133,146,0,0,274,26,133,0,159,159,433,30,34,0,37,0,6,0,31,63,37,6,31
08,Colorado/CO,0800800,"Southeast Colorado PUMA, Colorado/CO",08009,"Baca County, Colorado",3563,18,0,505,0,0.036,27,6,28,31,0,0,58,6,28,0,34,34,92,29,34,0,37,0,7,0,30,63,37,7,30
08,Colorado/CO,0800800,"Southeast Colorado PUMA, Colorado/CO",08021,"Conejos County, Colorado",8142,33,0,405,0,0.082,62,13,65,71,0,0,133,13,65,0,78,78,211,29,34,0,37,0,6,0,31,63,37,6,31
08,Colorado/CO,0800800,"Southeast Colorado PUMA, Colorado/CO",08023,"Costilla County, Colorado",3687,32,1,868,27,0.038,29,6,30,33,0,0,62,6,30,0,36,36,98,30,34,0,37,0,6,0,31,63,37,6,31
08,Colorado/CO,0800800,"Southeast Colorado PUMA, Colorado/CO",08071,"Las Animas County, Colorado",14179,23,0,162,0,0.143,109,22,113,124,0,0,233,22,113,0,135,135,368,30,34,0,37,0,6,0,31,63,37,6,31
08,Colorado/CO,0800800,"Southeast Colorado PUMA, Colorado/CO",08079,"Mineral County, Colorado",823,20,0,2430,0,0.007,5,1,6,6,0,0,11,1,6,0,7,7,18,28,33,0,39,0,6,0,33,61,39,6,33
08,Colorado/CO,0800800,"Southeast Colorado PUMA, Colorado/CO",08089,"Otero County, Colorado",18325,95,6,518,33,0.185,141,29,146,160,0,0,301,29,146,0,175,175,476,30,34,0,37,0,6,0,31,63,37,6,31
08,Colorado/CO,0800800,"Southeast Colorado PUMA, Colorado/CO",08099,"Prowers County, Colorado",12052,94,0,780,0,0.121,92,19,95,105,0,0,197,19,95,0,114,114,311,30,34,0,37,0,6,0,31,63,37,6,31
08,Colorado/CO,0800800,"Southeast Colorado PUMA, Colorado/CO",08101,"Pueblo County, Colorado",164685,1072,37,651,22,0.038,29,6,30,33,0,0,62,6,30,0,36,36,98,30,34,0,37,0,6,0,31,63,37,6,31
08,Colorado/CO,0800800,"Southeast Colorado PUMA, Colorado/CO",08105,"Rio Grande County, Colorado",11351,96,2,846,18,0.116,88,18,91,100,0,0,188,18,91,0,109,109,297,30,34,0,37,0,6,0,31,63,37,6,31
08,Colorado/CO,0800800,"Southeast Colorado PUMA, Colorado/CO",08109,"Saguache County, Colorado",6468,111,2,1716,31,0.065,49,10,51,56,0,0,105,10,51,0,61,61,166,30,34,0,37,0,6,0,31,63,37,6,31
08,Colorado/CO,0800801,"DRCOG Mountains--Jefferson (West), Boulder (West), Clear Creek & Gilpin Counties PUMA, Colorado/CO",08013,"Boulder County, Colorado",321030,4270,79,1330,25,0.215,26,0,0,0,0,0,26,0,0,0,0,0,26,100,0,0,0,0,0,0,0,100,0,0,0
08,Colorado/CO,0800801,"DRCOG Mountains--Jefferson (West), Boulder (West), Clear Creek & Gilpin Counties PUMA, Colorado/CO",08019,"Clear Creek County, Colorado",9379,37,1,394,11,0.087,10,0,0,0,0,0,10,0,0,0,0,0,10,100,0,0,0,0,0,0,0,100,0,0,0
08,Colorado/CO,0800801,"DRCOG Mountains--Jefferson (West), Boulder (West), Clear Creek & Gilpin Counties PUMA, Colorado/CO",08047,"Gilpin County, Colorado",5924,18,0,304,0,0.055,7,0,0,0,0,0,7,0,0,0,0,0,7,100,0,0,0,0,0,0,0,100,0,0,0
08,Colorado/CO,0800801,"DRCOG Mountains--Jefferson (West), Boulder (West), Clear Creek & Gilpin Counties PUMA, Colorado/CO",08059,"Jefferson County, Colorado",570427,5598,248,981,43,0.643,77,0,0,0,0,0,77,0,0,0,0,0,77,100,0,0,0,0,0,0,0,100,0,0,0
08,Colorado/CO,0800802,"Boulder (Northeast) & Weld (Southwest) Counties--Longmont City & Erie Town PUMA, Colorado/CO",08013,"Boulder County, Colorado",321030,4270,79,1330,25,0.69,114,5,34,128,30,0,242,35,34,30,39,69,311,37,41,10,13,10,2,0,11,78,22,11,11
08,Colorado/CO,0800802,"Boulder (Northeast) & Weld (Southwest) Counties--Longmont City & Erie Town PUMA, Colorado/CO",08123,"Weld County, Colorado",295123,4655,149,1577,50,0.31,51,2,15,57,14,0,108,16,15,14,17,31,139,37,41,10,12,10,1,0,11,78,22,12,11
08,Colorado/CO,0800803,"Boulder County (Central)--Boulder City PUMA, Colorado/CO",08013,"Boulder County, Colorado",321030,4270,79,1330,25,1,116,57,128,0,18,0,116,75,128,18,185,203,319,36,0,6,58,6,18,0,40,36,64,24,40
08,Colorado/CO,0800804,"Broomfield, Jefferson (Northeast), Adams (Northwest) & Boulder (Southeast) Counties PUMA, Colorado/CO",08001,"Adams County, Colorado",497115,8947,225,1800,45,0.043,5,0,1,1,0,0,6,0,1,0,1,1,7,71,14,0,14,0,0,0,14,86,14,0,14
08,Colorado/CO,0800804,"Broomfield, Jefferson (Northeast), Adams (Northwest) & Boulder (Southeast) Counties PUMA, Colorado/CO",08013,"Boulder County, Colorado",321030,4270,79,1330,25,0.351,37,0,5,4,0,0,41,0,5,0,5,5,46,80,9,0,11,0,0,0,11,89,11,0,11
08,Colorado/CO,0800804,"Broomfield, Jefferson (Northeast), Adams (Northwest) & Boulder (Southeast) Counties PUMA, Colorado/CO",08014,"Broomfield County, Colorado",66120,626,33,947,50,0.387,41,0,5,5,0,0,46,0,5,0,5,5,51,80,10,0,10,0,0,0,10,90,10,0,10
08,Colorado/CO,0800804,"Broomfield, Jefferson (Northeast), Adams (Northwest) & Boulder (Southeast) Counties PUMA, Colorado/CO",08059,"Jefferson County, Colorado",570427,5598,248,981,43,0.219,23,0,3,3,0,0,26,0,3,0,3,3,29,79,10,0,10,0,0,0,10,90,10,0,10
08,Colorado/CO,0800805,"Adams (West) & Jefferson (Far Northeast) Counties--Westminster & Northglenn Cities PUMA, Colorado/CO",08001,"Adams County, Colorado",497115,8947,225,1800,45,0.824,131,0,116,123,0,0,254,0,116,0,116,116,370,35,33,0,31,0,0,0,31,69,31,0,31
08,Colorado/CO,0800805,"Adams (West) & Jefferson (Far Northeast) Counties--Westminster & Northglenn Cities PUMA, Colorado/CO",08014,"Broomfield County, Colorado",66120,626,33,947,50,0.042,7,0,6,6,0,0,13,0,6,0,6,6,19,37,32,0,32,0,0,0,32,68,32,0,32
08,Colorado/CO,0800805,"Adams (West) & Jefferson (Far Northeast) Counties--Westminster & Northglenn Cities PUMA, Colorado/CO",08059,"Jefferson County, Colorado",570427,5598,248,981,43,0.134,21,0,19,20,0,0,41,0,19,0,19,19,60,35,33,0,32,0,0,0,32,68,32,0,32
08,Colorado/CO,0800806,"Adams County (West Central)--Thornton & Federal Heights Cities PUMA, Colorado/CO",08001,"Adams County, Colorado",497115,8947,225,1800,45,1,173,32,336,117,0,33,290,32,369,33,368,401,691,25,17,5,53,0,5,5,49,42,58,5,53
08,Colorado/CO,0800807,"Adams County (West Central)--Commerce City & Brighton Cities PUMA, Colorado/CO",08001,"Adams County, Colorado",497115,8947,225,1800,45,1,304,73,466,250,0,19,554,73,485,19,539,558,1112,27,22,2,48,0,7,2,42,50,50,7,44
08,Colorado/CO,0800808,"Arapahoe County (West)--Aurora (Southwest) & Centennial (East) Cities PUMA, Colorado/CO",08005,"Arapahoe County, Colorado",636671,9305,371,1462,58,1,260,26,33,0,0,0,260,26,33,0,59,59,319,82,0,0,18,0,8,0,10,82,18,8,10
08,Colorado/CO,0800809,"Arapahoe (West) & Adams (South Central) Counties--Aurora City (North Central) PUMA, Colorado/CO",08001,"Adams County, Colorado",497115,8947,225,1800,45,0.05,11,4,4,0,0,6,11,4,10,6,8,14,25,44,0,24,32,0,16,24,16,44,56,16,40
08,Colorado/CO,0800809,"Arapahoe (West) & Adams (South Central) Counties--Aurora City (North Central) PUMA, Colorado/CO",08005,"Arapahoe County, Colorado",636671,9305,371,1462,58,0.95,208,86,69,0,0,108,208,86,177,108,155,263,471,44,0,23,33,0,18,23,15,44,56,18,38
08,Colorado/CO,0800810,"Arapahoe (Northwest) & Adams (Southwest) Counties--Aurora City (Northwest) PUMA, Colorado/CO",08001,"Adams County, Colorado",497115,8947,225,1800,45,0.225,30,2,46,3,8,35,33,10,81,43,48,91,124,24,2,35,39,6,2,28,37,27,73,8,65
08,Colorado/CO,0800810,"Arapahoe (Northwest) & Adams (Southwest) Counties--Aurora City (Northwest) PUMA, Colorado/CO",08005,"Arapahoe County, Colorado",636671,9305,371,1462,58,0.775,103,5,160,9,28,121,112,33,281,149,165,314,426,24,2,35,39,7,1,28,38,26,74,8,66
08,Colorado/CO,0800811,"Arapahoe County (Southwest)--Centennial (West & Central) & Greenwood Village Cities PUMA, Colorado/CO",08005,"Arapahoe County, Colorado",636671,9305,371,1462,58,1,0,22,0,90,21,0,90,43,0,21,22,43,133,0,68,16,17,16,17,0,0,68,32,32,0
08,Colorado/CO,0800812,"Denver City (Northeast) PUMA, Colorado/CO",08031,"Denver County, Colorado",693417,12945,440,1867,63,1,267,0,209,140,35,102,407,35,311,137,209,346,753,35,19,18,28,5,0,14,28,54,46,5,41
08,Colorado/CO,0800813,"Denver City (Northwest) PUMA, Colorado/CO",08031,"Denver County, Colorado",693417,12945,440,1867,63,1,20,0,33,149,0,0,169,0,33,0,33,33,202,10,74,0,16,0,0,0,16,84,16,0,16
08,Colorado/CO,0800814,"Denver City (South Central) PUMA, Colorado/CO",08031,"Denver County, Colorado",693417,12945,440,1867,63,1,130,0,0,0,0,5,130,0,5,5,0,5,135,96,0,4,0,0,0,4,0,96,4,0,4
08,Colorado/CO,0800815,"Denver City (Southeast) PUMA, Colorado/CO",08005,"Arapahoe County, Colorado",636671,9305,371,1462,58,0.167,24,0,0,3,0,18,27,0,18,18,0,18,45,53,7,40,0,0,0,40,0,60,40,0,40
08,Colorado/CO,0800815,"Denver City (Southeast) PUMA, Colorado/CO",08031,"Denver County, Colorado",693417,12945,440,1867,63,0.833,118,0,0,13,0,92,131,0,92,92,0,92,223,53,6,41,0,0,0,41,0,59,41,0,41
08,Colorado/CO,0800816,"Denver City (Southwest) PUMA, Colorado/CO",08031,"Denver County, Colorado",693417,12945,440,1867,63,1,106,77,288,67,17,0,173,94,288,17,365,382,555,19,12,3,66,3,14,0,52,31,69,17,52
08,Colorado/CO,0800817,"Jefferson County (Northeast)--Arvada City PUMA, Colorado/CO",08001,"Adams County, Colorado",497115,8947,225,1800,45,0.027,2,0,1,0,0,1,2,0,2,1,1,2,4,50,0,25,25,0,0,25,25,50,50,0,50
08,Colorado/CO,0800817,"Jefferson County (Northeast)--Arvada City PUMA, Colorado/CO",08059,"Jefferson County, Colorado",570427,5598,248,981,43,0.973,78,0,34,0,0,18,78,0,52,18,34,52,130,60,0,14,26,0,0,14,26,60,40,0,40
08,Colorado/CO,0800818,"Jefferson County (East Central)--Lakewood (North), Wheat Ridge & Golden Cities PUMA, Colorado/CO",08059,"Jefferson County, Colorado",570427,5598,248,981,43,1,195,33,112,11,0,0,206,33,112,0,145,145,351,56,3,0,41,0,9,0,32,59,41,9,32
08,Colorado/CO,0800819,"Jefferson County (East Central)--Lakewood City (South) & Dakota Ridge PUMA, Colorado/CO",08059,"Jefferson County, Colorado",570427,5598,248,981,43,1,112,0,14,98,9,19,210,9,33,28,14,42,252,44,39,11,6,4,0,8,6,83,17,4,13
08,Colorado/CO,0800820,"Arapahoe (West) & Jefferson (East) Counties--Littleton, Englewood Cities & Columbine PUMA, Colorado/CO",08005,"Arapahoe County, Colorado",636671,9305,371,1462,58,0.754,43,0,20,28,9,0,71,9,20,9,20,29,100,43,28,9,20,9,0,0,20,71,29,9,20
08,Colorado/CO,0800820,"Arapahoe (West) & Jefferson (East) Counties--Littleton, Englewood Cities & Columbine PUMA, Colorado/CO",08059,"Jefferson County, Colorado",570427,5598,248,981,43,0.246,14,0,7,9,3,0,23,3,7,3,7,10,33,42,27,9,21,9,0,0,21,70,30,9,21
08,Colorado/CO,0800821,"Douglas (West) & Jefferson (Southeast) Counties--Highlands Ranch & Chatfield Park PUMA, Colorado/CO",08035,"Douglas County, Colorado",328614,2658,60,809,18,0.769,91,0,0,14,0,0,105,0,0,0,0,0,105,87,13,0,0,0,0,0,0,100,0,0,0
08,Colorado/CO,0800821,"Douglas (West) & Jefferson (Southeast) Counties--Highlands Ranch & Chatfield Park PUMA, Colorado/CO",08059,"Jefferson County, Colorado",570427,5598,248,981,43,0.231,27,0,0,4,0,0,31,0,0,0,0,0,31,87,13,0,0,0,0,0,0,100,0,0,0
08,Colorado/CO,0800822,"Douglas County (South)--Castle Rock Town PUMA, Colorado/CO",08035,"Douglas County, Colorado",328614,2658,60,809,18,1,100,0,7,30,0,0,130,0,7,0,7,7,137,73,22,0,5,0,0,0,5,95,5,0,5
08,Colorado/CO,0800823,"Douglas (Northeast) & Elbert (West) Counties--Parker Town & The Pinery PUMA, Colorado/CO",08035,"Douglas County, Colorado",328614,2658,60,809,18,0.831,101,0,0,20,0,0,121,0,0,0,0,0,121,83,17,0,0,0,0,0,0,100,0,0,0
08,Colorado/CO,0800823,"Douglas (Northeast) & Elbert (West) Counties--Parker Town & The Pinery PUMA, Colorado/CO",08039,"Elbert County, Colorado",25162,156,3,620,12,0.169,20,0,0,4,0,0,24,0,0,0,0,0,24,83,17,0,0,0,0,0,0,100,0,0,0
08,Colorado/CO,0800824,"DRCOG East Plains--Arapahoe (East) & Adams (East) Counties--Aurora City (Northeast) PUMA, Colorado/CO",08001,"Adams County, Colorado",497115,8947,225,1800,45,0.176,70,24,76,20,10,17,90,34,93,27,100,127,217,32,9,12,46,5,11,8,35,41,59,16,43
08,Colorado/CO,0800824,"DRCOG East Plains--Arapahoe (East) & Adams (East) Counties--Aurora City (Northeast) PUMA, Colorado/CO",08005,"Arapahoe County, Colorado",636671,9305,371,1462,58,0.527,210,73,226,60,31,52,270,104,278,83,299,382,652,32,9,13,46,5,11,8,35,41,59,16,43
08,Colorado/CO,0800824,"DRCOG East Plains--Arapahoe (East) & Adams (East) Counties--Aurora City (Northeast) PUMA, Colorado/CO",08123,"Weld County, Colorado",295123,4655,149,1577,50,0.297,118,41,127,34,18,29,152,59,156,47,168,215,367,32,9,13,46,5,11,8,35,41,59,16,43
08,Colorado/CO,0800900,"La Plata, Montezuma, Gunnison, Archuleta, Dolores, Hinsdale & San Juan Counties PUMA, Colorado/CO",08007,"Archuleta County, Colorado",12908,54,0,418,0,0.111,55,6,9,2,0,0,57,6,9,0,15,15,72,76,3,0,21,0,8,0,12,79,21,8,12
08,Colorado/CO,0800900,"La Plata, Montezuma, Gunnison, Archuleta, Dolores, Hinsdale & San Juan Counties PUMA, Colorado/CO",08033,"Dolores County, Colorado",1841,3,0,163,0,0.018,9,1,1,0,0,0,9,1,1,0,2,2,11,82,0,0,18,0,9,0,9,82,18,9,9
08,Colorado/CO,0800900,"La Plata, Montezuma, Gunnison, Archuleta, Dolores, Hinsdale & San Juan Counties PUMA, Colorado/CO",08051,"Gunnison County, Colorado",16537,296,7,1790,42,0.142,71,8,11,2,0,0,73,8,11,0,19,19,92,77,2,0,21,0,9,0,12,79,21,9,12
08,Colorado/CO,0800900,"La Plata, Montezuma, Gunnison, Archuleta, Dolores, Hinsdale & San Juan Counties PUMA, Colorado/CO",08053,"Hinsdale County, Colorado",878,3,0,342,0,0.007,3,0,1,0,0,0,3,0,1,0,1,1,4,75,0,0,25,0,0,0,25,75,25,0,25
08,Colorado/CO,0800900,"La Plata, Montezuma, Gunnison, Archuleta, Dolores, Hinsdale & San Juan Counties PUMA, Colorado/CO",08067,"La Plata County, Colorado",55101,259,2,470,4,0.482,241,26,37,7,0,0,248,26,37,0,63,63,311,77,2,0,20,0,8,0,12,80,20,8,12
08,Colorado/CO,0800900,"La Plata, Montezuma, Gunnison, Archuleta, Dolores, Hinsdale & San Juan Counties PUMA, Colorado/CO",08083,"Montezuma County, Colorado",25909,136,5,525,19,0.234,117,13,18,3,0,0,120,13,18,0,31,31,151,77,2,0,21,0,9,0,12,79,21,9,12
08,Colorado/CO,0800900,"La Plata, Montezuma, Gunnison, Archuleta, Dolores, Hinsdale & San Juan Counties PUMA, Colorado/CO",08111,"San Juan County, Colorado",544,6,0,1103,0,0.006,3,0,0,0,0,0,3,0,0,0,0,0,3,100,0,0,0,0,0,0,0,100,0,0,0
08,Colorado/CO,0801001,"Mesa County (Central)--Greater Grand Junction & Fruita Cities PUMA, Colorado/CO",08077,"Mesa County, Colorado",149998,592,7,395,5,1,116,0,29,51,0,0,167,0,29,0,29,29,196,59,26,0,15,0,0,0,15,85,15,0,15
08,Colorado/CO,0801002,"Mesa (Outside Grand Junction City), Montrose, Delta, San Miguel & Ouray Counties PUMA, Colorado/CO",08029,"Delta County, Colorado",30346,187,3,616,10,0.295,166,79,90,57,10,23,223,89,113,33,169,202,425,39,13,8,40,2,19,5,21,52,48,21,27
08,Colorado/CO,0801002,"Mesa (Outside Grand Junction City), Montrose, Delta, San Miguel & Ouray Counties PUMA, Colorado/CO",08077,"Mesa County, Colorado",149998,592,7,395,5,0.177,99,47,54,34,6,14,133,53,68,20,101,121,254,39,13,8,40,2,19,6,21,52,48,21,27
08,Colorado/CO,0801002,"Mesa (Outside Grand Junction City), Montrose, Delta, San Miguel & Ouray Counties PUMA, Colorado/CO",08085,"Montrose County, Colorado",41268,380,13,921,32,0.403,226,108,123,78,14,31,304,122,154,45,231,276,580,39,13,8,40,2,19,5,21,52,48,21,27
08,Colorado/CO,0801002,"Mesa (Outside Grand Junction City), Montrose, Delta, San Miguel & Ouray Counties PUMA, Colorado/CO",08091,"Ouray County, Colorado",4722,25,1,529,21,0.047,26,13,14,9,2,4,35,15,18,6,27,33,68,38,13,9,40,3,19,6,21,51,49,22,26
08,Colorado/CO,0801002,"Mesa (Outside Grand Junction City), Montrose, Delta, San Miguel & Ouray Counties PUMA, Colorado/CO",08113,"San Miguel County, Colorado",7968,96,0,1205,0,0.078,44,21,24,15,3,6,59,24,30,9,45,54,113,39,13,8,40,3,19,5,21,52,48,21,27
08,Colorado/CO,0804101,"El Paso (Outside Colorado Springs City) & Teller Counties--Fountain City PUMA, Colorado/CO",08041,"El Paso County, Colorado",688153,6901,173,1003,25,0.802,95,0,0,149,60,0,244,60,0,60,0,60,304,31,49,20,0,20,0,0,0,80,20,20,0
08,Colorado/CO,0804101,"El Paso (Outside Colorado Springs City) & Teller Counties--Fountain City PUMA, Colorado/CO",08119,"Teller County, Colorado",24113,176,4,730,17,0.198,24,0,0,37,15,0,61,15,0,15,0,15,76,32,49,20,0,20,0,0,0,80,20,20,0
08,Colorado/CO,0804102,"El Paso County (West Central)--Colorado Springs City (West) PUMA, Colorado/CO",08041,"El Paso County, Colorado",688153,6901,173,1003,25,1,38,0,97,19,0,0,57,0,97,0,97,97,154,25,12,0,63,0,0,0,63,37,63,0,63
08,Colorado/CO,0804103,"El Paso County (Central)--Colorado Springs City (Central) PUMA, Colorado/CO",08041,"El Paso County, Colorado",688153,6901,173,1003,25,1,206,0,57,0,0,0,206,0,57,0,57,57,263,78,0,0,22,0,0,0,22,78,22,0,22
08,Colorado/CO,0804104,"El Paso County (Central)--Colorado Springs City (East) & Cimarron Hills PUMA, Colorado/CO",08041,"El Paso County, Colorado",688153,6901,173,1003,25,1,53,0,0,26,0,69,79,0,69,69,0,69,148,36,18,47,0,0,0,47,0,53,47,0,47
08,Colorado/CO,0804105,"El Paso County (Central)--Colorado Springs City (South) & Security-Widefield PUMA, Colorado/CO",08041,"El Paso County, Colorado",688153,6901,173,1003,25,1,43,0,0,116,20,0,159,20,0,20,0,20,179,24,65,11,0,11,0,0,0,89,11,11,0
08,Colorado/CO,0804106,"El Paso County (North Central)--Colorado Springs City (North) & Monument Town PUMA, Colorado/CO",08041,"El Paso County, Colorado",688153,6901,173,1003,25,1,33,0,0,0,30,0,33,30,0,30,0,30,63,52,0,48,0,48,0,0,0,52,48,48,0
09,Connecticut/CT,0900100,"Danbury, Ridgefield, Bethel, Brookfield, New Fairfield, Redding & Sherman Towns PUMA, Connecticut/CT",09001,"Fairfield County, Connecticut",944348,20015,1422,2119,151,1,171,0,26,0,0,0,171,0,26,0,26,26,197,87,0,0,13,0,0,0,13,87,13,0,13
09,Connecticut/CT,0900101,"Fairfield, New Canaan, Wilton, Weston & Easton Towns PUMA, Connecticut/CT",09001,"Fairfield County, Connecticut",944348,20015,1422,2119,151,1,7,0,0,0,0,0,7,0,0,0,0,0,7,100,0,0,0,0,0,0,0,100,0,0,0
09,Connecticut/CT,0900102,"Stamford & Greenwich Towns PUMA, Connecticut/CT",09001,"Fairfield County, Connecticut",944348,20015,1422,2119,151,1,71,38,57,0,21,0,71,59,57,21,95,116,187,38,0,11,51,11,20,0,30,38,62,32,30
09,Connecticut/CT,0900103,"Norwalk, Westport & Darien Towns PUMA, Connecticut/CT",09001,"Fairfield County, Connecticut",944348,20015,1422,2119,151,1,41,0,0,0,0,0,41,0,0,0,0,0,41,100,0,0,0,0,0,0,0,100,0,0,0
09,Connecticut/CT,0900104,"Bridgeport Town PUMA, Connecticut/CT",09001,"Fairfield County, Connecticut",944348,20015,1422,2119,151,1,80,0,85,42,0,25,122,0,110,25,85,110,232,34,18,11,37,0,0,11,37,53,47,0,47
09,Connecticut/CT,0900105,"Stratford, Shelton, Trumbull, Newtown & Monroe Towns PUMA, Connecticut/CT",09001,"Fairfield County, Connecticut",944348,20015,1422,2119,151,1,113,15,0,0,0,0,113,15,0,0,15,15,128,88,0,0,12,0,12,0,0,88,12,12,0
09,Connecticut/CT,0900300,"Hartford County (North) PUMA, Connecticut/CT",09003,"Hartford County, Connecticut",894730,14539,1434,1625,160,1,242,0,0,0,0,0,242,0,0,0,0,0,242,100,0,0,0,0,0,0,0,100,0,0,0
09,Connecticut/CT,0900301,"Manchester & East Hartford Towns PUMA, Connecticut/CT",09003,"Hartford County, Connecticut",894730,14539,1434,1625,160,1,33,0,0,0,76,16,33,76,16,92,0,92,125,26,0,74,0,61,0,13,0,26,74,61,13
09,Connecticut/CT,0900302,"Hartford Town PUMA, Connecticut/CT",09003,"Hartford County, Connecticut",894730,14539,1434,1625,160,1,0,0,57,70,20,78,70,20,135,98,57,155,225,0,31,44,25,9,0,35,25,31,69,9,60
09,Connecticut/CT,0900303,"West Hartford, Farmington, Simsbury, Bloomfield, Avon & Canton Towns PUMA, Connecticut/CT",09003,"Hartford County, Connecticut",894730,14539,1434,1625,160,1,50,0,18,43,22,0,93,22,18,22,18,40,133,38,32,17,14,17,0,0,14,70,30,17,14
09,Connecticut/CT,0900304,"Bristol, Southington & Burlington Towns PUMA, Connecticut/CT",09003,"Hartford County, Connecticut",894730,14539,1434,1625,160,1,92,0,0,69,0,37,161,0,37,37,0,37,198,46,35,19,0,0,0,19,0,81,19,0,19
09,Connecticut/CT,0900305,"New Britain, Berlin & Plainville Towns PUMA, Connecticut/CT",09003,"Hartford County, Connecticut",894730,14539,1434,1625,160,1,82,50,29,60,0,81,142,50,110,81,79,160,302,27,20,27,26,0,17,27,10,47,53,17,36
09,Connecticut/CT,0900306,"Glastonbury, Newington, Wethersfield, Rocky Hill & Marlborough Towns PUMA, Connecticut/CT",09003,"Hartford County, Connecticut",894730,14539,1434,1625,160,1,17,0,16,31,23,0,48,23,16,23,16,39,87,20,36,26,18,26,0,0,18,55,45,26,18
09,Connecticut/CT,0900500,"Litchfield County PUMA, Connecticut/CT",09005,"Litchfield County, Connecticut",183031,1857,141,1015,77,1,424,0,0,53,0,0,477,0,0,0,0,0,477,89,11,0,0,0,0,0,0,100,0,0,0
09,Connecticut/CT,0900700,"Middlesex County PUMA, Connecticut/CT",09007,"Middlesex County, Connecticut",163368,1566,193,959,118,1,128,0,0,0,0,0,128,0,0,0,0,0,128,100,0,0,0,0,0,0,0,100,0,0,0
09,Connecticut/CT,0900900,"New Haven County (Northwest) PUMA, Connecticut/CT",09009,"New Haven County, Connecticut",859339,14340,1115,1669,130,1,78,0,0,0,18,0,78,18,0,18,0,18,96,81,0,19,0,19,0,0,0,81,19,19,0
09,Connecticut/CT,0900901,"Waterbury Town PUMA, Connecticut/CT",09009,"New Haven County, Connecticut",859339,14340,1115,1669,130,1,18,0,0,91,44,0,109,44,0,44,0,44,153,12,59,29,0,29,0,0,0,71,29,29,0
09,Connecticut/CT,0900902,"Meriden, Wallingford & North Haven Towns PUMA, Connecticut/CT",09009,"New Haven County, Connecticut",859339,14340,1115,1669,130,1,52,0,0,96,0,9,148,0,9,9,0,9,157,33,61,6,0,0,0,6,0,94,6,0,6
09,Connecticut/CT,0900903,"Hamden, Ansonia, Seymour, Derby, Woodbridge & Bethany Towns PUMA, Connecticut/CT",09009,"New Haven County, Connecticut",859339,14340,1115,1669,130,1,58,0,0,0,0,0,58,0,0,0,0,0,58,100,0,0,0,0,0,0,0,100,0,0,0
09,Connecticut/CT,0900904,"West Haven, Milford & Orange Towns PUMA, Connecticut/CT",09009,"New Haven County, Connecticut",859339,14340,1115,1669,130,1,89,41,153,0,0,0,89,41,153,0,194,194,283,31,0,0,69,0,14,0,54,31,69,14,54
09,Connecticut/CT,0900905,"New Haven Town PUMA, Connecticut/CT",09009,"New Haven County, Connecticut",859339,14340,1115,1669,130,1,75,0,20,268,9,35,343,9,55,44,20,64,407,18,66,11,5,2,0,9,5,84,16,2,14
09,Connecticut/CT,0901100,"New London County (North) PUMA, Connecticut/CT",09011,"New London County, Connecticut",268881,1843,114,685,42,1,174,0,0,0,0,0,174,0,0,0,0,0,174,100,0,0,0,0,0,0,0,100,0,0,0
09,Connecticut/CT,0901101,"New London County (South) PUMA, Connecticut/CT",09011,"New London County, Connecticut",268881,1843,114,685,42,1,145,0,0,0,0,0,145,0,0,0,0,0,145,100,0,0,0,0,0,0,0,100,0,0,0
09,Connecticut/CT,0901300,"Tolland County PUMA, Connecticut/CT",09013,"Tolland County, Connecticut",151269,1337,67,884,44,1,293,0,0,0,28,16,293,28,16,44,0,44,337,87,0,13,0,8,0,5,0,87,13,8,5
09,Connecticut/CT,0901500,"Windham County PUMA, Connecticut/CT",09015,"Windham County, Connecticut",116538,958,15,822,13,1,323,81,190,35,0,26,358,81,216,26,271,297,655,49,5,4,41,0,12,4,29,55,45,12,33
10,Delaware/DE,1000101,"New Castle County (East Central)--Wilmington City PUMA, Delaware/DE",10003,"New Castle County, Delaware",555133,9975,310,1797,56,1,224,18,245,88,0,0,312,18,245,0,263,263,575,39,15,0,46,0,3,0,43,54,46,3,43
10,Delaware/DE,1000102,"New Castle County (North)--Hockessin PUMA, Delaware/DE",10003,"New Castle County, Delaware",555133,9975,310,1797,56,1,289,42,55,0,0,18,289,42,73,18,97,115,404,72,0,4,24,0,10,4,14,72,28,10,18
10,Delaware/DE,1000103,"New Castle County (West Central)--Newark City & Brookside PUMA, Delaware/DE",10003,"New Castle County, Delaware",555133,9975,310,1797,56,1,243,28,20,17,16,47,260,44,67,63,48,111,371,65,5,17,13,4,8,13,5,70,30,12,18
10,Delaware/DE,1000104,"New Castle County (South)--Middletown Town, Bear & Glasgow PUMA, Delaware/DE",10003,"New Castle County, Delaware",555133,9975,310,1797,56,1,99,0,0,0,0,0,99,0,0,0,0,0,99,100,0,0,0,0,0,0,0,100,0,0,0
10,Delaware/DE,1000200,"Kent County--Dover City PUMA, Delaware/DE",10001,"Kent County, Delaware",174822,2905,116,1662,66,1,934,0,231,47,169,316,981,169,547,485,231,716,1697,55,3,29,14,10,0,19,14,58,42,10,32
10,Delaware/DE,1000300,"Sussex County PUMA, Delaware/DE",10005,"Sussex County, Delaware",219540,6718,205,3060,93,1,1995,243,1194,223,112,285,2218,355,1479,397,1437,1834,4052,49,6,10,35,3,6,7,29,55,45,9,37
11,District of Columbia/DC,1100102,"District of Columbia (North) PUMA, District of Columbia/DC",11001,"District of Columbia, District of Columbia",684498,15163,623,2215,91,1,0,0,39,0,0,0,0,0,39,0,39,39,39,0,0,0,100,0,0,0,100,0,100,0,100
11,District of Columbia/DC,1100103,"District of Columbia (Northeast) PUMA, District of Columbia/DC",11001,"District of Columbia, District of Columbia",684498,15163,623,2215,91,1,32,0,0,0,0,0,32,0,0,0,0,0,32,100,0,0,0,0,0,0,0,100,0,0,0
11,District of Columbia/DC,1100104,"District of Columbia (East) PUMA, District of Columbia/DC",11001,"District of Columbia, District of Columbia",684498,15163,623,2215,91,1,22,0,0,0,0,0,22,0,0,0,0,0,22,100,0,0,0,0,0,0,0,100,0,0,0
11,District of Columbia/DC,1100105,"District of Columbia (Central) PUMA, District of Columbia/DC",11001,"District of Columbia, District of Columbia",684498,15163,623,2215,91,1,17,0,0,29,0,0,46,0,0,0,0,0,46,37,63,0,0,0,0,0,0,100,0,0,0
12,Florida/FL,1200101,"Alachua County (Central)--Gainesville City (Central) PUMA, Florida/FL",12001,"Alachua County, Florida",263148,7960,53,3025,20,1,354,0,406,0,0,0,354,0,406,0,406,406,760,47,0,0,53,0,0,0,53,47,53,0,53
12,Florida/FL,1200102,"Alachua County (Outer) PUMA, Florida/FL",12001,"Alachua County, Florida",263148,7960,53,3025,20,1,255,0,11,15,0,13,270,0,24,13,11,24,294,87,5,4,4,0,0,4,4,92,8,0,8
12,Florida/FL,1200500,"Walton, Washington, Holmes & Bay Counties PUMA, Florida/FL",12005,"Bay County, Florida",182482,5999,102,3287,56,0.626,128,0,36,7,0,0,135,0,36,0,36,36,171,75,4,0,21,0,0,0,21,79,21,0,21
12,Florida/FL,1200500,"Walton, Washington, Holmes & Bay Counties PUMA, Florida/FL",12059,"Holmes County, Florida",19430,744,7,3829,36,0.066,13,0,4,1,0,0,14,0,4,0,4,4,18,72,6,0,22,0,0,0,22,78,22,0,22
12,Florida/FL,1200500,"Walton, Washington, Holmes & Bay Counties PUMA, Florida/FL",12131,"Walton County, Florida",65858,1937,25,2941,38,0.224,46,0,13,2,0,0,48,0,13,0,13,13,61,75,3,0,21,0,0,0,21,79,21,0,21
12,Florida/FL,1200500,"Walton, Washington, Holmes & Bay Counties PUMA, Florida/FL",12133,"Washington County, Florida",24566,1068,21,4347,85,0.084,17,0,5,1,0,0,18,0,5,0,5,5,23,74,4,0,22,0,0,0,22,78,22,0,22
12,Florida/FL,1200901,"Brevard County (Northwest)--Titusville, Rockledge & Cocoa Cities PUMA, Florida/FL",12009,"Brevard County, Florida",576808,8728,291,1513,50,1,69,0,72,112,0,0,181,0,72,0,72,72,253,27,44,0,28,0,0,0,28,72,28,0,28
12,Florida/FL,1200902,"Brevard County (East)--Beaches & Merritt Island PUMA, Florida/FL",12009,"Brevard County, Florida",576808,8728,291,1513,50,1,59,0,0,0,0,10,59,0,10,10,0,10,69,86,0,14,0,0,0,14,0,86,14,0,14
12,Florida/FL,1200903,"Brevard County (Southwest)--Melbourne & West Melbourne Cities PUMA, Florida/FL",12009,"Brevard County, Florida",576808,8728,291,1513,50,1,21,0,0,93,0,0,114,0,0,0,0,0,114,18,82,0,0,0,0,0,0,100,0,0,0
12,Florida/FL,1200904,"Brevard County (Southeast)--Palm Bay City, Grant-Valkaria & Malabar Towns PUMA, Florida/FL",12009,"Brevard County, Florida",576808,8728,291,1513,50,1,111,0,16,0,0,7,111,0,23,7,16,23,134,83,0,5,12,0,0,5,12,83,17,0,17
12,Florida/FL,1201101,"Broward County (West)--Coral Springs & Parkland Cities PUMA, Florida/FL",12011,"Broward County, Florida",1909151,76520,1364,4008,71,1,0,35,0,0,0,0,0,35,0,0,35,35,35,0,0,0,100,0,100,0,0,0,100,100,0
12,Florida/FL,1201102,"Broward County (North Central)--Margate & Coconut Creek Cities PUMA, Florida/FL",12011,"Broward County, Florida",1909151,76520,1364,4008,71,1,16,0,0,0,0,0,16,0,0,0,0,0,16,100,0,0,0,0,0,0,0,100,0,0,0
12,Florida/FL,1201103,"Broward County--Deerfield, Pompano Beach (North) & Lighthouse Point Cities PUMA, Florida/FL",12011,"Broward County, Florida",1909151,76520,1364,4008,71,1,48,0,0,0,0,55,48,0,55,55,0,55,103,47,0,53,0,0,0,53,0,47,53,0,53
12,Florida/FL,1201104,"Broward County--Pompano Beach (South) & Fort Lauderdale (Northeast) Cities PUMA, Florida/FL",12011,"Broward County, Florida",1909151,76520,1364,4008,71,1,25,0,7,12,0,0,37,0,7,0,7,7,44,57,27,0,16,0,0,0,16,84,16,0,16
12,Florida/FL,1201105,"Broward County (Central)--Tamarac, Oakland Park & North Lauderdale Cities PUMA, Florida/FL",12011,"Broward County, Florida",1909151,76520,1364,4008,71,1,32,14,10,9,10,0,41,24,10,10,24,34,75,43,12,13,32,13,19,0,13,55,45,32,13
12,Florida/FL,1201106,"Broward County (Central)--Plantation & Sunrise Cities PUMA, Florida/FL",12011,"Broward County, Florida",1909151,76520,1364,4008,71,1,11,0,23,15,22,12,26,22,35,34,23,57,83,13,18,41,28,27,0,14,28,31,69,27,42
12,Florida/FL,1201107,"Broward County (Central)--Lauderhill & Lauderdale Lakes Cities PUMA, Florida/FL",12011,"Broward County, Florida",1909151,76520,1364,4008,71,1,75,21,31,0,91,0,75,112,31,91,52,143,218,34,0,42,24,42,10,0,14,34,66,51,14
12,Florida/FL,1201108,"Broward County (East Central)--Fort Lauderdale City (Central) PUMA, Florida/FL",12011,"Broward County, Florida",1909151,76520,1364,4008,71,1,38,74,83,0,0,12,38,74,95,12,157,169,207,18,0,6,76,0,36,6,40,18,82,36,46
12,Florida/FL,1201109,"Broward County (Southeast)--Hollywood (North) & Dania Beach (South) Cities PUMA, Florida/FL",12011,"Broward County, Florida",1909151,76520,1364,4008,71,1,0,36,20,0,90,0,0,126,20,90,56,146,146,0,0,62,38,62,25,0,14,0,100,86,14
12,Florida/FL,1201110,"Broward County (Central)--Davie Town & Cooper City PUMA, Florida/FL",12011,"Broward County, Florida",1909151,76520,1364,4008,71,1,68,35,460,38,15,0,106,50,460,15,495,510,616,11,6,2,80,2,6,0,75,17,83,8,75
12,Florida/FL,1201111,"Broward County--Weston, Pembroke Pines (Northwest) Cities & Southwest Ranches Town PUMA, Florida/FL",12011,"Broward County, Florida",1909151,76520,1364,4008,71,1,95,0,27,24,44,26,119,44,53,70,27,97,216,44,11,32,12,20,0,12,12,55,45,20,25
12,Florida/FL,1201112,"Broward County (South Central)--Miramar (West) & Pembroke Pines (Southwest) Cities PUMA, Florida/FL",12011,"Broward County, Florida",1909151,76520,1364,4008,71,1,79,10,1,0,0,0,79,10,1,0,11,11,90,88,0,0,12,0,11,0,1,88,12,11,1
12,Florida/FL,1201113,"Broward County (Southeast)--Hollywood (South) & Pembroke Pines (East) Cities PUMA, Florida/FL",12011,"Broward County, Florida",1909151,76520,1364,4008,71,1,0,63,197,66,0,0,66,63,197,0,260,260,326,0,20,0,80,0,19,0,60,20,80,19,60
12,Florida/FL,1201114,"Broward County (Southeast)--Miramar (East), Hallandale Beach & West Park Cities PUMA, Florida/FL",12011,"Broward County, Florida",1909151,76520,1364,4008,71,1,83,35,25,33,15,0,116,50,25,15,60,75,191,43,17,8,31,8,18,0,13,61,39,26,13
12,Florida/FL,1201500,"Charlotte County PUMA, Florida/FL",12015,"Charlotte County, Florida",176954,3013,135,1703,76,1,120,0,14,0,0,0,120,0,14,0,14,14,134,90,0,0,10,0,0,0,10,90,10,0,10
12,Florida/FL,1201701,"Citrus County PUMA, Florida/FL",12017,"Citrus County, Florida",143087,2722,100,1902,70,1,128,0,35,0,0,0,128,0,35,0,35,35,163,79,0,0,21,0,0,0,21,79,21,0,21
12,Florida/FL,1201900,"Clay County PUMA, Florida/FL",12019,"Clay County, Florida",207291,4966,98,2396,47,1,263,0,0,29,0,0,292,0,0,0,0,0,292,90,10,0,0,0,0,0,0,100,0,0,0
12,Florida/FL,1202101,"Collier County (Northwest) PUMA, Florida/FL",12021,"Collier County, Florida",363922,12617,211,3467,58,1,0,0,27,42,0,29,42,0,56,29,27,56,98,0,43,30,28,0,0,30,28,43,57,0,57
12,Florida/FL,1202102,"Collier County (Southwest) PUMA, Florida/FL",12021,"Collier County, Florida",363922,12617,211,3467,58,1,9,0,127,0,0,18,9,0,145,18,127,145,154,6,0,12,82,0,0,12,82,6,94,0,94
12,Florida/FL,1202103,"Collier County (East) PUMA, Florida/FL",12021,"Collier County, Florida",363922,12617,211,3467,58,1,183,99,3287,428,96,795,611,195,4082,891,3386,4277,4888,4,9,18,69,2,2,16,67,12,88,4,84
12,Florida/FL,1202300,"Columbia, Levy, Bradford, Gilchrist, Dixie & Union Counties PUMA, Florida/FL",12007,"Bradford County, Florida",26979,1081,8,4007,30,0.146,82,3,25,7,0,0,89,3,25,0,28,28,117,70,6,0,24,0,3,0,21,76,24,3,21
12,Florida/FL,1202300,"Columbia, Levy, Bradford, Gilchrist, Dixie & Union Counties PUMA, Florida/FL",12023,"Columbia County, Florida",69105,3757,54,5437,78,0.375,212,7,64,18,0,0,230,7,64,0,71,71,301,70,6,0,24,0,2,0,21,76,24,2,21
12,Florida/FL,1202300,"Columbia, Levy, Bradford, Gilchrist, Dixie & Union Counties PUMA, Florida/FL",12029,"Dixie County, Florida",16437,831,7,5056,43,0.088,50,2,15,4,0,0,54,2,15,0,17,17,71,70,6,0,24,0,3,0,21,76,24,3,21
12,Florida/FL,1202300,"Columbia, Levy, Bradford, Gilchrist, Dixie & Union Counties PUMA, Florida/FL",12041,"Gilchrist County, Florida",17615,507,12,2878,68,0.093,53,2,16,4,0,0,57,2,16,0,18,18,75,71,5,0,24,0,3,0,21,76,24,3,21
12,Florida/FL,1202300,"Columbia, Levy, Bradford, Gilchrist, Dixie & Union Counties PUMA, Florida/FL",12075,"Levy County, Florida",39961,1022,9,2557,23,0.216,122,4,37,10,0,0,132,4,37,0,41,41,173,71,6,0,24,0,2,0,21,76,24,2,21
12,Florida/FL,1202300,"Columbia, Levy, Bradford, Gilchrist, Dixie & Union Counties PUMA, Florida/FL",12125,"Union County, Florida",15239,926,13,6077,85,0.082,46,1,14,4,0,0,50,1,14,0,15,15,65,71,6,0,23,0,2,0,22,77,23,2,22
12,Florida/FL,1202700,"Southwest Heartland--Highlands (Northwest), DeSoto & Hardee Counties PUMA, Florida/FL",12027,"DeSoto County, Florida",36399,1556,25,4275,69,0.234,128,113,592,100,0,36,228,113,628,36,705,741,969,13,10,4,73,0,12,4,61,24,76,12,65
12,Florida/FL,1202700,"Southwest Heartland--Highlands (Northwest), DeSoto & Hardee Counties PUMA, Florida/FL",12049,"Hardee County, Florida",27228,1331,11,4888,40,0.179,98,86,453,77,0,28,175,86,481,28,539,567,742,13,10,4,73,0,12,4,61,24,76,12,65
12,Florida/FL,1202700,"Southwest Heartland--Highlands (Northwest), DeSoto & Hardee Counties PUMA, Florida/FL",12055,"Highlands County, Florida",102101,2127,82,2083,80,0.587,320,283,1484,252,0,91,572,283,1575,91,1767,1858,2430,13,10,4,73,0,12,4,61,24,76,12,65
12,Florida/FL,1203101,"Duval County (Outer)--Jacksonville City (North & West) PUMA, Florida/FL",12031,"Duval County, Florida",924229,29965,371,3242,40,1,141,80,0,24,0,0,165,80,0,0,80,80,245,58,10,0,33,0,33,0,0,67,33,33,0
12,Florida/FL,1203102,"Duval County (Northwest Central)--Jacksonville City (Northwest) PUMA, Florida/FL",12031,"Duval County, Florida",924229,29965,371,3242,40,1,287,0,0,18,0,0,305,0,0,0,0,0,305,94,6,0,0,0,0,0,0,100,0,0,0
12,Florida/FL,1203103,"Duval County (North Central)--Jacksonville City (Arlington) PUMA, Florida/FL",12031,"Duval County, Florida",924229,29965,371,3242,40,1,111,0,21,0,0,0,111,0,21,0,21,21,132,84,0,0,16,0,0,0,16,84,16,0,16
12,Florida/FL,1203104,"Duval County (East)--Jacksonville City (Beaches) PUMA, Florida/FL",12031,"Duval County, Florida",924229,29965,371,3242,40,1,143,22,32,56,0,17,199,22,49,17,54,71,270,53,21,6,20,0,8,6,12,74,26,8,18
12,Florida/FL,1203105,"Duval County (Southeast)--Jacksonville City (Southeast) PUMA, Florida/FL",12031,"Duval County, Florida",924229,29965,371,3242,40,1,18,0,0,24,46,288,42,46,288,334,0,334,376,5,6,89,0,12,0,77,0,11,89,12,77
12,Florida/FL,1203106,"Duval County (South Central)--Jacksonville City (Southeast River) PUMA, Florida/FL",12031,"Duval County, Florida",924229,29965,371,3242,40,1,0,76,0,0,31,29,0,107,29,60,76,136,136,0,0,44,56,23,56,21,0,0,100,79,21
12,Florida/FL,1203107,"Duval County (Southwest Central)--Jacksonville City (Southwest) PUMA, Florida/FL",12031,"Duval County, Florida",924229,29965,371,3242,40,1,111,0,0,48,7,0,159,7,0,7,0,7,166,67,29,4,0,4,0,0,0,96,4,4,0
12,Florida/FL,1203301,"Escambia County (North) PUMA, Florida/FL",12033,"Escambia County, Florida",311522,12181,228,3910,73,1,187,0,0,0,0,0,187,0,0,0,0,0,187,100,0,0,0,0,0,0,0,100,0,0,0
12,Florida/FL,1203302,"Escambia County (South) PUMA, Florida/FL",12033,"Escambia County, Florida",311522,12181,228,3910,73,1,73,23,0,0,0,0,73,23,0,0,23,23,96,76,0,0,24,0,24,0,0,76,24,24,0
12,Florida/FL,1203500,"Flagler & Volusia (North Central) Counties PUMA, Florida/FL",12035,"Flagler County, Florida",107139,1715,23,1601,21,0.936,185,0,58,9,0,0,194,0,58,0,58,58,252,73,4,0,23,0,0,0,23,77,23,0,23
12,Florida/FL,1203500,"Flagler & Volusia (North Central) Counties PUMA, Florida/FL",12127,"Volusia County, Florida",527634,10738,239,2035,45,0.064,13,0,4,1,0,0,14,0,4,0,4,4,18,72,6,0,22,0,0,0,22,78,22,0,22
12,Florida/FL,1205301,"Hernando County PUMA, Florida/FL",12053,"Hernando County, Florida",182696,3107,119,1701,65,1,101,0,101,0,0,0,101,0,101,0,101,101,202,50,0,0,50,0,0,0,50,50,50,0,50
12,Florida/FL,1205701,"Hillsborough County (Central)--Tampa City (Central) PUMA, Florida/FL",12057,"Hillsborough County, Florida",1378883,41506,625,3010,45,1,78,31,60,70,12,20,148,43,80,32,91,123,271,29,26,12,34,4,11,7,22,55,45,16,30
12,Florida/FL,1205702,"Hillsborough County (Southwest)--Tampa City (South) PUMA, Florida/FL",12057,"Hillsborough County, Florida",1378883,41506,625,3010,45,1,55,0,353,43,22,20,98,22,373,42,353,395,493,11,9,9,72,4,0,4,72,20,80,4,76
12,Florida/FL,1205703,"Hillsborough County (Northwest) PUMA, Florida/FL",12057,"Hillsborough County, Florida",1378883,41506,625,3010,45,1,112,60,137,19,0,0,131,60,137,0,197,197,328,34,6,0,60,0,18,0,42,40,60,18,42
12,Florida/FL,1205704,"Hillsborough County (North Central) PUMA, Florida/FL",12057,"Hillsborough County, Florida",1378883,41506,625,3010,45,1,57,49,152,74,0,0,131,49,152,0,201,201,332,17,22,0,61,0,15,0,46,39,61,15,46
12,Florida/FL,1205705,"Hillsborough County (North Central)--Tampa City (North) PUMA, Florida/FL",12057,"Hillsborough County, Florida",1378883,41506,625,3010,45,1,37,0,8,48,0,15,85,0,23,15,8,23,108,34,44,14,7,0,0,14,7,79,21,0,21
12,Florida/FL,1205706,"Hillsborough County (Northeast) PUMA, Florida/FL",12057,"Hillsborough County, Florida",1378883,41506,625,3010,45,1,308,77,2370,380,0,0,688,77,2370,0,2447,2447,3135,10,12,0,78,0,2,0,76,22,78,2,76
12,Florida/FL,1205707,"Hillsborough County (Central) PUMA, Florida/FL",12057,"Hillsborough County, Florida",1378883,41506,625,3010,45,1,70,10,136,83,0,0,153,10,136,0,146,146,299,23,28,0,49,0,3,0,45,51,49,3,45
12,Florida/FL,1205708,"Hillsborough County (South County) PUMA, Florida/FL",12057,"Hillsborough County, Florida",1378883,41506,625,3010,45,1,108,177,1778,372,0,78,480,177,1856,78,1955,2033,2513,4,15,3,78,0,7,3,71,19,81,7,74
12,Florida/FL,1206100,"Indian River County PUMA, Florida/FL",12061,"Indian River County, Florida",150984,3169,115,2099,76,1,130,77,364,29,0,0,159,77,364,0,441,441,600,22,5,0,74,0,13,0,61,26,74,13,61
12,Florida/FL,1206300,"Apalachee Region (Outside Leon County) PUMA, Florida/FL",12013,"Calhoun County, Florida",14444,612,11,4237,76,0.076,92,2,17,4,0,7,96,2,24,7,19,26,122,75,3,6,16,0,2,6,14,79,21,2,20
12,Florida/FL,1206300,"Apalachee Region (Outside Leon County) PUMA, Florida/FL",12037,"Franklin County, Florida",11736,614,3,5232,26,0.062,75,2,14,3,0,6,78,2,20,6,16,22,100,75,3,6,16,0,2,6,14,78,22,2,20
12,Florida/FL,1206300,"Apalachee Region (Outside Leon County) PUMA, Florida/FL",12039,"Gadsden County, Florida",46017,2769,46,6017,100,0.241,292,7,54,13,0,22,305,7,76,22,61,83,388,75,3,6,16,0,2,6,14,79,21,2,20
12,Florida/FL,1206300,"Apalachee Region (Outside Leon County) PUMA, Florida/FL",12045,"Gulf County, Florida",16055,875,14,5450,87,0.084,102,3,19,4,0,8,106,3,27,8,22,30,136,75,3,6,16,0,2,6,14,78,22,2,20
12,Florida/FL,1206300,"Apalachee Region (Outside Leon County) PUMA, Florida/FL",12063,"Jackson County, Florida",48472,2791,77,5758,159,0.253,306,8,56,13,0,24,319,8,80,24,64,88,407,75,3,6,16,0,2,6,14,78,22,2,20
12,Florida/FL,1206300,"Apalachee Region (Outside Leon County) PUMA, Florida/FL",12065,"Jefferson County, Florida",14105,555,8,3935,57,0.073,88,2,16,4,0,7,92,2,23,7,18,25,117,75,3,6,15,0,2,6,14,79,21,2,20
12,Florida/FL,1206300,"Apalachee Region (Outside Leon County) PUMA, Florida/FL",12077,"Liberty County, Florida",8365,510,8,6097,96,0.043,52,1,10,2,0,4,54,1,14,4,11,15,69,75,3,6,16,0,1,6,14,78,22,1,20
12,Florida/FL,1206300,"Apalachee Region (Outside Leon County) PUMA, Florida/FL",12129,"Wakulla County, Florida",31877,1118,10,3507,31,0.167,202,5,37,9,0,16,211,5,53,16,42,58,269,75,3,6,16,0,2,6,14,78,22,2,20
12,Florida/FL,1206901,"Lake County (North) PUMA, Florida/FL",12069,"Lake County, Florida",335362,7420,188,2213,56,1,440,51,296,0,13,0,440,64,296,13,347,360,800,55,0,2,43,2,6,0,37,55,45,8,37
12,Florida/FL,1206902,"Sumter (North) & Lake (North) Counties PUMA, Florida/FL",12069,"Lake County, Florida",335362,7420,188,2213,56,0.419,25,0,11,26,16,0,51,16,11,16,11,27,78,32,33,21,14,21,0,0,14,65,35,21,14
12,Florida/FL,1206902,"Sumter (North) & Lake (North) Counties PUMA, Florida/FL",12119,"Sumter County, Florida",120999,2210,66,1826,55,0.581,34,0,16,35,21,0,69,21,16,21,16,37,106,32,33,20,15,20,0,0,15,65,35,20,15
12,Florida/FL,1206903,"Lake (South) & Sumter (South) Counties PUMA, Florida/FL",12069,"Lake County, Florida",335362,7420,188,2213,56,0.839,305,35,122,15,40,0,320,75,122,40,157,197,517,59,3,8,30,8,7,0,24,62,38,15,24
12,Florida/FL,1206903,"Lake (South) & Sumter (South) Counties PUMA, Florida/FL",12119,"Sumter County, Florida",120999,2210,66,1826,55,0.161,58,7,24,3,8,0,61,15,24,8,31,39,100,58,3,8,31,8,7,0,24,61,39,15,24
12,Florida/FL,1207101,"Lee County (South & West)--Barrier Islands Region PUMA, Florida/FL",12071,"Lee County, Florida",718679,20243,466,2817,65,1,0,0,93,0,0,29,0,0,122,29,93,122,122,0,0,24,76,0,0,24,76,0,100,0,100
12,Florida/FL,1207102,"Lee County (Northwest)--Cape Coral City PUMA, Florida/FL",12071,"Lee County, Florida",718679,20243,466,2817,65,1,85,110,26,0,12,0,85,122,26,12,136,148,233,36,0,5,58,5,47,0,11,36,64,52,11
12,Florida/FL,1207103,"Lee County (Northeast)--Lehigh Acres & North Fort Myers PUMA, Florida/FL",12071,"Lee County, Florida",718679,20243,466,2817,65,1,88,49,48,95,0,248,183,49,296,248,97,345,528,17,18,47,18,0,9,47,9,35,65,9,56
12,Florida/FL,1207104,"Lee County (Central)--Greater Fort Myers City PUMA, Florida/FL",12071,"Lee County, Florida",718679,20243,466,2817,65,1,66,54,139,0,0,99,66,54,238,99,193,292,358,18,0,28,54,0,15,28,39,18,82,15,66
12,Florida/FL,1207105,"Lee County (Southeast)--Bonita Springs City & Estero (East) PUMA, Florida/FL",12071,"Lee County, Florida",718679,20243,466,2817,65,1,46,47,213,27,6,0,73,53,213,6,260,266,339,14,8,2,77,2,14,0,63,22,78,16,63
12,Florida/FL,1207300,"Leon County (Outer) PUMA, Florida/FL",12073,"Leon County, Florida",288102,10365,66,3598,23,1,69,0,0,35,0,0,104,0,0,0,0,0,104,66,34,0,0,0,0,0,0,100,0,0,0
12,Florida/FL,1207301,"Leon County (Central)--Tallahassee City (Central) PUMA, Florida/FL",12073,"Leon County, Florida",288102,10365,66,3598,23,1,49,0,0,111,0,0,160,0,0,0,0,0,160,31,69,0,0,0,0,0,0,100,0,0,0
12,Florida/FL,1208101,"Manatee County (North) PUMA, Florida/FL",12081,"Manatee County, Florida",373853,11393,291,3047,78,1,145,51,181,8,11,15,153,62,196,26,232,258,411,35,2,6,56,3,12,4,44,37,63,15,48
12,Florida/FL,1208102,"Manatee County (West Central) PUMA, Florida/FL",12081,"Manatee County, Florida",373853,11393,291,3047,78,1,115,0,335,9,77,18,124,77,353,95,335,430,554,21,2,17,60,14,0,3,60,22,78,14,64
12,Florida/FL,1208103,"Manatee County (South) PUMA, Florida/FL",12081,"Manatee County, Florida",373853,11393,291,3047,78,1,109,25,40,25,62,0,134,87,40,62,65,127,261,42,10,24,25,24,10,0,15,51,49,33,15
12,Florida/FL,1208301,"Marion County (North) PUMA, Florida/FL",12083,"Marion County, Florida",348371,9626,274,2763,79,1,325,132,442,0,0,0,325,132,442,0,574,574,899,36,0,0,64,0,15,0,49,36,64,15,49
12,Florida/FL,1208302,"Marion County (Central)--Ocala City PUMA, Florida/FL",12083,"Marion County, Florida",348371,9626,274,2763,79,1,225,64,150,42,0,0,267,64,150,0,214,214,481,47,9,0,44,0,13,0,31,56,44,13,31
12,Florida/FL,1208303,"Marion County (South Central) PUMA, Florida/FL",12083,"Marion County, Florida",348371,9626,274,2763,79,1,119,140,13,94,0,27,213,140,40,27,153,180,393,30,24,7,39,0,36,7,3,54,46,36,10
12,Florida/FL,1208500,"Martin County PUMA, Florida/FL",12085,"Martin County, Florida",157581,4860,142,3084,90,1,67,92,586,32,0,28,99,92,614,28,678,706,805,8,4,3,84,0,11,3,73,12,88,11,76
12,Florida/FL,1208601,"Miami-Dade County (North Central)--Greater Miami Lakes Town PUMA, Florida/FL",12086,"Miami-Dade County, Florida",2715516,168774,3202,6215,118,1,29,69,45,17,0,0,46,69,45,0,114,114,160,18,11,0,71,0,43,0,28,29,71,43,28
12,Florida/FL,1208602,"Miami-Dade County (North Central)--Miami Gardens City (North & West) PUMA, Florida/FL",12086,"Miami-Dade County, Florida",2715516,168774,3202,6215,118,1,11,0,47,0,0,0,11,0,47,0,47,47,58,19,0,0,81,0,0,0,81,19,81,0,81
12,Florida/FL,1208603,"Miami-Dade County (Northeast)--Greater North Miami Beach City (West) PUMA, Florida/FL",12086,"Miami-Dade County, Florida",2715516,168774,3202,6215,118,1,34,25,17,12,22,68,46,47,85,90,42,132,178,19,7,51,24,12,14,38,10,26,74,26,48
12,Florida/FL,1208604,"Miami-Dade County (Northeast)--Aventura City & Surfside Town PUMA, Florida/FL",12086,"Miami-Dade County, Florida",2715516,168774,3202,6215,118,1,0,2,14,3,7,0,3,9,14,7,16,23,26,0,12,27,62,27,8,0,54,12,88,35,54
12,Florida/FL,1208605,"Miami-Dade County--North Miami City (Southwest) & Golden Glades (West) PUMA, Florida/FL",12086,"Miami-Dade County, Florida",2715516,168774,3202,6215,118,1,15,6,8,26,55,21,41,61,29,76,14,90,131,11,20,58,11,42,5,16,6,31,69,47,22
12,Florida/FL,1208606,"Miami-Dade County (Northeast)--Opa-Locka City, West Little River & Westview PUMA, Florida/FL",12086,"Miami-Dade County, Florida",2715516,168774,3202,6215,118,1,18,37,67,24,0,4,42,37,71,4,104,108,150,12,16,3,69,0,25,3,45,28,72,25,47
12,Florida/FL,1208607,"Miami-Dade County (Northeast)--Hialeah City (North Central) PUMA, Florida/FL",12086,"Miami-Dade County, Florida",2715516,168774,3202,6215,118,1,0,16,265,51,0,13,51,16,278,13,281,294,345,0,15,4,81,0,5,4,77,15,85,5,81
12,Florida/FL,1208608,"Miami-Dade County (North Central)--Doral, Sweetwater Cities & Fontainebleau PUMA, Florida/FL",12086,"Miami-Dade County, Florida",2715516,168774,3202,6215,118,1,0,84,73,25,0,19,25,84,92,19,157,176,201,0,12,9,78,0,42,9,36,12,88,42,46
12,Florida/FL,1208609,"Miami-Dade County (Northeast)--Hialeah City (South Central) PUMA, Florida/FL",12086,"Miami-Dade County, Florida",2715516,168774,3202,6215,118,1,0,58,236,0,0,0,0,58,236,0,294,294,294,0,0,0,100,0,20,0,80,0,100,20,80
12,Florida/FL,1208610,"Miami-Dade County (Central)--Miami Springs City & Miami International Airport PUMA, Florida/FL",12086,"Miami-Dade County, Florida",2715516,168774,3202,6215,118,1,13,35,123,0,0,0,13,35,123,0,158,158,171,8,0,0,92,0,20,0,72,8,92,20,72
12,Florida/FL,1208611,"Miami-Dade County (Northeast Central)--Miami City (North) PUMA, Florida/FL",12086,"Miami-Dade County, Florida",2715516,168774,3202,6215,118,1,59,0,115,0,17,66,59,17,181,83,115,198,257,23,0,32,45,7,0,26,45,23,77,7,70
12,Florida/FL,1208612,"Miami-Dade County (Northeast)--Miami Beach City & Miami Shores Village PUMA, Florida/FL",12086,"Miami-Dade County, Florida",2715516,168774,3202,6215,118,1,23,0,13,36,0,0,59,0,13,0,13,13,72,32,50,0,18,0,0,0,18,82,18,0,18
12,Florida/FL,1208613,"Miami-Dade County (Northeast Central)--Miami City (Downtown) PUMA, Florida/FL",12086,"Miami-Dade County, Florida",2715516,168774,3202,6215,118,1,0,215,219,31,0,10,31,215,229,10,434,444,475,0,7,2,91,0,45,2,46,7,93,45,48
12,Florida/FL,1208614,"Miami-Dade County (East)--Miami City (East) & Key Biscayne Village PUMA, Florida/FL",12086,"Miami-Dade County, Florida",2715516,168774,3202,6215,118,1,32,17,50,38,2,1,70,19,51,3,67,70,140,23,27,2,48,1,12,1,36,50,50,14,36
12,Florida/FL,1208615,"Miami-Dade County (East Central)--Miami City (West) PUMA, Florida/FL",12086,"Miami-Dade County, Florida",2715516,168774,3202,6215,118,1,0,4,33,21,0,0,21,4,33,0,37,37,58,0,36,0,64,0,7,0,57,36,64,7,57
12,Florida/FL,1208616,"Miami-Dade County (East)--Coral Gables City, Pinecrest Village & Kendall (South) PUMA, Florida/FL",12086,"Miami-Dade County, Florida",2715516,168774,3202,6215,118,1,10,67,32,6,0,0,16,67,32,0,99,99,115,9,5,0,86,0,58,0,28,14,86,58,28
12,Florida/FL,1208617,"Miami-Dade County (East Central)--South Miami City, Westchester & Coral Terrace PUMA, Florida/FL",12086,"Miami-Dade County, Florida",2715516,168774,3202,6215,118,1,0,105,94,10,0,0,10,105,94,0,199,199,209,0,5,0,95,0,50,0,45,5,95,50,45
12,Florida/FL,1208618,"Miami-Dade County (North Central)--Tamiami Trail Region (South)--Tamiami PUMA, Florida/FL",12086,"Miami-Dade County, Florida",2715516,168774,3202,6215,118,1,4,74,503,11,0,0,15,74,503,0,577,577,592,1,2,0,97,0,12,0,85,3,97,12,85
12,Florida/FL,1208619,"Miami-Dade County (Central)--Kendale Lakes (Southwest) & Kendall West (South) PUMA, Florida/FL",12086,"Miami-Dade County, Florida",2715516,168774,3202,6215,118,1,0,9,313,0,0,0,0,9,313,0,322,322,322,0,0,0,100,0,3,0,97,0,100,3,97
12,Florida/FL,1208620,"Miami-Dade County (East Central)--Kendall (North), Sunset & Westwood Lakes PUMA, Florida/FL",12086,"Miami-Dade County, Florida",2715516,168774,3202,6215,118,1,10,0,110,19,0,0,29,0,110,0,110,110,139,7,14,0,79,0,0,0,79,21,79,0,79
12,Florida/FL,1208621,"Miami-Dade County (Central)--The Hammocks (West), Richmond West (West) & Country Walk PUMA, Florida/FL",12086,"Miami-Dade County, Florida",2715516,168774,3202,6215,118,1,17,62,46,0,0,0,17,62,46,0,108,108,125,14,0,0,86,0,50,0,37,14,86,50,37
12,Florida/FL,1208622,"Miami-Dade County (Southwest)--South Miami Heights PUMA, Florida/FL",12086,"Miami-Dade County, Florida",2715516,168774,3202,6215,118,1,0,82,378,47,23,0,47,105,378,23,460,483,530,0,9,4,87,4,15,0,71,9,91,20,71
12,Florida/FL,1208623,"Miami-Dade County (Southeast)--Cutler Bay Town & Palmetto Bay Village PUMA, Florida/FL",12086,"Miami-Dade County, Florida",2715516,168774,3202,6215,118,1,0,0,386,0,3,55,0,3,441,58,386,444,444,0,0,13,87,1,0,12,87,0,100,1,99
12,Florida/FL,1208624,"Miami-Dade County (South)--Homestead City (North) & Florida City (North) PUMA, Florida/FL",12086,"Miami-Dade County, Florida",2715516,168774,3202,6215,118,1,72,230,1459,114,40,42,186,270,1501,82,1689,1771,1957,4,6,4,86,2,12,2,75,10,90,14,77
12,Florida/FL,1208700,"Miami-Dade (South/Outside Urban Development Boundary) & Monroe Counties PUMA, Florida/FL",12086,"Miami-Dade County, Florida",2715516,168774,3202,6215,118,0.279,11,30,144,21,9,11,32,39,155,20,174,194,226,5,9,9,77,4,13,5,64,14,86,17,69
12,Florida/FL,1208700,"Miami-Dade (South/Outside Urban Development Boundary) & Monroe Counties PUMA, Florida/FL",12087,"Monroe County, Florida",76325,1828,22,2395,29,0.721,29,78,371,53,23,28,82,101,399,51,449,500,582,5,9,9,77,4,13,5,64,14,86,17,69
12,Florida/FL,1208900,"Nassau & Baker Counties PUMA, Florida/FL",12003,"Baker County, Florida",27785,1449,11,5215,40,0.257,32,0,1,0,0,0,32,0,1,0,1,1,33,97,0,0,3,0,0,0,3,97,3,0,3
12,Florida/FL,1208900,"Nassau & Baker Counties PUMA, Florida/FL",12089,"Nassau County, Florida",80578,2075,42,2575,52,0.743,92,0,3,0,0,0,92,0,3,0,3,3,95,97,0,0,3,0,0,0,3,97,3,0,3
12,Florida/FL,1209100,"Okaloosa County PUMA, Florida/FL",12091,"Okaloosa County, Florida",200737,4883,109,2433,54,1,78,0,0,0,30,0,78,30,0,30,0,30,108,72,0,28,0,28,0,0,0,72,28,28,0
12,Florida/FL,1209300,"Southeast Heartland--Highlands (South & East), Okeechobee, Hendry & Glades Counties PUMA, Florida/FL",12043,"Glades County, Florida",13363,523,4,3914,30,0.133,98,22,363,96,2,2,194,24,365,4,385,389,583,17,16,1,66,0,4,0,62,33,67,4,63
12,Florida/FL,1209300,"Southeast Heartland--Highlands (South & East), Okeechobee, Hendry & Glades Counties PUMA, Florida/FL",12051,"Hendry County, Florida",40127,2063,42,5141,105,0.375,278,62,1025,271,5,4,549,67,1029,9,1087,1096,1645,17,16,1,66,0,4,0,62,33,67,4,63
12,Florida/FL,1209300,"Southeast Heartland--Highlands (South & East), Okeechobee, Hendry & Glades Counties PUMA, Florida/FL",12055,"Highlands County, Florida",102101,2127,82,2083,80,0.106,78,17,290,77,1,1,155,18,291,2,307,309,464,17,17,0,66,0,4,0,62,33,67,4,63
12,Florida/FL,1209300,"Southeast Heartland--Highlands (South & East), Okeechobee, Hendry & Glades Counties PUMA, Florida/FL",12093,"Okeechobee County, Florida",40572,1521,25,3749,62,0.385,285,64,1052,278,5,5,563,69,1057,10,1116,1126,1689,17,16,1,66,0,4,0,62,33,67,4,63
12,Florida/FL,1209501,"Orange County (Northwest) PUMA, Florida/FL",12095,"Orange County, Florida",1321194,39716,443,3006,34,1,263,198,248,35,9,0,298,207,248,9,446,455,753,35,5,1,59,1,26,0,33,40,60,27,33
12,Florida/FL,1209502,"Orange County (West Central)--Winter Garden, Ocoee Cities & Oakland Town PUMA, Florida/FL",12095,"Orange County, Florida",1321194,39716,443,3006,34,1,71,0,90,0,0,0,71,0,90,0,90,90,161,44,0,0,56,0,0,0,56,44,56,0,56
12,Florida/FL,1209503,"Orange County (Southwest)--Disney-International Drive Region PUMA, Florida/FL",12095,"Orange County, Florida",1321194,39716,443,3006,34,1,23,0,29,0,0,0,23,0,29,0,29,29,52,44,0,0,56,0,0,0,56,44,56,0,56
12,Florida/FL,1209504,"Orange County (South Central)--Orlando City (South Central), Conway & Pine Castle PUMA, Florida/FL",12095,"Orange County, Florida",1321194,39716,443,3006,34,1,134,0,223,110,12,75,244,12,298,87,223,310,554,24,20,16,40,2,0,14,40,44,56,2,54
12,Florida/FL,1209505,"Orange County (Central)--Orlando City (East Downtown) & Azalea Park PUMA, Florida/FL",12095,"Orange County, Florida",1321194,39716,443,3006,34,1,10,14,83,90,0,0,100,14,83,0,97,97,197,5,46,0,49,0,7,0,42,51,49,7,42
12,Florida/FL,1209506,"Orange County (Central)--Orlando City (West Downtown) & Pine Hills (Southeast) PUMA, Florida/FL",12095,"Orange County, Florida",1321194,39716,443,3006,34,1,86,0,0,7,22,0,93,22,0,22,0,22,115,75,6,19,0,19,0,0,0,81,19,19,0
12,Florida/FL,1209507,"Orange County (North Central)--Orlando (North), Winter Park & Maitland Cities PUMA, Florida/FL",12095,"Orange County, Florida",1321194,39716,443,3006,34,1,26,0,0,0,15,0,26,15,0,15,0,15,41,63,0,37,0,37,0,0,0,63,37,37,0
12,Florida/FL,1209508,"Orange County (North Central)--Orlando City (Univ. of Central Florida) & Union Park PUMA, Florida/FL",12095,"Orange County, Florida",1321194,39716,443,3006,34,1,73,0,0,10,0,11,83,0,11,11,0,11,94,78,11,12,0,0,0,12,0,88,12,0,12
12,Florida/FL,1209509,"Orange County (Southeast) PUMA, Florida/FL",12095,"Orange County, Florida",1321194,39716,443,3006,34,1,86,0,45,103,23,0,189,23,45,23,45,68,257,33,40,9,18,9,0,0,18,74,26,9,18
12,Florida/FL,1209510,"Orange County (Northeast) PUMA, Florida/FL",12095,"Orange County, Florida",1321194,39716,443,3006,34,1,116,143,0,17,0,12,133,143,12,12,143,155,288,40,6,4,50,0,50,4,0,46,54,50,4
12,Florida/FL,1209701,"Osceola County (West) PUMA, Florida/FL",12097,"Osceola County, Florida",338619,12354,145,3648,43,1,92,101,0,149,0,0,241,101,0,0,101,101,342,27,44,0,30,0,30,0,0,70,30,30,0
12,Florida/FL,1209702,"Osceola County (East) PUMA, Florida/FL",12097,"Osceola County, Florida",338619,12354,145,3648,43,1,224,0,8,170,0,0,394,0,8,0,8,8,402,56,42,0,2,0,0,0,2,98,2,0,2
12,Florida/FL,1209901,"Palm Beach County (Northeast) PUMA, Florida/FL",12099,"Palm Beach County, Florida",1446277,46021,1337,3182,92,1,11,0,0,0,0,0,11,0,0,0,0,0,11,100,0,0,0,0,0,0,0,100,0,0,0
12,Florida/FL,1209902,"Palm Beach County (Northeast)--Palm Beach Gardens & Riviera Beach Cities PUMA, Florida/FL",12099,"Palm Beach County, Florida",1446277,46021,1337,3182,92,1,108,0,50,7,11,0,115,11,50,11,50,61,176,61,4,6,28,6,0,0,28,65,35,6,28
12,Florida/FL,1209903,"Palm Beach County (East)--West Palm Beach City (Southeast) & Palm Beach Town PUMA, Florida/FL",12099,"Palm Beach County, Florida",1446277,46021,1337,3182,92,1,98,107,156,81,14,18,179,121,174,32,263,295,474,21,17,7,55,3,23,4,33,38,62,26,37
12,Florida/FL,1209904,"Palm Beach County (East)--Greenacres City (North) & Palm Springs Village (North) PUMA, Florida/FL",12099,"Palm Beach County, Florida",1446277,46021,1337,3182,92,1,11,99,241,55,31,18,66,130,259,49,340,389,455,2,12,11,75,7,22,4,53,15,85,29,57
12,Florida/FL,1209905,"Palm Beach County (East Central)--Lake Worth City, Lantana Town & Atlantis City PUMA, Florida/FL",12099,"Palm Beach County, Florida",1446277,46021,1337,3182,92,1,65,41,443,33,0,216,98,41,659,216,484,700,798,8,4,27,61,0,5,27,56,12,88,5,83
12,Florida/FL,1209906,"Palm Beach County (East Central)--Greater Boynton Beach City (North) PUMA, Florida/FL",12099,"Palm Beach County, Florida",1446277,46021,1337,3182,92,1,7,45,0,0,22,0,7,67,0,22,45,67,74,9,0,30,61,30,61,0,0,9,91,91,0
12,Florida/FL,1209907,"Palm Beach County (Southeast)--Greater Delray Beach City PUMA, Florida/FL",12099,"Palm Beach County, Florida",1446277,46021,1337,3182,92,1,19,11,0,0,27,0,19,38,0,27,11,38,57,33,0,47,19,47,19,0,0,33,67,67,0
12,Florida/FL,1209908,"Palm Beach County (Southeast)--Boca Raton City & Highland Beach Town PUMA, Florida/FL",12099,"Palm Beach County, Florida",1446277,46021,1337,3182,92,1,43,0,0,21,0,0,64,0,0,0,0,0,64,67,33,0,0,0,0,0,0,100,0,0,0
12,Florida/FL,1209909,"Palm Beach County (West of Boca Raton City) PUMA, Florida/FL",12099,"Palm Beach County, Florida",1446277,46021,1337,3182,92,1,79,0,0,0,0,0,79,0,0,0,0,0,79,100,0,0,0,0,0,0,0,100,0,0,0
12,Florida/FL,1209910,"Palm Beach County (Central)--Wellington Village & Agricultural Reserve PUMA, Florida/FL",12099,"Palm Beach County, Florida",1446277,46021,1337,3182,92,1,79,57,126,0,23,26,79,80,152,49,183,232,311,25,0,16,59,7,18,8,41,25,75,26,49
12,Florida/FL,1209911,"Palm Beach County (West)--Glades & Western Communities PUMA, Florida/FL",12099,"Palm Beach County, Florida",1446277,46021,1337,3182,92,1,645,403,606,164,86,314,809,489,920,400,1009,1409,2218,29,7,18,45,4,18,14,27,36,64,22,41
12,Florida/FL,1210101,"Pasco County (East Central) PUMA, Florida/FL",12101,"Pasco County, Florida",510593,9101,208,1782,41,1,238,0,316,155,0,0,393,0,316,0,316,316,709,34,22,0,45,0,0,0,45,55,45,0,45
12,Florida/FL,1210102,"Pasco County (West Central) PUMA, Florida/FL",12101,"Pasco County, Florida",510593,9101,208,1782,41,1,23,0,0,0,0,0,23,0,0,0,0,0,23,100,0,0,0,0,0,0,0,100,0,0,0
12,Florida/FL,1210103,"Pasco County (Gulf Coast) PUMA, Florida/FL",12101,"Pasco County, Florida",510593,9101,208,1782,41,1,21,0,15,0,11,4,21,11,19,15,15,30,51,41,0,29,29,22,0,8,29,41,59,22,37
12,Florida/FL,1210104,"Pasco County (South) PUMA, Florida/FL",12101,"Pasco County, Florida",510593,9101,208,1782,41,1,149,72,0,0,0,0,149,72,0,0,72,72,221,67,0,0,33,0,33,0,0,67,33,33,0
12,Florida/FL,1210301,"Pinellas County (North) PUMA, Florida/FL",12103,"Pinellas County, Florida",957875,21845,742,2281,77,1,28,0,0,0,0,0,28,0,0,0,0,0,28,100,0,0,0,0,0,0,0,100,0,0,0
12,Florida/FL,1210302,"Pinellas County (North Central) PUMA, Florida/FL",12103,"Pinellas County, Florida",957875,21845,742,2281,77,1,39,0,0,0,0,0,39,0,0,0,0,0,39,100,0,0,0,0,0,0,0,100,0,0,0
12,Florida/FL,1210303,"Pinellas County (Central)--Clearwater City (South & Central) PUMA, Florida/FL",12103,"Pinellas County, Florida",957875,21845,742,2281,77,1,113,0,0,0,0,16,113,0,16,16,0,16,129,88,0,12,0,0,0,12,0,88,12,0,12
12,Florida/FL,1210304,"Pinellas County (Central)--Greater Largo City PUMA, Florida/FL",12103,"Pinellas County, Florida",957875,21845,742,2281,77,1,0,0,0,42,0,0,42,0,0,0,0,0,42,0,100,0,0,0,0,0,0,100,0,0,0
12,Florida/FL,1210305,"Pinellas County (West Central)--Greater Seminole City PUMA, Florida/FL",12103,"Pinellas County, Florida",957875,21845,742,2281,77,1,36,0,27,0,0,0,36,0,27,0,27,27,63,57,0,0,43,0,0,0,43,57,43,0,43
12,Florida/FL,1210306,"Pinellas County (Central)--Greater Pinellas Park City PUMA, Florida/FL",12103,"Pinellas County, Florida",957875,21845,742,2281,77,1,0,0,14,0,52,2,0,52,16,54,14,68,68,0,0,79,21,76,0,3,21,0,100,76,24
12,Florida/FL,1210307,"Pinellas County (Southeast)--St. Petersburg City (East) PUMA, Florida/FL",12103,"Pinellas County, Florida",957875,21845,742,2281,77,1,161,0,0,0,0,0,161,0,0,0,0,0,161,100,0,0,0,0,0,0,0,100,0,0,0
12,Florida/FL,1210308,"Pinellas County (South Central)--St. Petersburg City (West) PUMA, Florida/FL",12103,"Pinellas County, Florida",957875,21845,742,2281,77,1,69,0,0,0,0,0,69,0,0,0,0,0,69,100,0,0,0,0,0,0,0,100,0,0,0
12,Florida/FL,1210501,"Polk County (Northwest) PUMA, Florida/FL",12105,"Polk County, Florida",668671,19647,526,2938,79,1,227,97,323,82,0,28,309,97,351,28,420,448,757,30,11,4,55,0,13,4,43,41,59,13,46
12,Florida/FL,1210502,"Polk County (Northeast) PUMA, Florida/FL",12105,"Polk County, Florida",668671,19647,526,2938,79,1,392,42,70,191,21,50,583,63,120,71,112,183,766,51,25,9,15,3,5,7,9,76,24,8,16
12,Florida/FL,1210503,"Polk County (Central) PUMA, Florida/FL",12105,"Polk County, Florida",668671,19647,526,2938,79,1,225,14,461,445,0,106,670,14,567,106,475,581,1251,18,36,8,38,0,1,8,37,54,46,1,45
12,Florida/FL,1210504,"Polk County (South) PUMA, Florida/FL",12105,"Polk County, Florida",668671,19647,526,2938,79,1,627,15,747,159,0,33,786,15,780,33,762,795,1581,40,10,2,48,0,1,2,47,50,50,1,49
12,Florida/FL,1210700,"Putnam & St. Johns (South) Counties PUMA, Florida/FL",12107,"Putnam County, Florida",72766,2107,38,2896,52,0.689,278,49,314,100,0,15,378,49,329,15,363,378,756,37,13,2,48,0,6,2,42,50,50,6,44
12,Florida/FL,1210700,"Putnam & St. Johns (South) Counties PUMA, Florida/FL",12109,"St. Johns County, Florida",235503,5235,69,2223,29,0.311,126,22,142,45,0,7,171,22,149,7,164,171,342,37,13,2,48,0,6,2,42,50,50,6,44
12,Florida/FL,1210900,"St. Johns County (North) PUMA, Florida/FL",12109,"St. Johns County, Florida",235503,5235,69,2223,29,1,214,45,0,96,0,0,310,45,0,0,45,45,355,60,27,0,13,0,13,0,0,87,13,13,0
12,Florida/FL,1211101,"St. Lucie County (North) PUMA, Florida/FL",12111,"St. Lucie County, Florida",305591,7952,275,2602,90,1,125,35,241,0,46,123,125,81,364,169,276,445,570,22,0,30,48,8,6,22,42,22,78,14,64
12,Florida/FL,1211102,"St. Lucie County (South) PUMA, Florida/FL",12111,"St. Lucie County, Florida",305591,7952,275,2602,90,1,136,0,0,0,0,0,136,0,0,0,0,0,136,100,0,0,0,0,0,0,0,100,0,0,0
12,Florida/FL,1211300,"Santa Rosa County PUMA, Florida/FL",12113,"Santa Rosa County, Florida",170442,5279,76,3097,45,1,239,0,42,0,7,0,239,7,42,7,42,49,288,83,0,2,15,2,0,0,15,83,17,2,15
12,Florida/FL,1211501,"Sarasota County (North) PUMA, Florida/FL",12115,"Sarasota County, Florida",412144,8065,254,1957,62,1,433,0,89,36,0,0,469,0,89,0,89,89,558,78,6,0,16,0,0,0,16,84,16,0,16
12,Florida/FL,1211502,"Sarasota County (Central & Gulf Coast) PUMA, Florida/FL",12115,"Sarasota County, Florida",412144,8065,254,1957,62,1,77,11,141,26,0,16,103,11,157,16,152,168,271,28,10,6,56,0,4,6,52,38,62,4,58
12,Florida/FL,1211503,"Sarasota County (East) PUMA, Florida/FL",12115,"Sarasota County, Florida",412144,8065,254,1957,62,1,7,0,4,0,0,0,7,0,4,0,4,4,11,64,0,0,36,0,0,0,36,64,36,0,36
12,Florida/FL,1211701,"Seminole County (West) PUMA, Florida/FL",12117,"Seminole County, Florida",455086,8946,207,1966,45,1,47,0,58,0,0,9,47,0,67,9,58,67,114,41,0,8,51,0,0,8,51,41,59,0,59
12,Florida/FL,1211702,"Seminole County (North Central) PUMA, Florida/FL",12117,"Seminole County, Florida",455086,8946,207,1966,45,1,119,0,124,164,15,0,283,15,124,15,124,139,422,28,39,4,29,4,0,0,29,67,33,4,29
12,Florida/FL,1211703,"Seminole County (South Central) PUMA, Florida/FL",12117,"Seminole County, Florida",455086,8946,207,1966,45,1,61,0,18,26,0,0,87,0,18,0,18,18,105,58,25,0,17,0,0,0,17,83,17,0,17
12,Florida/FL,1211704,"Seminole County (East) PUMA, Florida/FL",12117,"Seminole County, Florida",455086,8946,207,1966,45,1,0,0,33,0,0,0,0,0,33,0,33,33,33,0,0,0,100,0,0,0,100,0,100,0,100
12,Florida/FL,1212100,"Suwannee, Taylor, Madison, Hamilton & Lafayette Counties PUMA, Florida/FL",12047,"Hamilton County, Florida",14269,849,8,5950,56,0.134,176,8,30,23,0,7,199,8,37,7,38,45,244,72,9,3,16,0,3,3,12,82,18,3,15
12,Florida/FL,1212100,"Suwannee, Taylor, Madison, Hamilton & Lafayette Counties PUMA, Florida/FL",12067,"Lafayette County, Florida",8744,1234,12,14113,137,0.08,105,5,18,14,0,4,119,5,22,4,23,27,146,72,10,3,16,0,3,3,12,82,18,3,15
12,Florida/FL,1212100,"Suwannee, Taylor, Madison, Hamilton & Lafayette Counties PUMA, Florida/FL",12079,"Madison County, Florida",18474,1013,18,5483,97,0.17,223,11,38,30,0,8,253,11,46,8,49,57,310,72,10,3,16,0,4,3,12,82,18,4,15
12,Florida/FL,1212100,"Suwannee, Taylor, Madison, Hamilton & Lafayette Counties PUMA, Florida/FL",12121,"Suwannee County, Florida",43924,2674,69,6088,157,0.409,536,25,91,72,0,20,608,25,111,20,116,136,744,72,10,3,16,0,3,3,12,82,18,3,15
12,Florida/FL,1212100,"Suwannee, Taylor, Madison, Hamilton & Lafayette Counties PUMA, Florida/FL",12123,"Taylor County, Florida",22098,1317,12,5960,54,0.207,271,13,46,36,0,10,307,13,56,10,59,69,376,72,10,3,16,0,3,3,12,82,18,3,15
12,Florida/FL,1212701,"Volusia County (Central & Northwest)--DeLand, DeBary Cities & Pierson Town PUMA, Florida/FL",12127,"Volusia County, Florida",527634,10738,239,2035,45,1,130,63,280,124,0,0,254,63,280,0,343,343,597,22,21,0,57,0,11,0,47,43,57,11,47
12,Florida/FL,1212702,"Volusia County (Northeast)--Daytona Beach, Ormond Beach & Holly Hill Cities PUMA, Florida/FL",12127,"Volusia County, Florida",527634,10738,239,2035,45,1,0,0,40,0,0,0,0,0,40,0,40,40,40,0,0,0,100,0,0,0,100,0,100,0,100
12,Florida/FL,1212703,"Volusia County--Port Orange, Edgewater, New Smyrna Beach (East) & Oak Hill Cities PUMA, Florida/FL",12127,"Volusia County, Florida",527634,10738,239,2035,45,1,291,0,17,0,9,0,291,9,17,9,17,26,317,92,0,3,5,3,0,0,5,92,8,3,5
12,Florida/FL,1212704,"Volusia County (Southwest Central)--Deltona & Lake Helen Cities PUMA, Florida/FL",12127,"Volusia County, Florida",527634,10738,239,2035,45,1,141,35,36,44,38,38,185,73,74,76,71,147,332,42,13,23,21,11,11,11,11,56,44,22,22
13,Georgia/GA,1300100,"Coastal Regional Commission (South)--Glynn Camden & McIntosh Counties PUMA, Georgia/GA",13039,"Camden County, Georgia",52714,1277,8,2423,15,0.35,214,0,12,43,5,0,257,5,12,5,12,17,274,78,16,2,4,2,0,0,4,94,6,2,4
13,Georgia/GA,1300100,"Coastal Regional Commission (South)--Glynn Camden & McIntosh Counties PUMA, Georgia/GA",13127,"Glynn County, Georgia",83974,3446,94,4104,112,0.558,341,0,20,68,7,0,409,7,20,7,20,27,436,78,16,2,5,2,0,0,5,94,6,2,5
13,Georgia/GA,1300100,"Coastal Regional Commission (South)--Glynn Camden & McIntosh Counties PUMA, Georgia/GA",13191,"McIntosh County, Georgia",14120,287,7,2033,50,0.092,56,0,3,11,1,0,67,1,3,1,3,4,71,79,15,1,4,1,0,0,4,94,6,1,4
13,Georgia/GA,1300200,"Coastal Regional Commission (West)--Liberty, Bryan & Long Counties PUMA, Georgia/GA",13029,"Bryan County, Georgia",35885,1141,11,3180,31,0.309,30,0,47,0,0,4,30,0,51,4,47,51,81,37,0,5,58,0,0,5,58,37,63,0,63
13,Georgia/GA,1300200,"Coastal Regional Commission (West)--Liberty, Bryan & Long Counties PUMA, Georgia/GA",13179,"Liberty County, Georgia",62108,1103,22,1776,35,0.534,51,0,81,0,0,6,51,0,87,6,81,87,138,37,0,4,59,0,0,4,59,37,63,0,63
13,Georgia/GA,1300200,"Coastal Regional Commission (West)--Liberty, Bryan & Long Counties PUMA, Georgia/GA",13183,"Long County, Georgia",18156,246,3,1355,17,0.157,15,0,24,0,0,2,15,0,26,2,24,26,41,37,0,5,59,0,0,5,59,37,63,0,63
13,Georgia/GA,1300300,"Coastal Regional Commission (North)--Bulloch, Effingham & Screven Counties PUMA, Georgia/GA",13031,"Bulloch County, Georgia",74782,2859,27,3823,36,0.507,335,0,64,9,111,0,344,111,64,111,64,175,519,65,2,21,12,21,0,0,12,66,34,21,12
13,Georgia/GA,1300300,"Coastal Regional Commission (North)--Bulloch, Effingham & Screven Counties PUMA, Georgia/GA",13103,"Effingham County, Georgia",58689,1423,23,2425,39,0.398,263,0,51,7,87,0,270,87,51,87,51,138,408,64,2,21,12,21,0,0,12,66,34,21,12
13,Georgia/GA,1300300,"Coastal Regional Commission (North)--Bulloch, Effingham & Screven Counties PUMA, Georgia/GA",13251,"Screven County, Georgia",13990,406,10,2902,71,0.095,63,0,12,2,21,0,65,21,12,21,12,33,98,64,2,21,12,21,0,0,12,66,34,21,12
13,Georgia/GA,1300401,"Coastal Regional Commission (East)--Chatham County (West Central)--Savannah City PUMA, Georgia/GA",13051,"Chatham County, Georgia",287049,8377,154,2918,54,1,397,0,15,0,0,0,397,0,15,0,15,15,412,96,0,0,4,0,0,0,4,96,4,0,4
13,Georgia/GA,1300402,"Coastal Regional Commission (East)--Chatham County (East & Outside Savannah City) PUMA, Georgia/GA",13051,"Chatham County, Georgia",287049,8377,154,2918,54,1,55,0,0,0,0,0,55,0,0,0,0,0,55,100,0,0,0,0,0,0,0,100,0,0,0
13,Georgia/GA,1300500,"Southern Georgia Regional Commission (East & Central) PUMA, Georgia/GA",13003,"Atkinson County, Georgia",8265,441,3,5336,36,0.049,76,4,24,22,0,9,98,4,33,9,28,37,135,56,16,7,21,0,3,7,18,73,27,3,24
13,Georgia/GA,1300500,"Southern Georgia Regional Commission (East & Central) PUMA, Georgia/GA",13005,"Bacon County, Georgia",11228,595,14,5299,125,0.067,103,5,33,30,0,12,133,5,45,12,38,50,183,56,16,7,21,0,3,7,18,73,27,3,25
13,Georgia/GA,1300500,"Southern Georgia Regional Commission (East & Central) PUMA, Georgia/GA",13025,"Brantley County, Georgia",18561,343,10,1848,54,0.108,166,8,54,48,0,19,214,8,73,19,62,81,295,56,16,6,21,0,3,6,18,73,27,3,25
13,Georgia/GA,1300500,"Southern Georgia Regional Commission (East & Central) PUMA, Georgia/GA",13049,"Charlton County, Georgia",12983,625,7,4814,54,0.074,114,5,37,33,0,13,147,5,50,13,42,55,202,56,16,6,21,0,2,6,18,73,27,2,25
13,Georgia/GA,1300500,"Southern Georgia Regional Commission (East & Central) PUMA, Georgia/GA",13065,"Clinch County, Georgia",6743,376,6,5576,89,0.04,62,3,20,18,0,7,80,3,27,7,23,30,110,56,16,6,21,0,3,6,18,73,27,3,25
13,Georgia/GA,1300500,"Southern Georgia Regional Commission (East & Central) PUMA, Georgia/GA",13069,"Coffee County, Georgia",42961,2036,48,4739,112,0.254,391,19,126,113,0,45,504,19,171,45,145,190,694,56,16,6,21,0,3,6,18,73,27,3,25
13,Georgia/GA,1300500,"Southern Georgia Regional Commission (East & Central) PUMA, Georgia/GA",13101,"Echols County, Georgia",3994,240,2,6009,50,0.023,35,2,11,10,0,4,45,2,15,4,13,17,62,56,16,6,21,0,3,6,18,73,27,3,24
13,Georgia/GA,1300500,"Southern Georgia Regional Commission (East & Central) PUMA, Georgia/GA",13173,"Lanier County, Georgia",10366,295,5,2846,48,0.061,94,5,30,27,0,11,121,5,41,11,35,46,167,56,16,7,21,0,3,7,18,72,28,3,25
13,Georgia/GA,1300500,"Southern Georgia Regional Commission (East & Central) PUMA, Georgia/GA",13229,"Pierce County, Georgia",19164,602,20,3141,104,0.113,174,8,56,50,0,20,224,8,76,20,64,84,308,56,16,6,21,0,3,6,18,73,27,3,25
13,Georgia/GA,1300500,"Southern Georgia Regional Commission (East & Central) PUMA, Georgia/GA",13299,"Ware County, Georgia",35599,1480,59,4157,166,0.211,325,16,105,94,0,38,419,16,143,38,121,159,578,56,16,7,21,0,3,7,18,72,28,3,25
13,Georgia/GA,1300600,"Southern Georgia Regional Commission (South Central)--Lowndes County--Valdosta City PUMA, Georgia/GA",13185,"Lowndes County, Georgia",114582,3872,81,3379,71,1,304,58,163,82,0,0,386,58,163,0,221,221,607,50,14,0,36,0,10,0,27,64,36,10,27
13,Georgia/GA,1300700,"Southern Georgia Regional Commission (West) PUMA, Georgia/GA",13017,"Ben Hill County, Georgia",17154,760,23,4430,134,0.135,145,16,99,21,1,0,166,17,99,1,115,116,282,51,7,0,41,0,6,0,35,59,41,6,35
13,Georgia/GA,1300700,"Southern Georgia Regional Commission (West) PUMA, Georgia/GA",13019,"Berrien County, Georgia",19025,446,12,2344,63,0.149,160,17,109,23,1,0,183,18,109,1,126,127,310,52,7,0,41,0,5,0,35,59,41,6,35
13,Georgia/GA,1300700,"Southern Georgia Regional Commission (West) PUMA, Georgia/GA",13027,"Brooks County, Georgia",15622,515,25,3297,160,0.123,132,14,90,19,1,0,151,15,90,1,104,105,256,52,7,0,41,0,5,0,35,59,41,6,35
13,Georgia/GA,1300700,"Southern Georgia Regional Commission (West) PUMA, Georgia/GA",13075,"Cook County, Georgia",17184,548,13,3189,76,0.135,145,16,99,21,1,0,166,17,99,1,115,116,282,51,7,0,41,0,6,0,35,59,41,6,35
13,Georgia/GA,1300700,"Southern Georgia Regional Commission (West) PUMA, Georgia/GA",13155,"Irwin County, Georgia",9268,294,4,3172,43,0.074,80,9,54,12,1,0,92,10,54,1,63,64,156,51,8,1,40,1,6,0,35,59,41,6,35
13,Georgia/GA,1300700,"Southern Georgia Regional Commission (West) PUMA, Georgia/GA",13277,"Tift County, Georgia",40510,1754,56,4330,138,0.321,345,38,236,50,3,0,395,41,236,3,274,277,672,51,7,0,41,0,6,0,35,59,41,6,35
13,Georgia/GA,1300700,"Southern Georgia Regional Commission (West) PUMA, Georgia/GA",13287,"Turner County, Georgia",7962,296,22,3718,276,0.063,68,7,46,10,1,0,78,8,46,1,53,54,132,52,8,1,40,1,5,0,35,59,41,6,35
13,Georgia/GA,1300800,"Southwest Georgia Regional Commission (East)--Colquitt, Thomas & Worth Counties PUMA, Georgia/GA",13071,"Colquitt County, Georgia",45606,1877,33,4116,72,0.409,591,14,732,44,0,16,635,14,748,16,746,762,1397,42,3,1,53,0,1,1,52,45,55,1,54
13,Georgia/GA,1300800,"Southwest Georgia Regional Commission (East)--Colquitt, Thomas & Worth Counties PUMA, Georgia/GA",13275,"Thomas County, Georgia",44730,1486,63,3322,141,0.405,586,14,725,43,0,16,629,14,741,16,739,755,1384,42,3,1,53,0,1,1,52,45,55,1,54
13,Georgia/GA,1300800,"Southwest Georgia Regional Commission (East)--Colquitt, Thomas & Worth Counties PUMA, Georgia/GA",13321,"Worth County, Georgia",20656,528,30,2556,145,0.186,269,7,333,20,0,7,289,7,340,7,340,347,636,42,3,1,53,0,1,1,52,45,55,1,53
13,Georgia/GA,1300900,"Southwest Georgia Regional Commission (North Central)--Dougherty & Lee Counties PUMA, Georgia/GA",13095,"Dougherty County, Georgia",91049,3137,187,3445,205,0.754,1010,0,80,43,34,0,1053,34,80,34,80,114,1167,87,4,3,7,3,0,0,7,90,10,3,7
13,Georgia/GA,1300900,"Southwest Georgia Regional Commission (North Central)--Dougherty & Lee Counties PUMA, Georgia/GA",13177,"Lee County, Georgia",29348,697,25,2375,85,0.246,330,0,26,14,11,0,344,11,26,11,26,37,381,87,4,3,7,3,0,0,7,90,10,3,7
13,Georgia/GA,1301001,"Atlanta Regional Commission (Central)--Fulton County (North)--Sandy Springs City PUMA, Georgia/GA",13121,"Fulton County, Georgia",1021902,27389,571,2680,56,1,18,0,0,0,0,0,18,0,0,0,0,0,18,100,0,0,0,0,0,0,0,100,0,0,0
13,Georgia/GA,1301002,"Atlanta Regional Commission (Central)--Fulton County (Northeast)--Johns Creek City PUMA, Georgia/GA",13121,"Fulton County, Georgia",1021902,27389,571,2680,56,1,0,0,0,0,22,0,0,22,0,22,0,22,22,0,0,100,0,100,0,0,0,0,100,100,0
13,Georgia/GA,1301003,"Atlanta Regional Commission (Central)--Fulton County (Central)--Atlanta City (South) PUMA, Georgia/GA",13121,"Fulton County, Georgia",1021902,27389,571,2680,56,1,169,0,75,60,0,0,229,0,75,0,75,75,304,56,20,0,25,0,0,0,25,75,25,0,25
13,Georgia/GA,1301004,"Atlanta Regional Commission (Central)--Fulton County (South)--Union & Fairburn Cities PUMA, Georgia/GA",13121,"Fulton County, Georgia",1021902,27389,571,2680,56,1,172,0,0,7,0,0,179,0,0,0,0,0,179,96,4,0,0,0,0,0,0,100,0,0,0
13,Georgia/GA,1301005,"Atlanta Regional Commission (Central)--Fulton County (Northwest)--Roswell City PUMA, Georgia/GA",13121,"Fulton County, Georgia",1021902,27389,571,2680,56,1,237,0,258,0,0,13,237,0,271,13,258,271,508,47,0,3,51,0,0,3,51,47,53,0,53
13,Georgia/GA,1301006,"Atlanta Regional Commission (Central)--Fulton County (Central)--Atlanta City (North) PUMA, Georgia/GA",13121,"Fulton County, Georgia",1021902,27389,571,2680,56,1,82,0,0,0,0,0,82,0,0,0,0,0,82,100,0,0,0,0,0,0,0,100,0,0,0
13,Georgia/GA,1301007,"Atlanta Regional Commission (Central)--Fulton County (East)--Atlanta City (Southeast) PUMA, Georgia/GA",13089,"DeKalb County, Georgia",743187,18521,358,2492,48,0.208,16,0,0,0,2,0,16,2,0,2,0,2,18,89,0,11,0,11,0,0,0,89,11,11,0
13,Georgia/GA,1301007,"Atlanta Regional Commission (Central)--Fulton County (East)--Atlanta City (Southeast) PUMA, Georgia/GA",13121,"Fulton County, Georgia",1021902,27389,571,2680,56,0.792,63,0,0,0,8,0,63,8,0,8,0,8,71,89,0,11,0,11,0,0,0,89,11,11,0
13,Georgia/GA,1301008,"Atlanta Regional Commission (Central)--DeKalb County (South) PUMA, Georgia/GA",13089,"DeKalb County, Georgia",743187,18521,358,2492,48,1,318,0,0,0,0,0,318,0,0,0,0,0,318,100,0,0,0,0,0,0,0,100,0,0,0
13,Georgia/GA,1301100,"Southwest Georgia Regional Commission (West & Central) PUMA, Georgia/GA",13007,"Baker County, Georgia",3189,83,4,2603,125,0.027,66,0,16,1,0,0,67,0,16,0,16,16,83,80,1,0,19,0,0,0,19,81,19,0,19
13,Georgia/GA,1301100,"Southwest Georgia Regional Commission (West & Central) PUMA, Georgia/GA",13037,"Calhoun County, Georgia",6428,239,8,3718,124,0.054,131,0,31,1,0,0,132,0,31,0,31,31,163,80,1,0,19,0,0,0,19,81,19,0,19
13,Georgia/GA,1301100,"Southwest Georgia Regional Commission (West & Central) PUMA, Georgia/GA",13087,"Decatur County, Georgia",26833,1133,29,4222,108,0.229,558,0,132,5,0,0,563,0,132,0,132,132,695,80,1,0,19,0,0,0,19,81,19,0,19
13,Georgia/GA,1301100,"Southwest Georgia Regional Commission (West & Central) PUMA, Georgia/GA",13099,"Early County, Georgia",10348,486,32,4697,309,0.088,214,0,51,2,0,0,216,0,51,0,51,51,267,80,1,0,19,0,0,0,19,81,19,0,19
13,Georgia/GA,1301100,"Southwest Georgia Regional Commission (West & Central) PUMA, Georgia/GA",13131,"Grady County, Georgia",24926,768,22,3081,88,0.212,516,0,122,5,0,0,521,0,122,0,122,122,643,80,1,0,19,0,0,0,19,81,19,0,19
13,Georgia/GA,1301100,"Southwest Georgia Regional Commission (West & Central) PUMA, Georgia/GA",13201,"Miller County, Georgia",5836,254,1,4352,17,0.051,124,0,29,1,0,0,125,0,29,0,29,29,154,81,1,0,19,0,0,0,19,81,19,0,19
13,Georgia/GA,1301100,"Southwest Georgia Regional Commission (West & Central) PUMA, Georgia/GA",13205,"Mitchell County, Georgia",22432,793,45,3535,201,0.192,468,0,110,5,0,0,473,0,110,0,110,110,583,80,1,0,19,0,0,0,19,81,19,0,19
13,Georgia/GA,1301100,"Southwest Georgia Regional Commission (West & Central) PUMA, Georgia/GA",13253,"Seminole County, Georgia",8437,354,9,4196,107,0.072,175,0,41,2,0,0,177,0,41,0,41,41,218,80,1,0,19,0,0,0,19,81,19,0,19
13,Georgia/GA,1301100,"Southwest Georgia Regional Commission (West & Central) PUMA, Georgia/GA",13273,"Terrell County, Georgia",8859,328,31,3702,350,0.076,185,0,44,2,0,0,187,0,44,0,44,44,231,80,1,0,19,0,0,0,19,81,19,0,19
13,Georgia/GA,1301200,"Heart of Georgia Altamaha Regional Commission (Southeast) PUMA, Georgia/GA",13001,"Appling County, Georgia",18454,1021,26,5533,141,0.116,170,6,103,48,0,2,218,6,105,2,109,111,329,52,15,1,33,0,2,1,31,66,34,2,32
13,Georgia/GA,1301200,"Heart of Georgia Altamaha Regional Commission (Southeast) PUMA, Georgia/GA",13109,"Evans County, Georgia",10727,421,6,3925,56,0.067,98,4,60,28,0,1,126,4,61,1,64,65,191,51,15,1,34,0,2,1,31,66,34,2,32
13,Georgia/GA,1301200,"Heart of Georgia Altamaha Regional Commission (Southeast) PUMA, Georgia/GA",13161,"Jeff Davis County, Georgia",14991,713,20,4756,133,0.093,136,5,83,38,0,1,174,5,84,1,88,89,263,52,14,0,33,0,2,0,32,66,34,2,32
13,Georgia/GA,1301200,"Heart of Georgia Altamaha Regional Commission (Southeast) PUMA, Georgia/GA",13209,"Montgomery County, Georgia",9036,304,5,3364,55,0.057,83,3,51,24,0,1,107,3,52,1,54,55,162,51,15,1,33,0,2,1,31,66,34,2,32
13,Georgia/GA,1301200,"Heart of Georgia Altamaha Regional Commission (Southeast) PUMA, Georgia/GA",13267,"Tattnall County, Georgia",25353,826,11,3258,43,0.157,230,8,140,65,0,2,295,8,142,2,148,150,445,52,15,0,33,0,2,0,31,66,34,2,32
13,Georgia/GA,1301200,"Heart of Georgia Altamaha Regional Commission (Southeast) PUMA, Georgia/GA",13271,"Telfair County, Georgia",16115,383,18,2377,112,0.1,146,5,89,41,0,2,187,5,91,2,94,96,283,52,14,1,33,0,2,1,31,66,34,2,32
13,Georgia/GA,1301200,"Heart of Georgia Altamaha Regional Commission (Southeast) PUMA, Georgia/GA",13279,"Toombs County, Georgia",27048,1312,48,4851,177,0.171,250,9,152,71,0,3,321,9,155,3,161,164,485,52,15,1,33,0,2,1,31,66,34,2,32
13,Georgia/GA,1301200,"Heart of Georgia Altamaha Regional Commission (Southeast) PUMA, Georgia/GA",13305,"Wayne County, Georgia",29767,1118,29,3756,97,0.189,276,10,168,78,0,3,354,10,171,3,178,181,535,52,15,1,33,0,2,1,31,66,34,2,32
13,Georgia/GA,1301200,"Heart of Georgia Altamaha Regional Commission (Southeast) PUMA, Georgia/GA",13309,"Wheeler County, Georgia",7939,329,11,4144,139,0.05,73,3,45,21,0,1,94,3,46,1,48,49,143,51,15,1,34,0,2,1,31,66,34,2,32
13,Georgia/GA,1301300,"Heart of Georgia Altamaha Regional Commission (North & West) PUMA, Georgia/GA",13023,"Bleckley County, Georgia",12775,431,20,3374,157,0.093,76,3,12,7,0,0,83,3,12,0,15,15,98,78,7,0,15,0,3,0,12,85,15,3,12
13,Georgia/GA,1301300,"Heart of Georgia Altamaha Regional Commission (North & West) PUMA, Georgia/GA",13043,"Candler County, Georgia",10827,446,18,4119,166,0.078,64,2,10,6,0,0,70,2,10,0,12,12,82,78,7,0,15,0,2,0,12,85,15,2,12
13,Georgia/GA,1301300,"Heart of Georgia Altamaha Regional Commission (North & West) PUMA, Georgia/GA",13091,"Dodge County, Georgia",20919,417,12,1993,57,0.147,120,4,19,11,0,0,131,4,19,0,23,23,154,78,7,0,15,0,3,0,12,85,15,3,12
13,Georgia/GA,1301300,"Heart of Georgia Altamaha Regional Commission (North & West) PUMA, Georgia/GA",13107,"Emanuel County, Georgia",22499,1031,30,4582,133,0.162,132,5,21,13,0,0,145,5,21,0,26,26,171,77,8,0,15,0,3,0,12,85,15,3,12
13,Georgia/GA,1301300,"Heart of Georgia Altamaha Regional Commission (North & West) PUMA, Georgia/GA",13167,"Johnson County, Georgia",9730,414,22,4255,226,0.068,56,2,9,5,0,0,61,2,9,0,11,11,72,78,7,0,15,0,3,0,12,85,15,3,12
13,Georgia/GA,1301300,"Heart of Georgia Altamaha Regional Commission (North & West) PUMA, Georgia/GA",13175,"Laurens County, Georgia",47418,1632,67,3442,141,0.341,279,10,45,27,0,0,306,10,45,0,55,55,361,77,7,0,15,0,3,0,12,85,15,3,12
13,Georgia/GA,1301300,"Heart of Georgia Altamaha Regional Commission (North & West) PUMA, Georgia/GA",13283,"Treutlen County, Georgia",6777,256,8,3777,118,0.048,39,1,6,4,0,0,43,1,6,0,7,7,50,78,8,0,14,0,2,0,12,86,14,2,12
13,Georgia/GA,1301300,"Heart of Georgia Altamaha Regional Commission (North & West) PUMA, Georgia/GA",13315,"Wilcox County, Georgia",8846,248,20,2804,226,0.063,51,2,8,5,0,0,56,2,8,0,10,10,66,77,8,0,15,0,3,0,12,85,15,3,12
13,Georgia/GA,1301400,"Middle Georgia Regional Commission (Central)--Bibb County--Macon City PUMA, Georgia/GA",13021,"Bibb County, Georgia",153490,6024,168,3925,109,1,509,0,8,0,0,16,509,0,24,16,8,24,533,95,0,3,2,0,0,3,2,95,5,0,5
13,Georgia/GA,1301500,"Middle Georgia Regional Commission (South)--Houston & Pulaski Counties PUMA, Georgia/GA",13153,"Houston County, Georgia",151682,3109,80,2050,53,0.931,1285,0,0,16,39,33,1301,39,33,72,0,72,1373,94,1,5,0,3,0,2,0,95,5,3,2
13,Georgia/GA,1301500,"Middle Georgia Regional Commission (South)--Houston & Pulaski Counties PUMA, Georgia/GA",13235,"Pulaski County, Georgia",11295,312,22,2762,195,0.069,95,0,0,1,3,2,96,3,2,5,0,5,101,94,1,5,0,3,0,2,0,95,5,3,2
13,Georgia/GA,1301600,"Middle Georgia Regional Commission (North & Outside Bibb County) PUMA, Georgia/GA",13009,"Baldwin County, Georgia",45286,2087,56,4608,124,0.252,197,0,59,18,0,2,215,0,61,2,59,61,276,71,7,1,21,0,0,1,21,78,22,0,22
13,Georgia/GA,1301600,"Middle Georgia Regional Commission (North & Outside Bibb County) PUMA, Georgia/GA",13079,"Crawford County, Georgia",12344,166,5,1345,41,0.069,54,0,16,5,0,1,59,0,17,1,16,17,76,71,7,1,21,0,0,1,21,78,22,0,22
13,Georgia/GA,1301600,"Middle Georgia Regional Commission (North & Outside Bibb County) PUMA, Georgia/GA",13169,"Jones County, Georgia",28548,545,8,1909,28,0.16,125,0,38,12,0,1,137,0,39,1,38,39,176,71,7,1,22,0,0,1,22,78,22,0,22
13,Georgia/GA,1301600,"Middle Georgia Regional Commission (North & Outside Bibb County) PUMA, Georgia/GA",13207,"Monroe County, Georgia",27010,676,50,2503,185,0.153,120,0,36,11,0,1,131,0,37,1,36,37,168,71,7,1,21,0,0,1,21,78,22,0,22
13,Georgia/GA,1301600,"Middle Georgia Regional Commission (North & Outside Bibb County) PUMA, Georgia/GA",13225,"Peach County, Georgia",26966,665,24,2466,89,0.149,117,0,35,11,0,1,128,0,36,1,35,36,164,71,7,1,21,0,0,1,21,78,22,0,22
13,Georgia/GA,1301600,"Middle Georgia Regional Commission (North & Outside Bibb County) PUMA, Georgia/GA",13237,"Putnam County, Georgia",21503,683,24,3176,112,0.12,94,0,28,9,0,1,103,0,29,1,28,29,132,71,7,1,21,0,0,1,21,78,22,0,22
13,Georgia/GA,1301600,"Middle Georgia Regional Commission (North & Outside Bibb County) PUMA, Georgia/GA",13289,"Twiggs County, Georgia",8284,187,7,2257,85,0.046,36,0,11,3,0,0,39,0,11,0,11,11,50,72,6,0,22,0,0,0,22,78,22,0,22
13,Georgia/GA,1301600,"Middle Georgia Regional Commission (North & Outside Bibb County) PUMA, Georgia/GA",13319,"Wilkinson County, Georgia",9078,336,18,3701,198,0.051,40,0,12,4,0,0,44,0,12,0,12,12,56,71,7,0,21,0,0,0,21,79,21,0,21
13,Georgia/GA,1301700,"River Valley Regional Commission (West Central)--Muscogee & Chattahoochee Counties PUMA, Georgia/GA",13053,"Chattahoochee County, Georgia",10767,1632,1,15157,9,0.052,67,1,0,2,0,2,69,1,2,2,1,3,72,93,3,3,1,0,1,3,0,96,4,1,3
13,Georgia/GA,1301700,"River Valley Regional Commission (West Central)--Muscogee & Chattahoochee Counties PUMA, Georgia/GA",13215,"Muscogee County, Georgia",196670,5973,168,3037,85,0.948,1231,12,0,33,0,43,1264,12,43,43,12,55,1319,93,3,3,1,0,1,3,0,96,4,1,3
13,Georgia/GA,1301800,"River Valley Regional Commission (Outside Muscogee & Chattahoochee Counties) PUMA, Georgia/GA",13061,"Clay County, Georgia",3001,120,2,3999,67,0.019,50,1,4,3,0,1,53,1,5,1,5,6,59,85,5,2,8,0,2,2,7,90,10,2,8
13,Georgia/GA,1301800,"River Valley Regional Commission (Outside Muscogee & Chattahoochee Counties) PUMA, Georgia/GA",13081,"Crisp County, Georgia",22846,545,17,2386,74,0.14,367,6,28,19,0,4,386,6,32,4,34,38,424,87,4,1,8,0,1,1,7,91,9,1,8
13,Georgia/GA,1301800,"River Valley Regional Commission (Outside Muscogee & Chattahoochee Counties) PUMA, Georgia/GA",13093,"Dooly County, Georgia",13905,338,14,2431,101,0.085,223,4,17,11,0,3,234,4,20,3,21,24,258,86,4,1,8,0,2,1,7,91,9,2,8
13,Georgia/GA,1301800,"River Valley Regional Commission (Outside Muscogee & Chattahoochee Counties) PUMA, Georgia/GA",13145,"Harris County, Georgia",33590,786,21,2340,63,0.207,542,9,42,28,0,7,570,9,49,7,51,58,628,86,4,1,8,0,1,1,7,91,9,1,8
13,Georgia/GA,1301800,"River Valley Regional Commission (Outside Muscogee & Chattahoochee Counties) PUMA, Georgia/GA",13193,"Macon County, Georgia",13480,229,10,1699,74,0.083,217,4,17,11,0,3,228,4,20,3,21,24,252,86,4,1,8,0,2,1,7,90,10,2,8
13,Georgia/GA,1301800,"River Valley Regional Commission (Outside Muscogee & Chattahoochee Counties) PUMA, Georgia/GA",13197,"Marion County, Georgia",8484,190,8,2240,94,0.052,136,2,11,7,0,2,143,2,13,2,13,15,158,86,4,1,8,0,1,1,7,91,9,1,8
13,Georgia/GA,1301800,"River Valley Regional Commission (Outside Muscogee & Chattahoochee Counties) PUMA, Georgia/GA",13239,"Quitman County, Georgia",2276,32,1,1406,44,0.014,37,1,3,2,0,0,39,1,3,0,4,4,43,86,5,0,9,0,2,0,7,91,9,2,7
13,Georgia/GA,1301800,"River Valley Regional Commission (Outside Muscogee & Chattahoochee Counties) PUMA, Georgia/GA",13243,"Randolph County, Georgia",7087,331,29,4671,409,0.044,115,2,9,6,0,1,121,2,10,1,11,12,133,86,5,1,8,0,2,1,7,91,9,2,8
13,Georgia/GA,1301800,"River Valley Regional Commission (Outside Muscogee & Chattahoochee Counties) PUMA, Georgia/GA",13249,"Schley County, Georgia",5211,105,2,2015,38,0.031,81,1,6,4,0,1,85,1,7,1,7,8,93,87,4,1,8,0,1,1,6,91,9,1,8
13,Georgia/GA,1301800,"River Valley Regional Commission (Outside Muscogee & Chattahoochee Counties) PUMA, Georgia/GA",13259,"Stewart County, Georgia",6042,520,14,8606,232,0.035,92,2,7,5,0,1,97,2,8,1,9,10,107,86,5,1,8,0,2,1,7,91,9,2,7
13,Georgia/GA,1301800,"River Valley Regional Commission (Outside Muscogee & Chattahoochee Counties) PUMA, Georgia/GA",13261,"Sumter County, Georgia",30352,928,62,3057,204,0.187,490,8,38,25,0,6,515,8,44,6,46,52,567,86,4,1,8,0,1,1,7,91,9,1,8
13,Georgia/GA,1301800,"River Valley Regional Commission (Outside Muscogee & Chattahoochee Counties) PUMA, Georgia/GA",13263,"Talbot County, Georgia",6378,166,5,2603,78,0.038,99,2,8,5,0,1,104,2,9,1,10,11,115,86,4,1,9,0,2,1,7,90,10,2,8
13,Georgia/GA,1301800,"River Valley Regional Commission (Outside Muscogee & Chattahoochee Counties) PUMA, Georgia/GA",13269,"Taylor County, Georgia",8193,208,10,2539,122,0.051,134,2,10,7,0,2,141,2,12,2,12,14,155,86,5,1,8,0,1,1,6,91,9,1,8
13,Georgia/GA,1301800,"River Valley Regional Commission (Outside Muscogee & Chattahoochee Counties) PUMA, Georgia/GA",13307,"Webster County, Georgia",2613,44,2,1684,77,0.016,42,1,3,2,0,1,44,1,4,1,4,5,49,86,4,2,8,0,2,2,6,90,10,2,8
13,Georgia/GA,1301900,"Three Rivers Regional Commission (East) PUMA, Georgia/GA",13035,"Butts County, Georgia",23750,642,42,2703,177,0.157,43,0,1,1,0,0,44,0,1,0,1,1,45,96,2,0,2,0,0,0,2,98,2,0,2
13,Georgia/GA,1301900,"Three Rivers Regional Commission (East) PUMA, Georgia/GA",13171,"Lamar County, Georgia",18513,362,18,1955,97,0.122,34,0,1,1,0,0,35,0,1,0,1,1,36,94,3,0,3,0,0,0,3,97,3,0,3
13,Georgia/GA,1301900,"Three Rivers Regional Commission (East) PUMA, Georgia/GA",13231,"Pike County, Georgia",18082,323,10,1786,55,0.119,33,0,1,1,0,0,34,0,1,0,1,1,35,94,3,0,3,0,0,0,3,97,3,0,3
13,Georgia/GA,1301900,"Three Rivers Regional Commission (East) PUMA, Georgia/GA",13255,"Spalding County, Georgia",64719,1327,61,2050,94,0.428,119,0,2,3,0,0,122,0,2,0,2,2,124,96,2,0,2,0,0,0,2,98,2,0,2
13,Georgia/GA,1301900,"Three Rivers Regional Commission (East) PUMA, Georgia/GA",13293,"Upson County, Georgia",26216,783,62,2987,236,0.174,48,0,1,1,0,0,49,0,1,0,1,1,50,96,2,0,2,0,0,0,2,98,2,0,2
13,Georgia/GA,1302001,"Atlanta Regional Commission (Central)--DeKalb County (East Central)--Redan PUMA, Georgia/GA",13089,"DeKalb County, Georgia",743187,18521,358,2492,48,1,493,31,12,0,60,61,493,91,73,121,43,164,657,75,0,18,7,9,5,9,2,75,25,14,11
13,Georgia/GA,1302002,"Atlanta Regional Commission--DeKalb County--Decatur & Avondale Estates Cities PUMA, Georgia/GA",13089,"DeKalb County, Georgia",743187,18521,358,2492,48,1,347,0,2,11,0,66,358,0,68,66,2,68,426,81,3,15,0,0,0,15,0,84,16,0,16
13,Georgia/GA,1302003,"Atlanta Regional Commission (Central)--DeKalb County (Northeast)--Tucker PUMA, Georgia/GA",13089,"DeKalb County, Georgia",743187,18521,358,2492,48,1,304,23,59,20,97,2061,324,120,2120,2158,82,2240,2564,12,1,84,3,4,1,80,2,13,87,5,83
13,Georgia/GA,1302004,"Atlanta Regional Commission--DeKalb County (North)--Dunwoody City PUMA, Georgia/GA",13089,"DeKalb County, Georgia",743187,18521,358,2492,48,1,11,33,53,0,39,33,11,72,86,72,86,158,169,7,0,43,51,23,20,20,31,7,93,43,51
13,Georgia/GA,1302100,"Three Rivers Regional Commission (North Central)--Coweta County PUMA, Georgia/GA",13077,"Coweta County, Georgia",140516,2578,44,1835,31,1,95,0,62,0,0,21,95,0,83,21,62,83,178,53,0,12,35,0,0,12,35,53,47,0,47
13,Georgia/GA,1302200,"Three Rivers Regional Commission (Southwest)--Troup, Meriwether & Heard Counties PUMA, Georgia/GA",13149,"Heard County, Georgia",11677,192,5,1644,43,0.112,26,0,10,0,1,2,26,1,12,3,10,13,39,67,0,8,26,3,0,5,26,67,33,3,31
13,Georgia/GA,1302200,"Three Rivers Regional Commission (Southwest)--Troup, Meriwether & Heard Counties PUMA, Georgia/GA",13199,"Meriwether County, Georgia",21113,544,13,2577,62,0.205,48,0,18,0,2,4,48,2,22,6,18,24,72,67,0,8,25,3,0,6,25,67,33,3,31
13,Georgia/GA,1302200,"Three Rivers Regional Commission (Southwest)--Troup, Meriwether & Heard Counties PUMA, Georgia/GA",13285,"Troup County, Georgia",69774,2796,96,4007,138,0.683,160,0,60,0,5,12,160,5,72,17,60,77,237,68,0,7,25,2,0,5,25,68,32,2,30
13,Georgia/GA,1302300,"Three Rivers Regional Commission (Northwest)--Carroll County PUMA, Georgia/GA",13045,"Carroll County, Georgia",116022,2734,66,2356,57,1,1044,0,68,0,0,0,1044,0,68,0,68,68,1112,94,0,0,6,0,0,0,6,94,6,0,6
13,Georgia/GA,1302400,"Atlanta Regional Commission (South Central)--Fayette County PUMA, Georgia/GA",13113,"Fayette County, Georgia",111369,1808,49,1623,44,1,62,0,0,0,0,0,62,0,0,0,0,0,62,100,0,0,0,0,0,0,0,100,0,0,0
13,Georgia/GA,1302500,"Northwest Georgia Regional Commission (Southwest)--Floyd, Polk & Haralson Counties PUMA, Georgia/GA",13115,"Floyd County, Georgia",96824,3129,45,3232,46,0.577,350,0,109,41,11,0,391,11,109,11,109,120,511,68,8,2,21,2,0,0,21,77,23,2,21
13,Georgia/GA,1302500,"Northwest Georgia Regional Commission (Southwest)--Floyd, Polk & Haralson Counties PUMA, Georgia/GA",13143,"Haralson County, Georgia",28956,460,8,1589,28,0.174,106,0,33,12,3,0,118,3,33,3,33,36,154,69,8,2,21,2,0,0,21,77,23,2,21
13,Georgia/GA,1302500,"Northwest Georgia Regional Commission (Southwest)--Floyd, Polk & Haralson Counties PUMA, Georgia/GA",13233,"Polk County, Georgia",41621,1468,17,3527,41,0.25,152,0,47,18,5,0,170,5,47,5,47,52,222,68,8,2,21,2,0,0,21,77,23,2,21
13,Georgia/GA,1302600,"Northwest Georgia Regional Commission--Walker, Catoosa, Chattooga & Dade Counties PUMA, Georgia/GA",13047,"Catoosa County, Georgia",66299,1171,18,1766,27,0.379,278,0,9,0,0,5,278,0,14,5,9,14,292,95,0,2,3,0,0,2,3,95,5,0,5
13,Georgia/GA,1302600,"Northwest Georgia Regional Commission--Walker, Catoosa, Chattooga & Dade Counties PUMA, Georgia/GA",13055,"Chattooga County, Georgia",24817,757,18,3050,73,0.142,104,0,3,0,0,2,104,0,5,2,3,5,109,95,0,2,3,0,0,2,3,95,5,0,5
13,Georgia/GA,1302600,"Northwest Georgia Regional Commission--Walker, Catoosa, Chattooga & Dade Counties PUMA, Georgia/GA",13083,"Dade County, Georgia",16227,282,5,1738,31,0.093,68,0,2,0,0,1,68,0,3,1,2,3,71,96,0,1,3,0,0,1,3,96,4,0,4
13,Georgia/GA,1302600,"Northwest Georgia Regional Commission--Walker, Catoosa, Chattooga & Dade Counties PUMA, Georgia/GA",13295,"Walker County, Georgia",68824,1521,33,2210,48,0.387,284,0,9,0,0,5,284,0,14,5,9,14,298,95,0,2,3,0,0,2,3,95,5,0,5
13,Georgia/GA,1302700,"Northwest Georgia Regional Commission (North Central)--Whitfield County PUMA, Georgia/GA",13313,"Whitfield County, Georgia",103849,4530,61,4362,59,1,58,26,200,0,0,0,58,26,200,0,226,226,284,20,0,0,80,0,9,0,70,20,80,9,70
13,Georgia/GA,1302800,"Northwest Georgia Regional Commission (Northeast) PUMA, Georgia/GA",13111,"Fannin County, Georgia",24925,641,21,2572,84,0.137,147,28,38,4,0,3,151,28,41,3,66,69,220,67,2,1,30,0,13,1,17,69,31,13,19
13,Georgia/GA,1302800,"Northwest Georgia Regional Commission (Northeast) PUMA, Georgia/GA",13123,"Gilmer County, Georgia",29922,810,12,2707,40,0.164,176,33,46,4,0,4,180,33,50,4,79,83,263,67,2,2,30,0,13,2,17,68,32,13,19
13,Georgia/GA,1302800,"Northwest Georgia Regional Commission (Northeast) PUMA, Georgia/GA",13129,"Gordon County, Georgia",56790,1841,36,3242,63,0.313,336,63,88,8,0,7,344,63,95,7,151,158,502,67,2,1,30,0,13,1,18,69,31,13,19
13,Georgia/GA,1302800,"Northwest Georgia Regional Commission (Northeast) PUMA, Georgia/GA",13213,"Murray County, Georgia",39557,818,6,2068,15,0.216,232,44,61,6,0,5,238,44,66,5,105,110,348,67,2,1,30,0,13,1,18,68,32,13,19
13,Georgia/GA,1302800,"Northwest Georgia Regional Commission (Northeast) PUMA, Georgia/GA",13227,"Pickens County, Georgia",30832,615,10,1995,32,0.17,183,34,48,4,0,4,187,34,52,4,82,86,273,67,1,1,30,0,12,1,18,68,32,12,19
13,Georgia/GA,1302900,"Northwest Georgia Regional Commission (East Central)--Bartow County PUMA, Georgia/GA",13015,"Bartow County, Georgia",103620,2888,84,2787,81,1,307,0,18,51,0,0,358,0,18,0,18,18,376,82,14,0,5,0,0,0,5,95,5,0,5
13,Georgia/GA,1303001,"Atlanta Regional Commission (Northwest)--Cobb County (Central)--Marietta City PUMA, Georgia/GA",13067,"Cobb County, Georgia",745057,19430,425,2608,57,1,155,0,174,36,0,41,191,0,215,41,174,215,406,38,9,10,43,0,0,10,43,47,53,0,53
13,Georgia/GA,1303002,"Atlanta Regional Commission--Cobb County (Northwest)--Kennesaw & Acworth Cities PUMA, Georgia/GA",13067,"Cobb County, Georgia",745057,19430,425,2608,57,1,164,0,38,13,0,23,177,0,61,23,38,61,238,69,5,10,16,0,0,10,16,74,26,0,26
13,Georgia/GA,1303003,"Atlanta Regional Commission (Northwest)--Cobb County (Southwest)--Powder Springs City PUMA, Georgia/GA",13067,"Cobb County, Georgia",745057,19430,425,2608,57,1,66,0,0,22,23,0,88,23,0,23,0,23,111,59,20,21,0,21,0,0,0,79,21,21,0
13,Georgia/GA,1303004,"Atlanta Regional Commission (Northwest)--Cobb County (Southeast)--Smyrna City PUMA, Georgia/GA",13067,"Cobb County, Georgia",745057,19430,425,2608,57,1,94,34,65,72,54,21,166,88,86,75,99,174,340,28,21,22,29,16,10,6,19,49,51,26,25
13,Georgia/GA,1303005,"Atlanta Regional Commission (Northwest)--Cobb County (Northeast) PUMA, Georgia/GA",13067,"Cobb County, Georgia",745057,19430,425,2608,57,1,43,0,0,17,0,0,60,0,0,0,0,0,60,72,28,0,0,0,0,0,0,100,0,0,0
13,Georgia/GA,1303101,"Atlanta Regional Commission--Cherokee County (Central)--Woodstock & Canton Cities PUMA, Georgia/GA",13057,"Cherokee County, Georgia",241910,5959,92,2463,38,1,17,89,200,120,0,11,137,89,211,11,289,300,437,4,27,3,66,0,20,3,46,31,69,20,48
13,Georgia/GA,1303102,"Atlanta Regional Commission--Cherokee County (Outside Woodstock & Canton Cities) PUMA, Georgia/GA",13057,"Cherokee County, Georgia",241910,5959,92,2463,38,1,97,0,0,65,0,0,162,0,0,0,0,0,162,60,40,0,0,0,0,0,0,100,0,0,0
13,Georgia/GA,1303200,"Georgia Mountains Regional Commission (North & Northwest) PUMA, Georgia/GA",13085,"Dawson County, Georgia",23861,810,7,3395,29,0.175,122,0,38,0,0,0,122,0,38,0,38,38,160,76,0,0,24,0,0,0,24,76,24,0,24
13,Georgia/GA,1303200,"Georgia Mountains Regional Commission (North & Northwest) PUMA, Georgia/GA",13187,"Lumpkin County, Georgia",31951,905,14,2832,44,0.233,163,0,50,0,0,0,163,0,50,0,50,50,213,77,0,0,23,0,0,0,23,77,23,0,23
13,Georgia/GA,1303200,"Georgia Mountains Regional Commission (North & Northwest) PUMA, Georgia/GA",13241,"Rabun County, Georgia",16457,335,9,2036,55,0.123,86,0,27,0,0,0,86,0,27,0,27,27,113,76,0,0,24,0,0,0,24,76,24,0,24
13,Georgia/GA,1303200,"Georgia Mountains Regional Commission (North & Northwest) PUMA, Georgia/GA",13281,"Towns County, Georgia",11417,322,9,2820,79,0.084,59,0,18,0,0,0,59,0,18,0,18,18,77,77,0,0,23,0,0,0,23,77,23,0,23
13,Georgia/GA,1303200,"Georgia Mountains Regional Commission (North & Northwest) PUMA, Georgia/GA",13291,"Union County, Georgia",22775,737,20,3236,88,0.17,119,0,37,0,0,0,119,0,37,0,37,37,156,76,0,0,24,0,0,0,24,76,24,0,24
13,Georgia/GA,1303200,"Georgia Mountains Regional Commission (North & Northwest) PUMA, Georgia/GA",13311,"White County, Georgia",28928,828,19,2862,66,0.214,149,0,46,0,0,0,149,0,46,0,46,46,195,76,0,0,24,0,0,0,24,76,24,0,24
13,Georgia/GA,1303300,"Georgia Mountains Regional Commission (Southwest)--Forsyth County PUMA, Georgia/GA",13117,"Forsyth County, Georgia",219880,3926,45,1786,20,1,241,20,273,12,0,8,253,20,281,8,293,301,554,44,2,1,53,0,4,1,49,46,54,4,51
13,Georgia/GA,1303400,"Georgia Mountains Regional Commission (South Central)--Hall County PUMA, Georgia/GA",13139,"Hall County, Georgia",195961,9147,151,4668,77,1,1101,342,4193,305,126,211,1406,468,4404,337,4535,4872,6278,18,5,5,72,2,5,3,67,22,78,7,70
13,Georgia/GA,1303500,"Georgia Mountains Regional Commission (Southeast) PUMA, Georgia/GA",13011,"Banks County, Georgia",18510,478,7,2582,38,0.135,135,7,90,6,0,1,141,7,91,1,97,98,239,56,3,0,41,0,3,0,38,59,41,3,38
13,Georgia/GA,1303500,"Georgia Mountains Regional Commission (Southeast) PUMA, Georgia/GA",13119,"Franklin County, Georgia",22514,747,12,3318,53,0.164,164,8,109,7,0,1,171,8,110,1,117,118,289,57,2,0,40,0,3,0,38,59,41,3,38
13,Georgia/GA,1303500,"Georgia Mountains Regional Commission (Southeast) PUMA, Georgia/GA",13137,"Habersham County, Georgia",44289,1633,67,3687,151,0.325,324,16,217,14,0,2,338,16,219,2,233,235,573,57,2,0,41,0,3,0,38,59,41,3,38
13,Georgia/GA,1303500,"Georgia Mountains Regional Commission (Southeast) PUMA, Georgia/GA",13147,"Hart County, Georgia",25631,505,13,1970,51,0.188,188,9,125,8,0,1,196,9,126,1,134,135,331,57,2,0,40,0,3,0,38,59,41,3,38
13,Georgia/GA,1303500,"Georgia Mountains Regional Commission (Southeast) PUMA, Georgia/GA",13257,"Stephens County, Georgia",25676,1050,38,4089,148,0.189,189,9,126,8,0,1,197,9,127,1,135,136,333,57,2,0,41,0,3,0,38,59,41,3,38
13,Georgia/GA,1303600,"Northeast Georgia Regional Commission (Central)--Clarke County--Athens City PUMA, Georgia/GA",13059,"Clarke County, Georgia",124602,4997,43,4010,35,1,772,150,71,88,0,28,860,150,99,28,221,249,1109,70,8,3,20,0,14,3,6,78,22,14,9
13,Georgia/GA,1303700,"Northeast Georgia Regional Commission (East) PUMA, Georgia/GA",13105,"Elbert County, Georgia",19212,644,3,3352,16,0.164,137,3,5,18,0,2,155,3,7,2,8,10,165,83,11,1,5,0,2,1,3,94,6,2,4
13,Georgia/GA,1303700,"Northeast Georgia Regional Commission (East) PUMA, Georgia/GA",13133,"Greene County, Georgia",16976,499,23,2939,135,0.146,122,3,4,16,0,2,138,3,6,2,7,9,147,83,11,1,5,0,2,1,3,94,6,2,4
13,Georgia/GA,1303700,"Northeast Georgia Regional Commission (East) PUMA, Georgia/GA",13195,"Madison County, Georgia",28900,687,8,2377,28,0.247,207,5,7,27,0,3,234,5,10,3,12,15,249,83,11,1,5,0,2,1,3,94,6,2,4
13,Georgia/GA,1303700,"Northeast Georgia Regional Commission (East) PUMA, Georgia/GA",13219,"Oconee County, Georgia",37017,736,26,1988,70,0.316,265,6,9,35,0,4,300,6,13,4,15,19,319,83,11,1,5,0,2,1,3,94,6,2,4
13,Georgia/GA,1303700,"Northeast Georgia Regional Commission (East) PUMA, Georgia/GA",13221,"Oglethorpe County, Georgia",14784,329,11,2225,74,0.128,107,3,4,14,0,2,121,3,6,2,7,9,130,82,11,2,5,0,2,2,3,93,7,2,5
13,Georgia/GA,1303800,"Northeast Georgia Regional Commission (Northwest)--Barrow & Jackson Counties PUMA, Georgia/GA",13013,"Barrow County, Georgia",76887,2158,46,2807,60,0.544,295,5,76,0,13,0,295,18,76,13,81,94,389,76,0,3,21,3,1,0,20,76,24,5,20
13,Georgia/GA,1303800,"Northeast Georgia Regional Commission (Northwest)--Barrow & Jackson Counties PUMA, Georgia/GA",13157,"Jackson County, Georgia",65755,1961,31,2982,47,0.456,248,4,63,0,11,0,248,15,63,11,67,78,326,76,0,3,21,3,1,0,19,76,24,5,19
13,Georgia/GA,1303900,"Northeast Georgia Regional Commission (Southwest)--Walton, Morgan & Jasper Counties PUMA, Georgia/GA",13159,"Jasper County, Georgia",13784,216,4,1567,29,0.112,54,0,8,0,0,0,54,0,8,0,8,8,62,87,0,0,13,0,0,0,13,87,13,0,13
13,Georgia/GA,1303900,"Northeast Georgia Regional Commission (Southwest)--Walton, Morgan & Jasper Counties PUMA, Georgia/GA",13211,"Morgan County, Georgia",18235,478,2,2621,11,0.149,72,0,11,0,0,0,72,0,11,0,11,11,83,87,0,0,13,0,0,0,13,87,13,0,13
13,Georgia/GA,1303900,"Northeast Georgia Regional Commission (Southwest)--Walton, Morgan & Jasper Counties PUMA, Georgia/GA",13297,"Walton County, Georgia",90132,1781,53,1976,59,0.739,358,0,53,0,0,0,358,0,53,0,53,53,411,87,0,0,13,0,0,0,13,87,13,0,13
13,Georgia/GA,1304000,"Central Savannah River Area Regional Commission (East Central)--Richmond County PUMA, Georgia/GA",13245,"Richmond County, Georgia",201463,7027,161,3488,80,1,881,0,4,31,69,0,912,69,4,69,4,73,985,89,3,7,0,7,0,0,0,93,7,7,0
13,Georgia/GA,1304001,"Atlanta Regional Commission (Northeast)--Gwinnett County (West Central)--Duluth City PUMA, Georgia/GA",13135,"Gwinnett County, Georgia",902298,27187,401,3013,44,1,87,21,87,87,12,8,174,33,95,20,108,128,302,29,29,7,36,4,7,3,29,58,42,11,31
13,Georgia/GA,1304002,"Atlanta Regional Commission (Northeast)--Gwinnett County (North)--Sugar Hill City PUMA, Georgia/GA",13135,"Gwinnett County, Georgia",902298,27187,401,3013,44,1,108,0,27,0,27,0,108,27,27,27,27,54,162,67,0,17,17,17,0,0,17,67,33,17,17
13,Georgia/GA,1304003,"Atlanta Regional Commission--Gwinnett County (Central)--Lawrenceville City PUMA, Georgia/GA",13135,"Gwinnett County, Georgia",902298,27187,401,3013,44,1,65,105,299,36,28,23,101,133,322,51,404,455,556,12,6,9,73,5,19,4,54,18,82,24,58
13,Georgia/GA,1304004,"Atlanta Regional Commission (Northeast)--Gwinnett County (East) PUMA, Georgia/GA",13135,"Gwinnett County, Georgia",902298,27187,401,3013,44,1,257,0,2,0,18,15,257,18,17,33,2,35,292,88,0,11,1,6,0,5,1,88,12,6,6
13,Georgia/GA,1304005,"Atlanta Regional Commission (Northeast)--Gwinnett County (South)--Snellville City PUMA, Georgia/GA",13135,"Gwinnett County, Georgia",902298,27187,401,3013,44,1,240,0,111,23,86,26,263,86,137,112,111,223,486,49,5,23,23,18,0,5,23,54,46,18,28
13,Georgia/GA,1304006,"Atlanta Regional Commission (Northeast)--Gwinnett County (Southwest)--Lilburn City PUMA, Georgia/GA",13135,"Gwinnett County, Georgia",902298,27187,401,3013,44,1,225,59,273,74,101,54,299,160,327,155,332,487,786,29,9,20,42,13,8,7,35,38,62,20,42
13,Georgia/GA,1304100,"Central Savannah River Area Regional Commission (East Central)--Columbia County PUMA, Georgia/GA",13073,"Columbia County, Georgia",147295,3704,59,2515,40,1,19,0,4,51,0,0,70,0,4,0,4,4,74,26,69,0,5,0,0,0,5,95,5,0,5
13,Georgia/GA,1304200,"Central Savannah River Area Regional Commission (West & Outside Richmond & Columbia) PUMA, Georgia/GA",13033,"Burke County, Georgia",22550,795,10,3525,44,0.18,211,0,79,3,0,0,214,0,79,0,79,79,293,72,1,0,27,0,0,0,27,73,27,0,27
13,Georgia/GA,1304200,"Central Savannah River Area Regional Commission (West & Outside Richmond & Columbia) PUMA, Georgia/GA",13125,"Glascock County, Georgia",3009,38,2,1263,66,0.024,28,0,11,0,0,0,28,0,11,0,11,11,39,72,0,0,28,0,0,0,28,72,28,0,28
13,Georgia/GA,1304200,"Central Savannah River Area Regional Commission (West & Outside Richmond & Columbia) PUMA, Georgia/GA",13141,"Hancock County, Georgia",8535,387,42,4534,492,0.069,81,0,30,1,0,0,82,0,30,0,30,30,112,72,1,0,27,0,0,0,27,73,27,0,27
13,Georgia/GA,1304200,"Central Savannah River Area Regional Commission (West & Outside Richmond & Columbia) PUMA, Georgia/GA",13163,"Jefferson County, Georgia",15772,787,26,4990,165,0.127,149,0,56,2,0,0,151,0,56,0,56,56,207,72,1,0,27,0,0,0,27,73,27,0,27
13,Georgia/GA,1304200,"Central Savannah River Area Regional Commission (West & Outside Richmond & Columbia) PUMA, Georgia/GA",13165,"Jenkins County, Georgia",8827,412,29,4667,329,0.07,82,0,31,1,0,0,83,0,31,0,31,31,114,72,1,0,27,0,0,0,27,73,27,0,27
13,Georgia/GA,1304200,"Central Savannah River Area Regional Commission (West & Outside Richmond & Columbia) PUMA, Georgia/GA",13181,"Lincoln County, Georgia",7799,213,7,2731,90,0.062,73,0,27,1,0,0,74,0,27,0,27,27,101,72,1,0,27,0,0,0,27,73,27,0,27
13,Georgia/GA,1304200,"Central Savannah River Area Regional Commission (West & Outside Richmond & Columbia) PUMA, Georgia/GA",13189,"McDuffie County, Georgia",21498,595,14,2768,65,0.171,200,0,75,2,0,0,202,0,75,0,75,75,277,72,1,0,27,0,0,0,27,73,27,0,27
13,Georgia/GA,1304200,"Central Savannah River Area Regional Commission (West & Outside Richmond & Columbia) PUMA, Georgia/GA",13265,"Taliaferro County, Georgia",1665,22,0,1321,0,0.013,15,0,6,0,0,0,15,0,6,0,6,6,21,71,0,0,29,0,0,0,29,71,29,0,29
13,Georgia/GA,1304200,"Central Savannah River Area Regional Commission (West & Outside Richmond & Columbia) PUMA, Georgia/GA",13301,"Warren County, Georgia",5346,142,5,2656,94,0.043,50,0,19,1,0,0,51,0,19,0,19,19,70,71,1,0,27,0,0,0,27,73,27,0,27
13,Georgia/GA,1304200,"Central Savannah River Area Regional Commission (West & Outside Richmond & Columbia) PUMA, Georgia/GA",13303,"Washington County, Georgia",20461,666,8,3255,39,0.163,191,0,71,2,0,0,193,0,71,0,71,71,264,72,1,0,27,0,0,0,27,73,27,0,27
13,Georgia/GA,1304200,"Central Savannah River Area Regional Commission (West & Outside Richmond & Columbia) PUMA, Georgia/GA",13317,"Wilkes County, Georgia",9884,264,5,2671,51,0.078,91,0,34,1,0,0,92,0,34,0,34,34,126,72,1,0,27,0,0,0,27,73,27,0,27
13,Georgia/GA,1304300,"Atlanta & Northeast Georgia Regional Commissions--Newton & Rockdale Counties PUMA, Georgia/GA",13217,"Newton County, Georgia",106497,2575,86,2418,81,0.545,284,0,10,8,4,7,292,4,17,11,10,21,313,91,3,4,3,1,0,2,3,93,7,1,5
13,Georgia/GA,1304300,"Atlanta & Northeast Georgia Regional Commissions--Newton & Rockdale Counties PUMA, Georgia/GA",13247,"Rockdale County, Georgia",89011,1842,36,2069,40,0.455,238,0,9,6,4,6,244,4,15,10,9,19,263,90,2,4,3,2,0,2,3,93,7,2,6
13,Georgia/GA,1304400,"Atlanta Regional Commission (Southwest)--Douglas County PUMA, Georgia/GA",13097,"Douglas County, Georgia",141840,3520,71,2482,50,1,256,100,30,0,95,86,256,195,116,181,130,311,567,45,0,32,23,17,18,15,5,45,55,34,20
13,Georgia/GA,1304500,"Northwest Georgia Regional Commission (Southeast)--Paulding County PUMA, Georgia/GA",13223,"Paulding County, Georgia",155840,2760,53,1771,34,1,238,0,0,0,0,17,238,0,17,17,0,17,255,93,0,7,0,0,0,7,0,93,7,0,7
13,Georgia/GA,1304600,"Atlanta Regional Commission--Fulton County (Central)--Atlanta City (Central) PUMA, Georgia/GA",13121,"Fulton County, Georgia",1021902,27389,571,2680,56,1,458,0,0,14,0,0,472,0,0,0,0,0,472,97,3,0,0,0,0,0,0,100,0,0,0
13,Georgia/GA,1305001,"Atlanta Regional Commission (South Central)--Clayton County (South) PUMA, Georgia/GA",13063,"Clayton County, Georgia",278666,7061,161,2534,58,1,370,0,47,0,14,0,370,14,47,14,47,61,431,86,0,3,11,3,0,0,11,86,14,3,11
13,Georgia/GA,1305002,"Atlanta Regional Commission (South Central)--Clayton County (North)--Forest Park City PUMA, Georgia/GA",13063,"Clayton County, Georgia",278666,7061,161,2534,58,1,289,79,116,2,104,37,291,183,153,141,195,336,627,46,0,22,31,17,13,6,19,46,54,29,24
13,Georgia/GA,1306001,"Atlanta Regional Commission (Southeast)--Henry County (South)--McDonough City PUMA, Georgia/GA",13151,"Henry County, Georgia",221307,5156,100,2330,45,1,280,0,18,87,58,0,367,58,18,58,18,76,443,63,20,13,4,13,0,0,4,83,17,13,4
13,Georgia/GA,1306002,"Atlanta Regional Commission (Southeast)--Henry County (North)--Stockbridge City PUMA, Georgia/GA",13151,"Henry County, Georgia",221307,5156,100,2330,45,1,283,0,0,0,51,0,283,51,0,51,0,51,334,85,0,15,0,15,0,0,0,85,15,15,0
15,Hawaii/HI,1500100,"Maui, Kalawao & Kauai Counties PUMA, Hawaii/HI",15007,"Kauai County, Hawaii",71377,58,0,81,0,0.303,166,0,8,21,70,128,187,70,136,198,8,206,393,42,5,50,2,18,0,33,2,48,52,18,35
15,Hawaii/HI,1500100,"Maui, Kalawao & Kauai Counties PUMA, Hawaii/HI",15009,"Maui County, Hawaii",165281,490,9,296,5,0.696,381,0,17,49,161,293,430,161,310,454,17,471,901,42,5,50,2,18,0,33,2,48,52,18,34
15,Hawaii/HI,1500100,"Maui, Kalawao & Kauai Counties PUMA, Hawaii/HI",15005,"Kalawao County, Hawaii",75,NA,NA,NA,NA,0,0,0,0,0,0,0,0,0,0,0,0,0,0,NaN,NaN,NaN,NaN,NaN,NaN,NaN,NaN,NaN,NaN,NaN,NaN
15,Hawaii/HI,1500200,"Hawaii County PUMA, Hawaii/HI",15001,"Hawaii County, Hawaii",197658,700,15,354,8,1,1226,98,138,93,229,423,1319,327,561,652,236,888,2207,56,4,30,11,10,4,19,6,60,40,15,25
15,Hawaii/HI,1500301,"Honolulu County--Rural Oahu PUMA, Hawaii/HI",15003,"Honolulu County, Hawaii",987638,10791,102,1093,10,1,271,0,12,18,11,28,289,11,40,39,12,51,340,80,5,11,4,3,0,8,4,85,15,3,12
15,Hawaii/HI,1500302,"Honolulu County--Koolaupoko PUMA, Hawaii/HI",15003,"Honolulu County, Hawaii",987638,10791,102,1093,10,1,176,0,0,21,42,18,197,42,18,60,0,60,257,68,8,23,0,16,0,7,0,77,23,16,7
15,Hawaii/HI,1500303,"Honolulu County--East Honolulu to Kapahulu PUMA, Hawaii/HI",15003,"Honolulu County, Hawaii",987638,10791,102,1093,10,1,68,0,0,0,13,0,68,13,0,13,0,13,81,84,0,16,0,16,0,0,0,84,16,16,0
15,Hawaii/HI,1500304,"Honolulu County--Tantalus to Waikiki PUMA, Hawaii/HI",15003,"Honolulu County, Hawaii",987638,10791,102,1093,10,1,128,0,0,0,14,38,128,14,38,52,0,52,180,71,0,29,0,8,0,21,0,71,29,8,21
15,Hawaii/HI,1500305,"Honolulu County--Nuuanu to Kalihi PUMA, Hawaii/HI",15003,"Honolulu County, Hawaii",987638,10791,102,1093,10,1,70,0,0,45,123,296,115,123,296,419,0,419,534,13,8,78,0,23,0,55,0,22,78,23,55
15,Hawaii/HI,1500306,"Honolulu County--Moanalua to Pearl City PUMA, Hawaii/HI",15003,"Honolulu County, Hawaii",987638,10791,102,1093,10,1,106,0,0,0,117,126,106,117,126,243,0,243,349,30,0,70,0,34,0,36,0,30,70,34,36
15,Hawaii/HI,1500307,"Honolulu County--Central Oahu PUMA, Hawaii/HI",15003,"Honolulu County, Hawaii",987638,10791,102,1093,10,1,178,0,0,0,172,155,178,172,155,327,0,327,505,35,0,65,0,34,0,31,0,35,65,34,31
15,Hawaii/HI,1500308,"Honolulu County--Ewa PUMA, Hawaii/HI",15003,"Honolulu County, Hawaii",987638,10791,102,1093,10,1,127,0,0,0,186,226,127,186,226,412,0,412,539,24,0,76,0,35,0,42,0,24,76,35,42
16,Idaho/ID,1600100,"Bonner, Latah, Shoshone, Boundary, Benewah & Kootenai (Southeast) Counties PUMA, Idaho/ID",16009,"Benewah County, Idaho",9086,141,3,1552,33,0.076,60,1,0,6,0,0,66,1,0,0,1,1,67,90,9,0,1,0,1,0,0,99,1,1,0
16,Idaho/ID,1600100,"Bonner, Latah, Shoshone, Boundary, Benewah & Kootenai (Southeast) Counties PUMA, Idaho/ID",16017,"Bonner County, Idaho",42711,322,0,754,0,0.353,278,7,0,28,0,0,306,7,0,0,7,7,313,89,9,0,2,0,2,0,0,98,2,2,0
16,Idaho/ID,1600100,"Bonner, Latah, Shoshone, Boundary, Benewah & Kootenai (Southeast) Counties PUMA, Idaho/ID",16021,"Boundary County, Idaho",11549,56,1,485,9,0.097,76,2,0,8,0,0,84,2,0,0,2,2,86,88,9,0,2,0,2,0,0,98,2,2,0
16,Idaho/ID,1600100,"Bonner, Latah, Shoshone, Boundary, Benewah & Kootenai (Southeast) Counties PUMA, Idaho/ID",16055,"Kootenai County, Idaho",153605,2621,34,1706,22,0.045,35,1,0,4,0,0,39,1,0,0,1,1,40,88,10,0,2,0,2,0,0,98,2,2,0
16,Idaho/ID,1600100,"Bonner, Latah, Shoshone, Boundary, Benewah & Kootenai (Southeast) Counties PUMA, Idaho/ID",16057,"Latah County, Idaho",39239,410,0,1045,0,0.326,257,6,0,25,0,0,282,6,0,0,6,6,288,89,9,0,2,0,2,0,0,98,2,2,0
16,Idaho/ID,1600100,"Bonner, Latah, Shoshone, Boundary, Benewah & Kootenai (Southeast) Counties PUMA, Idaho/ID",16079,"Shoshone County, Idaho",12526,213,18,1700,144,0.103,81,2,0,8,0,0,89,2,0,0,2,2,91,89,9,0,2,0,2,0,0,98,2,2,0
16,Idaho/ID,1600200,"Kootenai County (Northwest)--Coeur d'Alene, Post Falls & Hayden Cities PUMA, Idaho/ID",16055,"Kootenai County, Idaho",153605,2621,34,1706,22,1,539,0,5,42,0,0,581,0,5,0,5,5,586,92,7,0,1,0,0,0,1,99,1,0,1
16,Idaho/ID,1600300,"Central Idaho--Lewiston City & Nez Perce Reservation PUMA, Idaho/ID",16003,"Adams County, Idaho",4019,28,2,697,50,0.037,28,0,4,4,0,1,32,0,5,1,4,5,37,76,11,3,11,0,0,3,11,86,14,0,14
16,Idaho/ID,1600300,"Central Idaho--Lewiston City & Nez Perce Reservation PUMA, Idaho/ID",16015,"Boise County, Idaho",7163,68,1,949,14,0.067,51,0,7,8,0,1,59,0,8,1,7,8,67,76,12,1,10,0,0,1,10,88,12,0,12
16,Idaho/ID,1600300,"Central Idaho--Lewiston City & Nez Perce Reservation PUMA, Idaho/ID",16023,"Butte County, Idaho",2602,31,0,1191,0,0.024,18,0,3,3,0,0,21,0,3,0,3,3,24,75,12,0,12,0,0,0,12,88,12,0,12
16,Idaho/ID,1600300,"Central Idaho--Lewiston City & Nez Perce Reservation PUMA, Idaho/ID",16033,"Clark County, Idaho",1077,32,0,2971,0,0.008,6,0,1,1,0,0,7,0,1,0,1,1,8,75,12,0,12,0,0,0,12,88,12,0,12
16,Idaho/ID,1600300,"Central Idaho--Lewiston City & Nez Perce Reservation PUMA, Idaho/ID",16035,"Clearwater County, Idaho",8640,44,0,509,0,0.08,61,0,9,10,0,2,71,0,11,2,9,11,82,74,12,2,11,0,0,2,11,87,13,0,13
16,Idaho/ID,1600300,"Central Idaho--Lewiston City & Nez Perce Reservation PUMA, Idaho/ID",16037,"Custer County, Idaho",4141,60,1,1449,24,0.039,30,0,4,5,0,1,35,0,5,1,4,5,40,75,12,2,10,0,0,2,10,88,12,0,12
16,Idaho/ID,1600300,"Central Idaho--Lewiston City & Nez Perce Reservation PUMA, Idaho/ID",16049,"Idaho County, Idaho",16337,197,0,1206,0,0.153,116,0,17,18,0,3,134,0,20,3,17,20,154,75,12,2,11,0,0,2,11,87,13,0,13
16,Idaho/ID,1600300,"Central Idaho--Lewiston City & Nez Perce Reservation PUMA, Idaho/ID",16059,"Lemhi County, Idaho",7798,91,0,1167,0,0.073,55,0,8,9,0,1,64,0,9,1,8,9,73,75,12,1,11,0,0,1,11,88,12,0,12
16,Idaho/ID,1600300,"Central Idaho--Lewiston City & Nez Perce Reservation PUMA, Idaho/ID",16061,"Lewis County, Idaho",3845,15,0,390,0,0.036,27,0,4,4,0,1,31,0,5,1,4,5,36,75,11,3,11,0,0,3,11,86,14,0,14
16,Idaho/ID,1600300,"Central Idaho--Lewiston City & Nez Perce Reservation PUMA, Idaho/ID",16069,"Nez Perce County, Idaho",40155,434,24,1081,60,0.382,290,1,42,46,0,7,336,1,49,7,43,50,386,75,12,2,11,0,0,2,11,87,13,0,13
16,Idaho/ID,1600300,"Central Idaho--Lewiston City & Nez Perce Reservation PUMA, Idaho/ID",16085,"Valley County, Idaho",10401,91,1,875,10,0.099,75,0,11,12,0,2,87,0,13,2,11,13,100,75,12,2,11,0,0,2,11,87,13,0,13
16,Idaho/ID,1600400,"Ada (North), Payette, Canyon (North), Gem & Washington Counties--Eagle City PUMA, Idaho/ID",16001,"Ada County, Idaho",446052,12720,147,2852,33,0.337,394,100,298,84,8,0,478,108,298,8,398,406,884,45,10,1,45,1,11,0,34,54,46,12,34
16,Idaho/ID,1600400,"Ada (North), Payette, Canyon (North), Gem & Washington Counties--Eagle City PUMA, Idaho/ID",16027,"Canyon County, Idaho",212230,8105,101,3819,48,0.221,258,65,195,55,5,0,313,70,195,5,260,265,578,45,10,1,45,1,11,0,34,54,46,12,34
16,Idaho/ID,1600400,"Ada (North), Payette, Canyon (North), Gem & Washington Counties--Eagle City PUMA, Idaho/ID",16045,"Gem County, Idaho",17052,308,2,1806,12,0.151,177,45,133,38,3,0,215,48,133,3,178,181,396,45,10,1,45,1,11,0,34,54,46,12,34
16,Idaho/ID,1600400,"Ada (North), Payette, Canyon (North), Gem & Washington Counties--Eagle City PUMA, Idaho/ID",16075,"Payette County, Idaho",23041,864,7,3750,30,0.202,236,60,178,50,5,0,286,65,178,5,238,243,529,45,9,1,45,1,11,0,34,54,46,12,34
16,Idaho/ID,1600400,"Ada (North), Payette, Canyon (North), Gem & Washington Counties--Eagle City PUMA, Idaho/ID",16087,"Washington County, Idaho",10025,357,6,3561,60,0.089,104,26,79,22,2,0,126,28,79,2,105,107,233,45,9,1,45,1,11,0,34,54,46,12,34
16,Idaho/ID,1600500,"Canyon (South) & Owyhee Counties--Caldwell & Nampa (South & West) Cities PUMA, Idaho/ID",16027,"Canyon County, Idaho",212230,8105,101,3819,48,0.907,844,461,1733,518,0,6,1362,461,1739,6,2194,2200,3562,24,15,0,62,0,13,0,49,38,62,13,49
16,Idaho/ID,1600500,"Canyon (South) & Owyhee Counties--Caldwell & Nampa (South & West) Cities PUMA, Idaho/ID",16073,"Owyhee County, Idaho",11455,326,5,2846,44,0.093,86,47,178,53,0,1,139,47,179,1,225,226,365,24,15,0,62,0,13,0,49,38,62,13,49
16,Idaho/ID,1600600,"Canyon (East) & Ada (West) Counties--Nampa (Central & East) & Meridian (West) Cities PUMA, Idaho/ID",16001,"Ada County, Idaho",446052,12720,147,2852,33,0.406,158,35,143,115,0,0,273,35,143,0,178,178,451,35,25,0,39,0,8,0,32,61,39,8,32
16,Idaho/ID,1600600,"Canyon (East) & Ada (West) Counties--Nampa (Central & East) & Meridian (West) Cities PUMA, Idaho/ID",16027,"Canyon County, Idaho",212230,8105,101,3819,48,0.594,232,52,208,168,0,0,400,52,208,0,260,260,660,35,25,0,39,0,8,0,32,61,39,8,32
16,Idaho/ID,1600701,"Ada County (Central)--Meridian (Northeast) & Boise (Far West) Cities PUMA, Idaho/ID",16001,"Ada County, Idaho",446052,12720,147,2852,33,1,205,0,0,93,53,0,298,53,0,53,0,53,351,58,26,15,0,15,0,0,0,85,15,15,0
16,Idaho/ID,1600702,"Ada County (Northeast)--Boise (North & West) & Garden City Cities PUMA, Idaho/ID",16001,"Ada County, Idaho",446052,12720,147,2852,33,1,186,0,219,207,35,94,393,35,313,129,219,348,741,25,28,17,30,5,0,13,30,53,47,5,42
16,Idaho/ID,1600800,"Ada County (South)--Boise (South) & Kuna Cities PUMA, Idaho/ID",16001,"Ada County, Idaho",446052,12720,147,2852,33,1,195,30,0,31,0,56,226,30,56,56,30,86,312,62,10,18,10,0,10,18,0,72,28,10,18
16,Idaho/ID,1600900,"Twin Falls & Cassia Counties--Twin Falls City PUMA, Idaho/ID",16031,"Cassia County, Idaho",23615,708,5,2998,21,0.22,390,112,466,87,6,6,477,118,472,12,578,590,1067,37,8,1,54,1,10,1,44,45,55,11,44
16,Idaho/ID,1600900,"Twin Falls & Cassia Counties--Twin Falls City PUMA, Idaho/ID",16083,"Twin Falls County, Idaho",83666,2199,38,2628,45,0.78,1382,399,1653,310,23,23,1692,422,1676,46,2052,2098,3790,36,8,1,54,1,11,1,44,45,55,11,44
16,Idaho/ID,1601000,"Elmore, Jerome, Blaine, Minidoka, Gooding, Lincoln & Camas Counties PUMA, Idaho/ID",16013,"Blaine County, Idaho",21994,651,6,2960,27,0.193,452,103,582,140,2,7,592,105,589,9,685,694,1286,35,11,1,53,0,8,1,45,46,54,8,46
16,Idaho/ID,1601000,"Elmore, Jerome, Blaine, Minidoka, Gooding, Lincoln & Camas Counties PUMA, Idaho/ID",16025,"Camas County, Idaho",886,27,0,3047,0,0.009,21,5,27,7,0,0,28,5,27,0,32,32,60,35,12,0,53,0,8,0,45,47,53,8,45
16,Idaho/ID,1601000,"Elmore, Jerome, Blaine, Minidoka, Gooding, Lincoln & Camas Counties PUMA, Idaho/ID",16039,"Elmore County, Idaho",26433,345,3,1305,11,0.23,538,123,693,166,2,9,704,125,702,11,816,827,1531,35,11,1,53,0,8,1,45,46,54,8,46
16,Idaho/ID,1601000,"Elmore, Jerome, Blaine, Minidoka, Gooding, Lincoln & Camas Counties PUMA, Idaho/ID",16047,"Gooding County, Idaho",15169,280,0,1846,0,0.134,314,71,404,97,1,5,411,72,409,6,475,481,892,35,11,1,53,0,8,1,45,46,54,8,46
16,Idaho/ID,1601000,"Elmore, Jerome, Blaine, Minidoka, Gooding, Lincoln & Camas Counties PUMA, Idaho/ID",16053,"Jerome County, Idaho",23431,752,7,3209,30,0.204,477,109,615,147,2,8,624,111,623,10,724,734,1358,35,11,1,53,0,8,1,45,46,54,8,46
16,Idaho/ID,1601000,"Elmore, Jerome, Blaine, Minidoka, Gooding, Lincoln & Camas Counties PUMA, Idaho/ID",16063,"Lincoln County, Idaho",5321,89,0,1673,0,0.047,110,25,142,34,0,2,144,25,144,2,167,169,313,35,11,1,53,0,8,1,45,46,54,8,46
16,Idaho/ID,1601000,"Elmore, Jerome, Blaine, Minidoka, Gooding, Lincoln & Camas Counties PUMA, Idaho/ID",16067,"Minidoka County, Idaho",20615,676,8,3279,39,0.183,428,98,552,132,2,7,560,100,559,9,650,659,1219,35,11,1,53,0,8,1,45,46,54,8,46
16,Idaho/ID,1601100,"Bingham (Outside Fort Hall AIR), Madison, Jefferson, Fremont & Teton Counties PUMA, Idaho/ID",16011,"Bingham County, Idaho",45551,971,10,2132,22,0.318,582,114,278,122,0,0,704,114,278,0,392,392,1096,53,11,0,36,0,10,0,25,64,36,10,25
16,Idaho/ID,1601100,"Bingham (Outside Fort Hall AIR), Madison, Jefferson, Fremont & Teton Counties PUMA, Idaho/ID",16043,"Fremont County, Idaho",12965,198,3,1527,23,0.097,178,35,85,37,0,0,215,35,85,0,120,120,335,53,11,0,36,0,10,0,25,64,36,10,25
16,Idaho/ID,1601100,"Bingham (Outside Fort Hall AIR), Madison, Jefferson, Fremont & Teton Counties PUMA, Idaho/ID",16051,"Jefferson County, Idaho",27969,554,2,1981,7,0.209,383,75,182,80,0,0,463,75,182,0,257,257,720,53,11,0,36,0,10,0,25,64,36,10,25
16,Idaho/ID,1601100,"Bingham (Outside Fort Hall AIR), Madison, Jefferson, Fremont & Teton Counties PUMA, Idaho/ID",16065,"Madison County, Idaho",38705,716,1,1850,3,0.293,536,105,256,113,0,0,649,105,256,0,361,361,1010,53,11,0,36,0,10,0,25,64,36,10,25
16,Idaho/ID,1601100,"Bingham (Outside Fort Hall AIR), Madison, Jefferson, Fremont & Teton Counties PUMA, Idaho/ID",16081,"Teton County, Idaho",11080,165,0,1489,0,0.082,150,29,72,32,0,0,182,29,72,0,101,101,283,53,11,0,36,0,10,0,25,64,36,10,25
16,Idaho/ID,1601200,"Bonneville County--Idaho Falls City PUMA, Idaho/ID",16019,"Bonneville County, Idaho",112397,2708,16,2409,14,1,836,109,402,62,0,0,898,109,402,0,511,511,1409,59,4,0,36,0,8,0,29,64,36,8,29
16,Idaho/ID,1601300,"Southeast Idaho--Pocatello, Chubbuck Cities & Fort Hall Reservation PUMA, Idaho/ID",16005,"Bannock County, Idaho",85065,1084,4,1274,5,0.673,806,57,524,221,17,0,1027,74,524,17,581,598,1625,50,14,1,36,1,4,0,32,63,37,5,32
16,Idaho/ID,1601300,"Southeast Idaho--Pocatello, Chubbuck Cities & Fort Hall Reservation PUMA, Idaho/ID",16007,"Bear Lake County, Idaho",5962,46,1,772,17,0.047,56,4,37,15,1,0,71,5,37,1,41,42,113,50,13,1,36,1,4,0,33,63,37,4,33
16,Idaho/ID,1601300,"Southeast Idaho--Pocatello, Chubbuck Cities & Fort Hall Reservation PUMA, Idaho/ID",16011,"Bingham County, Idaho",45551,971,10,2132,22,0.022,26,2,17,7,1,0,33,3,17,1,19,20,53,49,13,2,36,2,4,0,32,62,38,6,32
16,Idaho/ID,1601300,"Southeast Idaho--Pocatello, Chubbuck Cities & Fort Hall Reservation PUMA, Idaho/ID",16029,"Caribou County, Idaho",6918,114,0,1648,0,0.055,66,5,43,18,1,0,84,6,43,1,48,49,133,50,14,1,36,1,4,0,32,63,37,5,32
16,Idaho/ID,1601300,"Southeast Idaho--Pocatello, Chubbuck Cities & Fort Hall Reservation PUMA, Idaho/ID",16041,"Franklin County, Idaho",13279,134,0,1009,0,0.107,128,9,83,35,3,0,163,12,83,3,92,95,258,50,14,1,36,1,3,0,32,63,37,5,32
16,Idaho/ID,1601300,"Southeast Idaho--Pocatello, Chubbuck Cities & Fort Hall Reservation PUMA, Idaho/ID",16071,"Oneida County, Idaho",4326,26,0,601,0,0.035,42,3,27,12,1,0,54,4,27,1,30,31,85,49,14,1,35,1,4,0,32,64,36,5,32
16,Idaho/ID,1601300,"Southeast Idaho--Pocatello, Chubbuck Cities & Fort Hall Reservation PUMA, Idaho/ID",16077,"Power County, Idaho",7713,251,1,3254,13,0.061,73,5,47,20,2,0,93,7,47,2,52,54,147,50,14,1,35,1,3,0,32,63,37,5,32
17,Illinois/IL,1700104,"Jo Daviess, Carroll, Whiteside & Lee Counties PUMA, Illinois/IL",17015,"Carroll County, Illinois",14562,228,4,1566,27,0.114,163,1,6,18,6,0,181,7,6,6,7,13,194,84,9,3,4,3,1,0,3,93,7,4,3
17,Illinois/IL,1700104,"Jo Daviess, Carroll, Whiteside & Lee Counties PUMA, Illinois/IL",17085,"Jo Daviess County, Illinois",21834,257,2,1177,9,0.171,245,2,9,27,10,0,272,12,9,10,11,21,293,84,9,3,4,3,1,0,3,93,7,4,3
17,Illinois/IL,1700104,"Jo Daviess, Carroll, Whiteside & Lee Counties PUMA, Illinois/IL",17103,"Lee County, Illinois",34527,360,1,1043,3,0.269,385,3,13,42,15,0,427,18,13,15,16,31,458,84,9,3,3,3,1,0,3,93,7,4,3
17,Illinois/IL,1700104,"Jo Daviess, Carroll, Whiteside & Lee Counties PUMA, Illinois/IL",17195,"Whiteside County, Illinois",56396,744,20,1319,35,0.445,637,6,22,69,25,0,706,31,22,25,28,53,759,84,9,3,4,3,1,0,3,93,7,4,3
17,Illinois/IL,1700105,"Rock Island County PUMA, Illinois/IL",17161,"Rock Island County, Illinois",145275,3004,82,2068,56,1,341,0,333,17,335,843,358,335,1176,1178,333,1511,1869,18,1,63,18,18,0,45,18,19,81,18,63
17,Illinois/IL,1700202,"Henry, Mercer, Henderson, Warren, Hancock, McDonough & Fulton Counties PUMA, Illinois/IL",17057,"Fulton County, Illinois",35418,162,0,457,0,0.204,410,5,26,11,1,9,421,6,35,10,31,41,462,89,2,2,7,0,1,2,6,91,9,1,8
17,Illinois/IL,1700202,"Henry, Mercer, Henderson, Warren, Hancock, McDonough & Fulton Counties PUMA, Illinois/IL",17067,"Hancock County, Illinois",18112,206,3,1137,17,0.106,213,3,14,6,1,5,219,4,19,6,17,23,242,88,2,2,7,0,1,2,6,90,10,2,8
17,Illinois/IL,1700202,"Henry, Mercer, Henderson, Warren, Hancock, McDonough & Fulton Counties PUMA, Illinois/IL",17071,"Henderson County, Illinois",6884,66,0,959,0,0.039,78,1,5,2,0,2,80,1,7,2,6,8,88,89,2,2,7,0,1,2,6,91,9,1,8
17,Illinois/IL,1700202,"Henry, Mercer, Henderson, Warren, Hancock, McDonough & Fulton Counties PUMA, Illinois/IL",17073,"Henry County, Illinois",49464,656,5,1326,10,0.283,569,7,36,15,1,13,584,8,49,14,43,57,641,89,2,2,7,0,1,2,6,91,9,1,8
17,Illinois/IL,1700202,"Henry, Mercer, Henderson, Warren, Hancock, McDonough & Fulton Counties PUMA, Illinois/IL",17109,"McDonough County, Illinois",30875,475,15,1538,49,0.178,358,5,23,9,1,8,367,6,31,9,28,37,404,89,2,2,7,0,1,2,6,91,9,1,8
17,Illinois/IL,1700202,"Henry, Mercer, Henderson, Warren, Hancock, McDonough & Fulton Counties PUMA, Illinois/IL",17131,"Mercer County, Illinois",15693,137,5,873,32,0.09,181,2,12,5,0,4,186,2,16,4,14,18,204,89,2,2,7,0,1,2,6,91,9,1,8
17,Illinois/IL,1700202,"Henry, Mercer, Henderson, Warren, Hancock, McDonough & Fulton Counties PUMA, Illinois/IL",17187,"Warren County, Illinois",17338,327,2,1886,12,0.1,201,3,13,5,0,4,206,3,17,4,16,20,226,89,2,2,7,0,1,2,6,91,9,1,8
17,Illinois/IL,1700300,"Adams, Pike, Brown, Schuyler & Mason Counties PUMA, Illinois/IL",17001,"Adams County, Illinois",66427,1082,10,1629,15,0.607,894,2,10,0,13,63,894,15,73,76,12,88,982,91,0,8,1,1,0,6,1,91,9,2,7
17,Illinois/IL,1700300,"Adams, Pike, Brown, Schuyler & Mason Counties PUMA, Illinois/IL",17009,"Brown County, Illinois",6675,56,0,839,0,0.062,91,0,1,0,1,6,91,1,7,7,1,8,99,92,0,7,1,1,0,6,1,92,8,1,7
17,Illinois/IL,1700300,"Adams, Pike, Brown, Schuyler & Mason Counties PUMA, Illinois/IL",17125,"Mason County, Illinois",13778,140,1,1016,7,0.123,181,0,2,0,3,13,181,3,15,16,2,18,199,91,0,8,1,2,0,7,1,91,9,2,8
17,Illinois/IL,1700300,"Adams, Pike, Brown, Schuyler & Mason Counties PUMA, Illinois/IL",17149,"Pike County, Illinois",15754,123,1,781,6,0.145,214,1,2,0,3,15,214,4,17,18,3,21,235,91,0,8,1,1,0,6,1,91,9,2,7
17,Illinois/IL,1700300,"Adams, Pike, Brown, Schuyler & Mason Counties PUMA, Illinois/IL",17169,"Schuyler County, Illinois",7064,49,0,694,0,0.063,93,0,1,0,1,6,93,1,7,7,1,8,101,92,0,7,1,1,0,6,1,92,8,1,7
17,Illinois/IL,1700401,"Cass, Morgan, Scott, Greene, Macoupin, Jersey & Calhoun Counties PUMA, Illinois/IL",17013,"Calhoun County, Illinois",4858,58,0,1194,0,0.035,60,7,13,1,2,1,61,9,14,3,20,23,84,71,1,4,24,2,8,1,15,73,27,11,17
17,Illinois/IL,1700401,"Cass, Morgan, Scott, Greene, Macoupin, Jersey & Calhoun Counties PUMA, Illinois/IL",17017,"Cass County, Illinois",12665,393,11,3103,87,0.092,157,18,33,4,5,4,161,23,37,9,51,60,221,71,2,4,23,2,8,2,15,73,27,10,17
17,Illinois/IL,1700401,"Cass, Morgan, Scott, Greene, Macoupin, Jersey & Calhoun Counties PUMA, Illinois/IL",17061,"Greene County, Illinois",13218,219,10,1657,76,0.095,162,18,34,4,5,4,166,23,38,9,52,61,227,71,2,4,23,2,8,2,15,73,27,10,17
17,Illinois/IL,1700401,"Cass, Morgan, Scott, Greene, Macoupin, Jersey & Calhoun Counties PUMA, Illinois/IL",17083,"Jersey County, Illinois",22069,389,15,1763,68,0.16,273,31,58,6,8,6,279,39,64,14,89,103,382,71,2,4,23,2,8,2,15,73,27,10,17
17,Illinois/IL,1700401,"Cass, Morgan, Scott, Greene, Macoupin, Jersey & Calhoun Counties PUMA, Illinois/IL",17117,"Macoupin County, Illinois",45719,535,7,1170,15,0.333,567,64,121,13,16,13,580,80,134,29,185,214,794,71,2,4,23,2,8,2,15,73,27,10,17
17,Illinois/IL,1700401,"Cass, Morgan, Scott, Greene, Macoupin, Jersey & Calhoun Counties PUMA, Illinois/IL",17137,"Morgan County, Illinois",34426,664,24,1929,70,0.249,424,48,90,10,12,10,434,60,100,22,138,160,594,71,2,4,23,2,8,2,15,73,27,10,17
17,Illinois/IL,1700401,"Cass, Morgan, Scott, Greene, Macoupin, Jersey & Calhoun Counties PUMA, Illinois/IL",17171,"Scott County, Illinois",5047,77,0,1526,0,0.037,63,7,13,1,2,1,64,9,14,3,20,23,87,72,1,3,23,2,8,1,15,74,26,10,16
17,Illinois/IL,1700501,"Montgomery, Bond, Clinton, Fayette & Effingham Counties PUMA, Illinois/IL",17005,"Bond County, Illinois",16712,313,5,1873,30,0.12,143,0,3,4,0,0,147,0,3,0,3,3,150,95,3,0,2,0,0,0,2,98,2,0,2
17,Illinois/IL,1700501,"Montgomery, Bond, Clinton, Fayette & Effingham Counties PUMA, Illinois/IL",17027,"Clinton County, Illinois",37628,1129,20,3000,53,0.27,321,0,7,8,0,0,329,0,7,0,7,7,336,96,2,0,2,0,0,0,2,98,2,0,2
17,Illinois/IL,1700501,"Montgomery, Bond, Clinton, Fayette & Effingham Counties PUMA, Illinois/IL",17049,"Effingham County, Illinois",34174,858,1,2511,3,0.246,293,0,7,8,0,0,301,0,7,0,7,7,308,95,3,0,2,0,0,0,2,98,2,0,2
17,Illinois/IL,1700501,"Montgomery, Bond, Clinton, Fayette & Effingham Counties PUMA, Illinois/IL",17051,"Fayette County, Illinois",21724,402,3,1850,14,0.156,186,0,4,5,0,0,191,0,4,0,4,4,195,95,3,0,2,0,0,0,2,98,2,0,2
17,Illinois/IL,1700501,"Montgomery, Bond, Clinton, Fayette & Effingham Counties PUMA, Illinois/IL",17135,"Montgomery County, Illinois",29009,362,12,1248,41,0.207,246,0,6,6,0,0,252,0,6,0,6,6,258,95,2,0,2,0,0,0,2,98,2,0,2
17,Illinois/IL,1700600,"Douglas, Edgar, Coles & Cumberland Counties PUMA, Illinois/IL",17029,"Coles County, Illinois",51736,1437,30,2778,58,0.521,616,0,8,0,0,0,616,0,8,0,8,8,624,99,0,0,1,0,0,0,1,99,1,0,1
17,Illinois/IL,1700600,"Douglas, Edgar, Coles & Cumberland Counties PUMA, Illinois/IL",17035,"Cumberland County, Illinois",10865,211,5,1942,46,0.108,128,0,2,0,0,0,128,0,2,0,2,2,130,98,0,0,2,0,0,0,2,98,2,0,2
17,Illinois/IL,1700600,"Douglas, Edgar, Coles & Cumberland Counties PUMA, Illinois/IL",17041,"Douglas County, Illinois",19714,303,7,1537,36,0.196,232,0,3,0,0,0,232,0,3,0,3,3,235,99,0,0,1,0,0,0,1,99,1,0,1
17,Illinois/IL,1700600,"Douglas, Edgar, Coles & Cumberland Counties PUMA, Illinois/IL",17045,"Edgar County, Illinois",17539,113,8,644,46,0.175,207,0,3,0,0,0,207,0,3,0,3,3,210,99,0,0,1,0,0,0,1,99,1,0,1
17,Illinois/IL,1700700,"Clark, Jasper, Crawford, Lawrence, Richland, Clay & Wayne Counties PUMA, Illinois/IL",17023,"Clark County, Illinois",15836,158,2,998,13,0.149,176,0,0,10,4,0,186,4,0,4,0,4,190,93,5,2,0,2,0,0,0,98,2,2,0
17,Illinois/IL,1700700,"Clark, Jasper, Crawford, Lawrence, Richland, Clay & Wayne Counties PUMA, Illinois/IL",17025,"Clay County, Illinois",13338,149,0,1117,0,0.125,148,0,0,8,3,0,156,3,0,3,0,3,159,93,5,2,0,2,0,0,0,98,2,2,0
17,Illinois/IL,1700700,"Clark, Jasper, Crawford, Lawrence, Richland, Clay & Wayne Counties PUMA, Illinois/IL",17033,"Crawford County, Illinois",19088,429,3,2247,16,0.181,214,0,0,12,5,0,226,5,0,5,0,5,231,93,5,2,0,2,0,0,0,98,2,2,0
17,Illinois/IL,1700700,"Clark, Jasper, Crawford, Lawrence, Richland, Clay & Wayne Counties PUMA, Illinois/IL",17079,"Jasper County, Illinois",9598,206,9,2146,94,0.089,105,0,0,6,2,0,111,2,0,2,0,2,113,93,5,2,0,2,0,0,0,98,2,2,0
17,Illinois/IL,1700700,"Clark, Jasper, Crawford, Lawrence, Richland, Clay & Wayne Counties PUMA, Illinois/IL",17101,"Lawrence County, Illinois",16189,252,2,1557,12,0.153,181,0,0,10,4,0,191,4,0,4,0,4,195,93,5,2,0,2,0,0,0,98,2,2,0
17,Illinois/IL,1700700,"Clark, Jasper, Crawford, Lawrence, Richland, Clay & Wayne Counties PUMA, Illinois/IL",17159,"Richland County, Illinois",15881,204,5,1285,31,0.149,176,0,0,10,4,0,186,4,0,4,0,4,190,93,5,2,0,2,0,0,0,98,2,2,0
17,Illinois/IL,1700700,"Clark, Jasper, Crawford, Lawrence, Richland, Clay & Wayne Counties PUMA, Illinois/IL",17191,"Wayne County, Illinois",16487,269,5,1632,30,0.154,182,0,0,10,4,0,192,4,0,4,0,4,196,93,5,2,0,2,0,0,0,98,2,2,0
17,Illinois/IL,1700800,"South & Southeast Illinois PUMA, Illinois/IL",17003,"Alexander County, Illinois",6532,76,1,1164,15,0.048,46,1,3,0,0,0,46,1,3,0,4,4,50,92,0,0,8,0,2,0,6,92,8,2,6
17,Illinois/IL,1700800,"South & Southeast Illinois PUMA, Illinois/IL",17047,"Edwards County, Illinois",6507,64,0,984,0,0.048,46,1,3,0,0,0,46,1,3,0,4,4,50,92,0,0,8,0,2,0,6,92,8,2,6
17,Illinois/IL,1700800,"South & Southeast Illinois PUMA, Illinois/IL",17059,"Gallatin County, Illinois",5157,71,2,1377,39,0.039,38,1,3,0,0,0,38,1,3,0,4,4,42,90,0,0,10,0,2,0,7,90,10,2,7
17,Illinois/IL,1700800,"South & Southeast Illinois PUMA, Illinois/IL",17065,"Hamilton County, Illinois",8221,68,0,827,0,0.06,58,1,4,0,0,0,58,1,4,0,5,5,63,92,0,0,8,0,2,0,6,92,8,2,6
17,Illinois/IL,1700800,"South & Southeast Illinois PUMA, Illinois/IL",17069,"Hardin County, Illinois",4009,39,0,973,0,0.03,29,1,2,0,0,0,29,1,2,0,3,3,32,91,0,0,9,0,3,0,6,91,9,3,6
17,Illinois/IL,1700800,"South & Southeast Illinois PUMA, Illinois/IL",17087,"Johnson County, Illinois",12602,153,0,1214,0,0.096,92,2,7,0,0,0,92,2,7,0,9,9,101,91,0,0,9,0,2,0,7,91,9,2,7
17,Illinois/IL,1700800,"South & Southeast Illinois PUMA, Illinois/IL",17127,"Massac County, Illinois",14430,107,2,742,14,0.109,105,3,8,0,0,0,105,3,8,0,11,11,116,91,0,0,9,0,3,0,7,91,9,3,7
17,Illinois/IL,1700800,"South & Southeast Illinois PUMA, Illinois/IL",17151,"Pope County, Illinois",4249,27,1,635,24,0.031,30,1,2,0,0,0,30,1,2,0,3,3,33,91,0,0,9,0,3,0,6,91,9,3,6
17,Illinois/IL,1700800,"South & Southeast Illinois PUMA, Illinois/IL",17153,"Pulaski County, Illinois",5611,173,1,3083,18,0.042,40,1,3,0,0,0,40,1,3,0,4,4,44,91,0,0,9,0,2,0,7,91,9,2,7
17,Illinois/IL,1700800,"South & Southeast Illinois PUMA, Illinois/IL",17165,"Saline County, Illinois",24231,319,4,1316,17,0.18,173,4,13,0,0,0,173,4,13,0,17,17,190,91,0,0,9,0,2,0,7,91,9,2,7
17,Illinois/IL,1700800,"South & Southeast Illinois PUMA, Illinois/IL",17181,"Union County, Illinois",17127,514,24,3001,140,0.128,123,3,9,0,0,0,123,3,9,0,12,12,135,91,0,0,9,0,2,0,7,91,9,2,7
17,Illinois/IL,1700800,"South & Southeast Illinois PUMA, Illinois/IL",17185,"Wabash County, Illinois",11573,150,1,1296,9,0.085,82,2,6,0,0,0,82,2,6,0,8,8,90,91,0,0,9,0,2,0,7,91,9,2,7
17,Illinois/IL,1700800,"South & Southeast Illinois PUMA, Illinois/IL",17193,"White County, Illinois",14025,167,0,1191,0,0.106,102,2,8,0,0,0,102,2,8,0,10,10,112,91,0,0,9,0,2,0,7,91,9,2,7
17,Illinois/IL,1700900,"Jackson, Williamson, Franklin & Perry Counties PUMA, Illinois/IL",17055,"Franklin County, Illinois",39127,520,3,1329,8,0.209,207,0,2,0,0,0,207,0,2,0,2,2,209,99,0,0,1,0,0,0,1,99,1,0,1
17,Illinois/IL,1700900,"Jackson, Williamson, Franklin & Perry Counties PUMA, Illinois/IL",17077,"Jackson County, Illinois",58551,1257,24,2147,41,0.315,312,0,3,0,0,0,312,0,3,0,3,3,315,99,0,0,1,0,0,0,1,99,1,0,1
17,Illinois/IL,1700900,"Jackson, Williamson, Franklin & Perry Counties PUMA, Illinois/IL",17145,"Perry County, Illinois",21384,345,15,1613,70,0.114,113,0,1,0,0,0,113,0,1,0,1,1,114,99,0,0,1,0,0,0,1,99,1,0,1
17,Illinois/IL,1700900,"Jackson, Williamson, Franklin & Perry Counties PUMA, Illinois/IL",17199,"Williamson County, Illinois",67299,1383,44,2055,65,0.361,357,0,3,0,0,0,357,0,3,0,3,3,360,99,0,0,1,0,0,0,1,99,1,0,1
17,Illinois/IL,1701001,"Monroe, Randolph, Washington, Jefferson & Marion Counties PUMA, Illinois/IL",17081,"Jefferson County, Illinois",38169,587,38,1538,100,0.244,360,0,2,3,0,0,363,0,2,0,2,2,365,99,1,0,1,0,0,0,1,99,1,0,1
17,Illinois/IL,1701001,"Monroe, Randolph, Washington, Jefferson & Marion Counties PUMA, Illinois/IL",17121,"Marion County, Illinois",38084,532,0,1397,0,0.242,357,0,2,3,0,0,360,0,2,0,2,2,362,99,1,0,1,0,0,0,1,99,1,0,1
17,Illinois/IL,1701001,"Monroe, Randolph, Washington, Jefferson & Marion Counties PUMA, Illinois/IL",17133,"Monroe County, Illinois",33936,652,15,1921,44,0.216,319,0,2,3,0,0,322,0,2,0,2,2,324,98,1,0,1,0,0,0,1,99,1,0,1
17,Illinois/IL,1701001,"Monroe, Randolph, Washington, Jefferson & Marion Counties PUMA, Illinois/IL",17157,"Randolph County, Illinois",32546,933,11,2867,34,0.207,306,0,1,3,0,0,309,0,1,0,1,1,310,99,1,0,0,0,0,0,0,100,0,0,0
17,Illinois/IL,1701001,"Monroe, Randolph, Washington, Jefferson & Marion Counties PUMA, Illinois/IL",17189,"Washington County, Illinois",14155,204,1,1441,7,0.09,133,0,1,1,0,0,134,0,1,0,1,1,135,99,1,0,1,0,0,0,1,99,1,0,1
17,Illinois/IL,1701104,"St. Clair County (Central & Northeast) PUMA, Illinois/IL",17163,"St. Clair County, Illinois",263463,7219,189,2740,72,1,256,27,54,0,0,0,256,27,54,0,81,81,337,76,0,0,24,0,8,0,16,76,24,8,16
17,Illinois/IL,1701105,"St. Clair County (Northwest, Southwest & Southeast) PUMA, Illinois/IL",17163,"St. Clair County, Illinois",263463,7219,189,2740,72,1,310,0,0,0,0,0,310,0,0,0,0,0,310,100,0,0,0,0,0,0,0,100,0,0,0
17,Illinois/IL,1701204,"Madison County (East) PUMA, Illinois/IL",17119,"Madison County, Illinois",265670,5577,136,2099,51,1,271,17,0,0,0,5,271,17,5,5,17,22,293,92,0,2,6,0,6,2,0,92,8,6,2
17,Illinois/IL,1701205,"Madison County (West)--Granite City, Alton, Wood River Cities & Godfrey Village PUMA, Illinois/IL",17119,"Madison County, Illinois",265670,5577,136,2099,51,1,397,0,0,26,0,0,423,0,0,0,0,0,423,94,6,0,0,0,0,0,0,100,0,0,0
17,Illinois/IL,1701300,"Sangamon County--Springfield City PUMA, Illinois/IL",17167,"Sangamon County, Illinois",197661,2371,45,1200,23,1,623,32,0,0,0,70,623,32,70,70,32,102,725,86,0,10,4,0,4,10,0,86,14,4,10
17,Illinois/IL,1701500,"Macon County--Decatur City PUMA, Illinois/IL",17115,"Macon County, Illinois",106512,1487,44,1396,41,1,1267,0,0,0,0,0,1267,0,0,0,0,0,1267,100,0,0,0,0,0,0,0,100,0,0,0
17,Illinois/IL,1701602,"Menard, Logan, De Witt, Piatt, Moultrie, Shelby & Christian Counties PUMA, Illinois/IL",17021,"Christian County, Illinois",33231,521,12,1568,36,0.23,368,0,0,9,4,0,377,4,0,4,0,4,381,97,2,1,0,1,0,0,0,99,1,1,0
17,Illinois/IL,1701602,"Menard, Logan, De Witt, Piatt, Moultrie, Shelby & Christian Counties PUMA, Illinois/IL",17039,"De Witt County, Illinois",16042,112,1,698,6,0.112,179,0,0,4,2,0,183,2,0,2,0,2,185,97,2,1,0,1,0,0,0,99,1,1,0
17,Illinois/IL,1701602,"Menard, Logan, De Witt, Piatt, Moultrie, Shelby & Christian Counties PUMA, Illinois/IL",17107,"Logan County, Illinois",29207,459,1,1572,3,0.204,326,0,0,8,3,0,334,3,0,3,0,3,337,97,2,1,0,1,0,0,0,99,1,1,0
17,Illinois/IL,1701602,"Menard, Logan, De Witt, Piatt, Moultrie, Shelby & Christian Counties PUMA, Illinois/IL",17129,"Menard County, Illinois",12367,124,1,1003,8,0.087,139,0,0,3,1,0,142,1,0,1,0,1,143,97,2,1,0,1,0,0,0,99,1,1,0
17,Illinois/IL,1701602,"Menard, Logan, De Witt, Piatt, Moultrie, Shelby & Christian Counties PUMA, Illinois/IL",17139,"Moultrie County, Illinois",14703,213,3,1449,20,0.102,163,0,0,4,2,0,167,2,0,2,0,2,169,96,2,1,0,1,0,0,0,99,1,1,0
17,Illinois/IL,1701602,"Menard, Logan, De Witt, Piatt, Moultrie, Shelby & Christian Counties PUMA, Illinois/IL",17147,"Piatt County, Illinois",16427,137,0,834,0,0.114,182,0,0,4,2,0,186,2,0,2,0,2,188,97,2,1,0,1,0,0,0,99,1,1,0
17,Illinois/IL,1701602,"Menard, Logan, De Witt, Piatt, Moultrie, Shelby & Christian Counties PUMA, Illinois/IL",17173,"Shelby County, Illinois",21832,372,4,1704,18,0.15,240,0,0,6,2,0,246,2,0,2,0,2,248,97,2,1,0,1,0,0,0,99,1,1,0
17,Illinois/IL,1701701,"Peoria County--Peoria City PUMA, Illinois/IL",17143,"Peoria County, Illinois",184463,3413,49,1850,27,1,359,0,26,88,0,0,447,0,26,0,26,26,473,76,19,0,5,0,0,0,5,95,5,0,5
17,Illinois/IL,1701900,"Tazewell County PUMA, Illinois/IL",17179,"Tazewell County, Illinois",133852,1704,24,1273,18,1,431,0,0,3,0,0,434,0,0,0,0,0,434,99,1,0,0,0,0,0,0,100,0,0,0
17,Illinois/IL,1702000,"McLean County PUMA, Illinois/IL",17113,"McLean County, Illinois",173219,3245,22,1873,13,1,552,9,22,31,5,0,583,14,22,5,31,36,619,89,5,1,5,1,1,0,4,94,6,2,4
17,Illinois/IL,1702100,"Champaign County--Champaign & Urbana Cities PUMA, Illinois/IL",17019,"Champaign County, Illinois",209448,4583,20,2188,10,1,1116,0,0,33,0,30,1149,0,30,30,0,30,1179,95,3,3,0,0,0,3,0,97,3,0,3
17,Illinois/IL,1702200,"Livingston, Ford, Iroquois & Vermilion Counties PUMA, Illinois/IL",17053,"Ford County, Illinois",13398,100,5,746,37,0.087,160,4,9,8,1,0,168,5,9,1,13,14,182,88,4,1,7,1,2,0,5,92,8,3,5
17,Illinois/IL,1702200,"Livingston, Ford, Iroquois & Vermilion Counties PUMA, Illinois/IL",17075,"Iroquois County, Illinois",28169,361,19,1282,67,0.181,333,9,19,16,1,0,349,10,19,1,28,29,378,88,4,0,7,0,2,0,5,92,8,3,5
17,Illinois/IL,1702200,"Livingston, Ford, Iroquois & Vermilion Counties PUMA, Illinois/IL",17105,"Livingston County, Illinois",36324,371,6,1021,17,0.233,428,12,24,21,2,0,449,14,24,2,36,38,487,88,4,0,7,0,2,0,5,92,8,3,5
17,Illinois/IL,1702200,"Livingston, Ford, Iroquois & Vermilion Counties PUMA, Illinois/IL",17183,"Vermilion County, Illinois",78407,718,4,916,5,0.499,918,25,52,45,4,0,963,29,52,4,77,81,1044,88,4,0,7,0,2,0,5,92,8,3,5
17,Illinois/IL,1702300,"Kankakee County PUMA, Illinois/IL",17091,"Kankakee County, Illinois",111061,2734,77,2462,69,1,442,52,387,195,0,31,637,52,418,31,439,470,1107,40,18,3,40,0,5,3,35,58,42,5,38
17,Illinois/IL,1702400,"LaSalle County PUMA, Illinois/IL",17099,"LaSalle County, Illinois",110401,1682,56,1524,51,1,471,42,161,66,0,27,537,42,188,27,203,230,767,61,9,4,26,0,5,4,21,70,30,5,25
17,Illinois/IL,1702501,"Knox, Stark, Bureau, Marshall & Woodford Counties PUMA, Illinois/IL",17011,"Bureau County, Illinois",33381,625,11,1872,33,0.227,309,5,30,12,1,2,321,6,32,3,35,38,359,86,3,1,10,0,1,1,8,89,11,2,9
17,Illinois/IL,1702501,"Knox, Stark, Bureau, Marshall & Woodford Counties PUMA, Illinois/IL",17095,"Knox County, Illinois",50999,640,3,1255,6,0.347,473,7,45,18,2,3,491,9,48,5,52,57,548,86,3,1,9,0,1,1,8,90,10,2,9
17,Illinois/IL,1702501,"Knox, Stark, Bureau, Marshall & Woodford Counties PUMA, Illinois/IL",17123,"Marshall County, Illinois",11794,101,0,856,0,0.081,110,2,11,4,0,1,114,2,12,1,13,14,128,86,3,1,10,0,2,1,9,89,11,2,9
17,Illinois/IL,1702501,"Knox, Stark, Bureau, Marshall & Woodford Counties PUMA, Illinois/IL",17155,"Putnam County, Illinois",5746,57,0,992,0,0.038,52,1,5,2,0,0,54,1,5,0,6,6,60,87,3,0,10,0,2,0,8,90,10,2,8
17,Illinois/IL,1702501,"Knox, Stark, Bureau, Marshall & Woodford Counties PUMA, Illinois/IL",17175,"Stark County, Illinois",5500,55,2,1000,36,0.039,53,1,5,2,0,0,55,1,5,0,6,6,61,87,3,0,10,0,2,0,8,90,10,2,8
17,Illinois/IL,1702501,"Knox, Stark, Bureau, Marshall & Woodford Counties PUMA, Illinois/IL",17203,"Woodford County, Illinois",38817,427,6,1100,15,0.267,364,6,35,14,1,3,378,7,38,4,41,45,423,86,3,1,10,0,1,1,8,89,11,2,9
17,Illinois/IL,1702601,"DeKalb County PUMA, Illinois/IL",17037,"DeKalb County, Illinois",104200,1613,38,1548,36,1,390,112,201,9,0,0,399,112,201,0,313,313,712,55,1,0,44,0,16,0,28,56,44,16,28
17,Illinois/IL,1702700,"Stephenson & Ogle Counties PUMA, Illinois/IL",17141,"Ogle County, Illinois",51328,705,6,1374,12,0.529,816,65,118,28,24,4,844,89,122,28,183,211,1055,77,3,3,17,2,6,0,11,80,20,8,12
17,Illinois/IL,1702700,"Stephenson & Ogle Counties PUMA, Illinois/IL",17177,"Stephenson County, Illinois",45433,510,6,1123,13,0.471,726,58,106,24,21,4,750,79,110,25,164,189,939,77,3,3,17,2,6,0,11,80,20,8,12
17,Illinois/IL,1702801,"Winnebago County (Southeast & West)--Rockford City PUMA, Illinois/IL",17201,"Winnebago County, Illinois",286174,5750,153,2009,53,1,817,134,152,165,44,160,982,178,312,204,286,490,1472,56,11,14,19,3,9,11,10,67,33,12,21
17,Illinois/IL,1702901,"Winnebago (Northeast) & Boone Counties PUMA, Illinois/IL",17007,"Boone County, Illinois",53606,1095,23,2043,43,0.378,325,21,95,65,0,56,390,21,151,56,116,172,562,58,12,10,21,0,4,10,17,69,31,4,27
17,Illinois/IL,1702901,"Winnebago (Northeast) & Boone Counties PUMA, Illinois/IL",17201,"Winnebago County, Illinois",286174,5750,153,2009,53,0.622,534,34,157,107,0,91,641,34,248,91,191,282,923,58,12,10,21,0,4,10,17,69,31,4,27
17,Illinois/IL,1703005,"Kane County (Southeast)--Aurora Township PUMA, Illinois/IL",17089,"Kane County, Illinois",530839,12993,327,2448,62,1,351,113,398,216,0,118,567,113,516,118,511,629,1196,29,18,10,43,0,9,10,33,47,53,9,43
17,Illinois/IL,1703007,"Kane County (East)--St. Charles, Batavia (Central) & Geneva (Central) Townships PUMA, Illinois/IL",17089,"Kane County, Illinois",530839,12993,327,2448,62,1,124,25,0,23,0,0,147,25,0,0,25,25,172,72,13,0,15,0,15,0,0,85,15,15,0
17,Illinois/IL,1703008,"Kane County (Northeast)--Elgin (North & Central) & Dundee Townships PUMA, Illinois/IL",17089,"Kane County, Illinois",530839,12993,327,2448,62,1,175,120,352,207,17,131,382,137,483,148,472,620,1002,17,21,15,47,2,12,13,35,38,62,14,48
17,Illinois/IL,1703009,"Kane County (West) PUMA, Illinois/IL",17089,"Kane County, Illinois",530839,12993,327,2448,62,1,589,174,48,0,0,0,589,174,48,0,222,222,811,73,0,0,27,0,21,0,6,73,27,21,6
17,Illinois/IL,1703102,"Will County (West Central)--Joliet & Troy Townships PUMA, Illinois/IL",17197,"Will County, Illinois",688697,13831,380,2008,55,1,214,0,246,72,0,0,286,0,246,0,246,246,532,40,14,0,46,0,0,0,46,54,46,0,46
17,Illinois/IL,1703105,"Will County (Northwest Central)--Plainfield & Lockport Townships PUMA, Illinois/IL",17197,"Will County, Illinois",688697,13831,380,2008,55,1,245,109,164,132,65,0,377,174,164,65,273,338,715,34,18,9,38,9,15,0,23,53,47,24,23
17,Illinois/IL,1703106,"Will County (Northwest)--DuPage & Wheatland Townships PUMA, Illinois/IL",17197,"Will County, Illinois",688697,13831,380,2008,55,1,158,71,82,59,41,0,217,112,82,41,153,194,411,38,14,10,37,10,17,0,20,53,47,27,20
17,Illinois/IL,1703107,"Will County (Northeast)--Frankfort, Homer & New Lenox (North) Townships PUMA, Illinois/IL",17197,"Will County, Illinois",688697,13831,380,2008,55,1,86,0,0,0,0,0,86,0,0,0,0,0,86,100,0,0,0,0,0,0,0,100,0,0,0
17,Illinois/IL,1703108,"Will County (South) PUMA, Illinois/IL",17197,"Will County, Illinois",688697,13831,380,2008,55,1,321,19,6,0,0,0,321,19,6,0,25,25,346,93,0,0,7,0,5,0,2,93,7,5,2
17,Illinois/IL,1703202,"DuPage County (Central)--Milton Township PUMA, Illinois/IL",17043,"DuPage County, Illinois",931743,17253,557,1852,60,1,46,0,15,0,91,0,46,91,15,91,15,106,152,30,0,60,10,60,0,0,10,30,70,60,10
17,Illinois/IL,1703203,"DuPage County (South Central)--Lisle Township PUMA, Illinois/IL",17043,"DuPage County, Illinois",931743,17253,557,1852,60,1,130,34,0,0,0,0,130,34,0,0,34,34,164,79,0,0,21,0,21,0,0,79,21,21,0
17,Illinois/IL,1703204,"DuPage County (Southeast)--Downers Grove Township PUMA, Illinois/IL",17043,"DuPage County, Illinois",931743,17253,557,1852,60,1,73,0,0,0,0,14,73,0,14,14,0,14,87,84,0,16,0,0,0,16,0,84,16,0,16
17,Illinois/IL,1703205,"DuPage County (East Central)--York Township PUMA, Illinois/IL",17043,"DuPage County, Illinois",931743,17253,557,1852,60,1,270,0,0,16,0,0,286,0,0,0,0,0,286,94,6,0,0,0,0,0,0,100,0,0,0
17,Illinois/IL,1703207,"Dupage County (Northeast)--Addison & Bloomingdale (North) Townships PUMA, Illinois/IL",17043,"DuPage County, Illinois",931743,17253,557,1852,60,1,114,56,244,19,58,0,133,114,244,58,300,358,491,23,4,12,61,12,11,0,50,27,73,23,50
17,Illinois/IL,1703208,"DuPage County (Northwest)--Bloomingdale (South), Wayne & Winfield (North) Townships PUMA, Illinois/IL",17043,"DuPage County, Illinois",931743,17253,557,1852,60,1,216,92,393,158,54,40,374,146,433,94,485,579,953,23,17,10,51,6,10,4,41,39,61,15,45
17,Illinois/IL,1703209,"DuPage County (Southwest)--Naperville & Winfield (South) Townships PUMA, Illinois/IL",17043,"DuPage County, Illinois",931743,17253,557,1852,60,1,31,32,174,147,0,0,178,32,174,0,206,206,384,8,38,0,54,0,8,0,45,46,54,8,45
17,Illinois/IL,1703306,"Lake County (Northwest)--Avon, Lake Villa, Antioch & Grant Townships PUMA, Illinois/IL",17097,"Lake County, Illinois",703619,16733,487,2378,69,1,217,113,154,39,0,0,256,113,154,0,267,267,523,41,7,0,51,0,22,0,29,49,51,22,29
17,Illinois/IL,1703307,"Lake County (Northeast)--Waukegan, Zion, Benton & Newport Townships PUMA, Illinois/IL",17097,"Lake County, Illinois",703619,16733,487,2378,69,1,9,94,382,197,0,0,206,94,382,0,476,476,682,1,29,0,70,0,14,0,56,30,70,14,56
17,Illinois/IL,1703308,"Lake County (Southwest)--Ela, Freemont, Wauconda & Cuba Townships PUMA, Illinois/IL",17097,"Lake County, Illinois",703619,16733,487,2378,69,1,86,0,0,0,0,0,86,0,0,0,0,0,86,100,0,0,0,0,0,0,0,100,0,0,0
17,Illinois/IL,1703309,"Lake County (East Central)--Warren, Libertyville (North & East) & Shields Townships PUMA, Illinois/IL",17097,"Lake County, Illinois",703619,16733,487,2378,69,1,136,12,43,34,0,0,170,12,43,0,55,55,225,60,15,0,24,0,5,0,19,76,24,5,19
17,Illinois/IL,1703310,"Lake County--Vernon, Moraine, West Deerfield & Libertyville (Southeast) Townships PUMA, Illinois/IL",17097,"Lake County, Illinois",703619,16733,487,2378,69,1,164,0,97,20,0,18,184,0,115,18,97,115,299,55,7,6,32,0,0,6,32,62,38,0,38
17,Illinois/IL,1703401,"Cook County (Northwest)--Palatine & Barrington Townships PUMA, Illinois/IL",17031,"Cook County, Illinois",5223719,142215,5194,2722,99,1,27,46,54,19,28,0,46,74,54,28,100,128,174,16,11,16,57,16,26,0,31,26,74,43,31
17,Illinois/IL,1703407,"Cook County (West Central)--Proviso, Riverside & River Forest Townships PUMA, Illinois/IL",17031,"Cook County, Illinois",5223719,142215,5194,2722,99,1,167,33,108,96,0,0,263,33,108,0,141,141,404,41,24,0,35,0,8,0,27,65,35,8,27
17,Illinois/IL,1703408,"Cook County (Central)--Cicero, Berwyn & Oak Park Townships PUMA, Illinois/IL",17031,"Cook County, Illinois",5223719,142215,5194,2722,99,1,166,322,682,343,0,14,509,322,696,14,1004,1018,1527,11,22,1,66,0,21,1,45,33,67,21,46
17,Illinois/IL,1703409,"Cook County (West Central)--Lyons & Stickney Townships PUMA, Illinois/IL",17031,"Cook County, Illinois",5223719,142215,5194,2722,99,1,205,50,184,77,51,77,282,101,261,128,234,362,644,32,12,20,36,8,8,12,29,44,56,16,41
17,Illinois/IL,1703410,"Cook County (Southwest)--Orland (West & Central), Palos & Lemont Townships PUMA, Illinois/IL",17031,"Cook County, Illinois",5223719,142215,5194,2722,99,1,124,0,0,36,76,0,160,76,0,76,0,76,236,53,15,32,0,32,0,0,0,68,32,32,0
17,Illinois/IL,1703411,"Cook County (South Central)--Worth & Calumet Townships PUMA, Illinois/IL",17031,"Cook County, Illinois",5223719,142215,5194,2722,99,1,180,58,26,73,26,0,253,84,26,26,84,110,363,50,20,7,23,7,16,0,7,70,30,23,7
17,Illinois/IL,1703412,"Cook County (South Central)--Bremen & Orland (East) Townships PUMA, Illinois/IL",17031,"Cook County, Illinois",5223719,142215,5194,2722,99,1,193,0,102,74,0,0,267,0,102,0,102,102,369,52,20,0,28,0,0,0,28,72,28,0,28
17,Illinois/IL,1703413,"Cook County (Southeast)--Thornton Township PUMA, Illinois/IL",17031,"Cook County, Illinois",5223719,142215,5194,2722,99,1,485,185,159,183,0,59,668,185,218,59,344,403,1071,45,17,6,32,0,17,6,15,62,38,17,20
17,Illinois/IL,1703414,"Cook County (South)--Bloom & Rich Townships PUMA, Illinois/IL",17031,"Cook County, Illinois",5223719,142215,5194,2722,99,1,562,48,0,14,23,13,576,71,13,36,48,84,660,85,2,5,7,3,7,2,0,87,13,11,2
17,Illinois/IL,1703415,"Cook County (North)--Wheeling Township (North & East) PUMA, Illinois/IL",17031,"Cook County, Illinois",5223719,142215,5194,2722,99,1,9,0,212,0,12,92,9,12,304,104,212,316,325,3,0,32,65,4,0,28,65,3,97,4,94
17,Illinois/IL,1703416,"Cook County (Northeast)--Northfield & New Trier Townships PUMA, Illinois/IL",17031,"Cook County, Illinois",5223719,142215,5194,2722,99,1,77,0,0,0,69,0,77,69,0,69,0,69,146,53,0,47,0,47,0,0,0,53,47,47,0
17,Illinois/IL,1703417,"Cook County (Northwest)--Hanover & Schaumburg (Northwest) Townships PUMA, Illinois/IL",17031,"Cook County, Illinois",5223719,142215,5194,2722,99,1,20,40,440,25,0,0,45,40,440,0,480,480,525,4,5,0,91,0,8,0,84,9,91,8,84
17,Illinois/IL,1703418,"Cook County (Northwest)--Schaumburg Township (South & Central) PUMA, Illinois/IL",17031,"Cook County, Illinois",5223719,142215,5194,2722,99,1,93,0,76,50,27,37,143,27,113,64,76,140,283,33,18,23,27,10,0,13,27,51,49,10,40
17,Illinois/IL,1703419,"Cook County (Northwest)--Elk Grove & Wheeling (Southwest) Townships PUMA, Illinois/IL",17031,"Cook County, Illinois",5223719,142215,5194,2722,99,1,185,28,205,0,20,44,185,48,249,64,233,297,482,38,0,13,48,4,6,9,43,38,62,10,52
17,Illinois/IL,1703420,"Cook County (North)--Maine, Norwood Park Townships & Chicago City--Edison Park PUMA, Illinois/IL",17031,"Cook County, Illinois",5223719,142215,5194,2722,99,1,235,0,230,0,66,23,235,66,253,89,230,319,554,42,0,16,42,12,0,4,42,42,58,12,46
17,Illinois/IL,1703421,"Cook County (North)--Niles & Evanston Townships PUMA, Illinois/IL",17031,"Cook County, Illinois",5223719,142215,5194,2722,99,1,15,0,13,0,41,32,15,41,45,73,13,86,101,15,0,72,13,41,0,32,13,15,85,41,45
17,Illinois/IL,1703422,"Cook County (West)--Leyden, Norwood Park (South) Townships & Chicago City--O'Hare PUMA, Illinois/IL",17031,"Cook County, Illinois",5223719,142215,5194,2722,99,1,223,63,109,41,40,85,264,103,194,125,172,297,561,40,7,22,31,7,11,15,19,47,53,18,35
17,Illinois/IL,1703501,"Chicago City (North)--Edgewater, Uptown & Rogers Park PUMA, Illinois/IL",17031,"Cook County, Illinois",5223719,142215,5194,2722,99,1,123,0,457,0,76,67,123,76,524,143,457,600,723,17,0,20,63,11,0,9,63,17,83,11,72
17,Illinois/IL,1703502,"Chicago City (North)--Lake View & Lincoln Park PUMA, Illinois/IL",17031,"Cook County, Illinois",5223719,142215,5194,2722,99,1,22,9,31,0,0,0,22,9,31,0,40,40,62,35,0,0,65,0,15,0,50,35,65,15,50
17,Illinois/IL,1703503,"Chicago City (North)--West Ridge, Lincoln Square & North Center PUMA, Illinois/IL",17031,"Cook County, Illinois",5223719,142215,5194,2722,99,1,75,0,0,0,23,30,75,23,30,53,0,53,128,59,0,41,0,18,0,23,0,59,41,18,23
17,Illinois/IL,1703504,"Chicago City (Northwest)--Irving Park, Albany Park, Forest Glen & North Park PUMA, Illinois/IL",17031,"Cook County, Illinois",5223719,142215,5194,2722,99,1,20,74,169,36,9,43,56,83,212,52,243,295,351,6,10,15,69,3,21,12,48,16,84,24,60
17,Illinois/IL,1703520,"Chicago City (Northwest)--Portage Park, Dunning & Jefferson Park PUMA, Illinois/IL",17031,"Cook County, Illinois",5223719,142215,5194,2722,99,1,40,14,142,43,86,38,83,100,180,124,156,280,363,11,12,34,43,24,4,10,39,23,77,28,50
17,Illinois/IL,1703521,"Chicago City (West)--Austin, Belmont Cragin & Montclare PUMA, Illinois/IL",17031,"Cook County, Illinois",5223719,142215,5194,2722,99,1,236,261,767,72,16,0,308,277,767,16,1028,1044,1352,17,5,1,76,1,19,0,57,23,77,20,57
17,Illinois/IL,1703522,"Chicago City (Northwest)--Logan Square, Avondale & Hermosa PUMA, Illinois/IL",17031,"Cook County, Illinois",5223719,142215,5194,2722,99,1,96,160,513,313,0,0,409,160,513,0,673,673,1082,9,29,0,62,0,15,0,47,38,62,15,47
17,Illinois/IL,1703523,"Chicago City (West)--North & South Lawndale, Humboldt Park, East & West Garfield Park PUMA, Illinois/IL",17031,"Cook County, Illinois",5223719,142215,5194,2722,99,1,416,84,772,136,0,0,552,84,772,0,856,856,1408,30,10,0,61,0,6,0,55,39,61,6,55
17,Illinois/IL,1703524,"Chicago City (West)--West Town, Near West Side & Lower West Side PUMA, Illinois/IL",17031,"Cook County, Illinois",5223719,142215,5194,2722,99,1,178,71,120,40,0,0,218,71,120,0,191,191,409,44,10,0,47,0,17,0,29,53,47,17,29
17,Illinois/IL,1703525,"Chicago City (Central)--Near North Side, Loop & Near South Side PUMA, Illinois/IL",17031,"Cook County, Illinois",5223719,142215,5194,2722,99,1,166,0,0,0,0,0,166,0,0,0,0,0,166,100,0,0,0,0,0,0,0,100,0,0,0
17,Illinois/IL,1703526,"Chicago City (Southwest)--Brighton Park, New City, Bridgeport & McKinley Park PUMA, Illinois/IL",17031,"Cook County, Illinois",5223719,142215,5194,2722,99,1,42,143,903,402,53,142,444,196,1045,195,1046,1241,1685,2,24,12,62,3,8,8,54,26,74,12,62
17,Illinois/IL,1703527,"Chicago City (Southwest)--Gage Park, Garfield Ridge & West Lawn PUMA, Illinois/IL",17031,"Cook County, Illinois",5223719,142215,5194,2722,99,1,22,324,725,315,101,18,337,425,743,119,1049,1168,1505,1,21,8,70,7,22,1,48,22,78,28,49
17,Illinois/IL,1703528,"Chicago City (South)--Chicago Lawn, Englewood/West Englewood & Greater Grand Crossing PUMA, Illinois/IL",17031,"Cook County, Illinois",5223719,142215,5194,2722,99,1,249,69,286,80,30,0,329,99,286,30,355,385,714,35,11,4,50,4,10,0,40,46,54,14,40
17,Illinois/IL,1703529,"Chicago City (South)--South Shore, Hyde Park, Woodlawn, Grand Boulevard & Douglas PUMA, Illinois/IL",17031,"Cook County, Illinois",5223719,142215,5194,2722,99,1,270,0,0,0,0,26,270,0,26,26,0,26,296,91,0,9,0,0,0,9,0,91,9,0,9
17,Illinois/IL,1703530,"Chicago City (South)--Ashburn, Washington Heights, Morgan Park & Beverly PUMA, Illinois/IL",17031,"Cook County, Illinois",5223719,142215,5194,2722,99,1,102,138,50,69,0,0,171,138,50,0,188,188,359,28,19,0,52,0,38,0,14,48,52,38,14
17,Illinois/IL,1703531,"Chicago City (South)--Auburn Gresham, Roseland, Chatham, Avalon Park & Burnside PUMA, Illinois/IL",17031,"Cook County, Illinois",5223719,142215,5194,2722,99,1,628,0,15,0,45,0,628,45,15,45,15,60,688,91,0,7,2,7,0,0,2,91,9,7,2
17,Illinois/IL,1703532,"Chicago City (South)--South Chicago, Pullman, West Pullman, East Side & South Deering PUMA, Illinois/IL",17031,"Cook County, Illinois",5223719,142215,5194,2722,99,1,400,236,127,137,0,46,537,236,173,46,363,409,946,42,14,5,38,0,25,5,13,57,43,25,18
17,Illinois/IL,1703601,"McHenry County (North, West & Central) PUMA, Illinois/IL",17111,"McHenry County, Illinois",307789,4609,122,1497,40,1,488,110,70,94,0,0,582,110,70,0,180,180,762,64,12,0,24,0,14,0,9,76,24,14,9
17,Illinois/IL,1703602,"McHenry County (Southeast)--Algonquin, McHenry & Nunda Townships PUMA, Illinois/IL",17111,"McHenry County, Illinois",307789,4609,122,1497,40,1,413,0,15,0,25,0,413,25,15,25,15,40,453,91,0,6,3,6,0,0,3,91,9,6,3
17,Illinois/IL,1703700,"Kendall & Grundy Counties PUMA, Illinois/IL",17063,"Grundy County, Illinois",50509,659,5,1305,10,0.288,103,20,0,29,5,15,132,25,15,20,20,40,172,60,17,12,12,3,12,9,0,77,23,15,9
17,Illinois/IL,1703700,"Kendall & Grundy Counties PUMA, Illinois/IL",17093,"Kendall County, Illinois",124626,2042,26,1639,21,0.712,253,51,0,70,11,38,323,62,38,49,51,100,423,60,17,12,12,3,12,9,0,76,24,15,9
18,Indiana/IN,1800101,"Lake County (Northwest)--Hammond & East Chicago Cities PUMA, Indiana/IN",18089,"Lake County, Indiana",486849,10555,341,2168,70,1,93,77,259,214,0,0,307,77,259,0,336,336,643,14,33,0,52,0,12,0,40,48,52,12,40
18,Indiana/IN,1800102,"Lake County (Northeast)--Gary City & Griffith Town PUMA, Indiana/IN",18089,"Lake County, Indiana",486849,10555,341,2168,70,1,237,0,42,12,8,0,249,8,42,8,42,50,299,79,4,3,14,3,0,0,14,83,17,3,14
18,Indiana/IN,1800103,"Lake County (Central) PUMA, Indiana/IN",18089,"Lake County, Indiana",486849,10555,341,2168,70,1,255,38,0,111,0,93,366,38,93,93,38,131,497,51,22,19,8,0,8,19,0,74,26,8,19
18,Indiana/IN,1800104,"Lake County (South) PUMA, Indiana/IN",18089,"Lake County, Indiana",486849,10555,341,2168,70,1,78,36,0,0,0,0,78,36,0,0,36,36,114,68,0,0,32,0,32,0,0,68,32,32,0
18,Indiana/IN,1800200,"Porter County PUMA, Indiana/IN",18127,"Porter County, Indiana",168041,2147,49,1278,29,1,181,0,16,30,0,0,211,0,16,0,16,16,227,80,13,0,7,0,0,0,7,93,7,0,7
18,Indiana/IN,1800300,"LaPorte County PUMA, Indiana/IN",18091,"LaPorte County, Indiana",110552,1427,40,1291,36,1,567,33,42,10,0,0,577,33,42,0,75,75,652,87,2,0,12,0,5,0,6,88,12,5,6
18,Indiana/IN,1800401,"St. Joseph County (North)--South Bend City PUMA, Indiana/IN",18141,"St. Joseph County, Indiana",269240,6410,112,2381,42,1,202,0,93,50,0,25,252,0,118,25,93,118,370,55,14,7,25,0,0,7,25,68,32,0,32
18,Indiana/IN,1800402,"St. Joseph County (Outside South Bend City)--Mishawaka City PUMA, Indiana/IN",18141,"St. Joseph County, Indiana",269240,6410,112,2381,42,1,314,0,0,0,0,0,314,0,0,0,0,0,314,100,0,0,0,0,0,0,0,100,0,0,0
18,Indiana/IN,1800500,"Elkhart County--Elkhart & Goshen Cities PUMA, Indiana/IN",18039,"Elkhart County, Indiana",203604,6622,114,3252,56,1,596,143,93,0,0,0,596,143,93,0,236,236,832,72,0,0,28,0,17,0,11,72,28,17,11
18,Indiana/IN,1800600,"Noble, DeKalb, LaGrange & Steuben Counties PUMA, Indiana/IN",18033,"DeKalb County, Indiana",42704,478,12,1119,28,0.261,293,0,31,0,0,0,293,0,31,0,31,31,324,90,0,0,10,0,0,0,10,90,10,0,10
18,Indiana/IN,1800600,"Noble, DeKalb, LaGrange & Steuben Counties PUMA, Indiana/IN",18087,"LaGrange County, Indiana",38942,636,11,1633,28,0.239,269,0,28,0,0,0,269,0,28,0,28,28,297,91,0,0,9,0,0,0,9,91,9,0,9
18,Indiana/IN,1800600,"Noble, DeKalb, LaGrange & Steuben Counties PUMA, Indiana/IN",18113,"Noble County, Indiana",47451,912,33,1922,70,0.291,327,0,34,0,0,0,327,0,34,0,34,34,361,91,0,0,9,0,0,0,9,91,9,0,9
18,Indiana/IN,1800600,"Noble, DeKalb, LaGrange & Steuben Counties PUMA, Indiana/IN",18151,"Steuben County, Indiana",34474,381,7,1105,20,0.209,235,0,25,0,0,0,235,0,25,0,25,25,260,90,0,0,10,0,0,0,10,90,10,0,10
18,Indiana/IN,1800700,"Jasper, Starke, Fulton, Newton & Pulaski Counties PUMA, Indiana/IN",18049,"Fulton County, Indiana",20212,240,2,1187,10,0.195,175,26,15,1,0,0,176,26,15,0,41,41,217,81,0,0,19,0,12,0,7,81,19,12,7
18,Indiana/IN,1800700,"Jasper, Starke, Fulton, Newton & Pulaski Counties PUMA, Indiana/IN",18073,"Jasper County, Indiana",33449,396,3,1184,9,0.324,291,43,25,1,0,0,292,43,25,0,68,68,360,81,0,0,19,0,12,0,7,81,19,12,7
18,Indiana/IN,1800700,"Jasper, Starke, Fulton, Newton & Pulaski Counties PUMA, Indiana/IN",18111,"Newton County, Indiana",14018,174,12,1241,86,0.135,121,18,11,1,0,0,122,18,11,0,29,29,151,80,1,0,19,0,12,0,7,81,19,12,7
18,Indiana/IN,1800700,"Jasper, Starke, Fulton, Newton & Pulaski Counties PUMA, Indiana/IN",18131,"Pulaski County, Indiana",12660,115,1,908,8,0.123,110,16,10,0,0,0,110,16,10,0,26,26,136,81,0,0,19,0,12,0,7,81,19,12,7
18,Indiana/IN,1800700,"Jasper, Starke, Fulton, Newton & Pulaski Counties PUMA, Indiana/IN",18149,"Starke County, Indiana",22941,265,8,1155,35,0.223,200,29,17,1,0,0,201,29,17,0,46,46,247,81,0,0,19,0,12,0,7,81,19,12,7
18,Indiana/IN,1800800,"Kosciusko & Marshall Counties PUMA, Indiana/IN",18085,"Kosciusko County, Indiana",78806,1236,19,1568,24,0.629,647,53,102,47,9,45,694,62,147,54,155,209,903,72,5,6,17,1,6,5,11,77,23,7,16
18,Indiana/IN,1800800,"Kosciusko & Marshall Counties PUMA, Indiana/IN",18099,"Marshall County, Indiana",46595,1008,24,2163,52,0.371,381,32,60,28,5,27,409,37,87,32,92,124,533,71,5,6,17,1,6,5,11,77,23,7,16
18,Indiana/IN,1800900,"Huntington, Whitley, Adams & Wells Counties PUMA, Indiana/IN",18001,"Adams County, Indiana",35195,262,4,744,11,0.265,360,0,5,10,0,0,370,0,5,0,5,5,375,96,3,0,1,0,0,0,1,99,1,0,1
18,Indiana/IN,1800900,"Huntington, Whitley, Adams & Wells Counties PUMA, Indiana/IN",18069,"Huntington County, Indiana",36378,239,3,657,8,0.274,372,0,5,10,0,0,382,0,5,0,5,5,387,96,3,0,1,0,0,0,1,99,1,0,1
18,Indiana/IN,1800900,"Huntington, Whitley, Adams & Wells Counties PUMA, Indiana/IN",18179,"Wells County, Indiana",27947,278,4,995,14,0.21,285,0,4,8,0,0,293,0,4,0,4,4,297,96,3,0,1,0,0,0,1,99,1,0,1
18,Indiana/IN,1800900,"Huntington, Whitley, Adams & Wells Counties PUMA, Indiana/IN",18183,"Whitley County, Indiana",33649,270,7,802,21,0.251,341,0,5,10,0,0,351,0,5,0,5,5,356,96,3,0,1,0,0,0,1,99,1,0,1
18,Indiana/IN,1801001,"Allen County (Central)--Fort Wayne City (South) PUMA, Indiana/IN",18003,"Allen County, Indiana",370016,6206,212,1677,57,1,437,9,107,0,0,149,437,9,256,149,116,265,702,62,0,21,17,0,1,21,15,62,38,1,36
18,Indiana/IN,1801002,"Allen County (Central)--Fort Wayne City (North) PUMA, Indiana/IN",18003,"Allen County, Indiana",370016,6206,212,1677,57,1,336,0,10,6,45,166,342,45,176,211,10,221,563,60,1,37,2,8,0,29,2,61,39,8,31
18,Indiana/IN,1801003,"Allen County (Outside Fort Wayne City) PUMA, Indiana/IN",18003,"Allen County, Indiana",370016,6206,212,1677,57,1,282,0,0,0,17,0,282,17,0,17,0,17,299,94,0,6,0,6,0,0,0,94,6,6,0
18,Indiana/IN,1801100,"Montgomery, Clinton, White, Carroll & Benton Counties PUMA, Indiana/IN",18007,"Benton County, Indiana",8667,88,0,1015,0,0.07,121,10,31,2,0,0,123,10,31,0,41,41,164,74,1,0,25,0,6,0,19,75,25,6,19
18,Indiana/IN,1801100,"Montgomery, Clinton, White, Carroll & Benton Counties PUMA, Indiana/IN",18015,"Carroll County, Indiana",19994,274,13,1370,65,0.162,279,23,71,6,0,0,285,23,71,0,94,94,379,74,2,0,25,0,6,0,19,75,25,6,19
18,Indiana/IN,1801100,"Montgomery, Clinton, White, Carroll & Benton Counties PUMA, Indiana/IN",18023,"Clinton County, Indiana",32301,603,18,1867,56,0.264,455,38,116,9,0,0,464,38,116,0,154,154,618,74,1,0,25,0,6,0,19,75,25,6,19
18,Indiana/IN,1801100,"Montgomery, Clinton, White, Carroll & Benton Counties PUMA, Indiana/IN",18107,"Montgomery County, Indiana",38276,510,22,1332,57,0.309,533,44,136,11,0,0,544,44,136,0,180,180,724,74,2,0,25,0,6,0,19,75,25,6,19
18,Indiana/IN,1801100,"Montgomery, Clinton, White, Carroll & Benton Counties PUMA, Indiana/IN",18181,"White County, Indiana",24217,485,14,2003,58,0.195,336,28,86,7,0,0,343,28,86,0,114,114,457,74,2,0,25,0,6,0,19,75,25,6,19
18,Indiana/IN,1801200,"Tippecanoe County--Lafayette & West Lafayette Cities PUMA, Indiana/IN",18157,"Tippecanoe County, Indiana",189294,2394,14,1265,7,1,1262,91,82,0,6,32,1262,97,114,38,173,211,1473,86,0,3,12,0,6,2,6,86,14,7,8
18,Indiana/IN,1801300,"Howard, Cass & Tipton Counties--Kokomo City PUMA, Indiana/IN",18017,"Cass County, Indiana",38084,1944,10,5105,26,0.28,277,56,116,65,32,59,342,88,175,91,172,263,605,46,11,15,28,5,9,10,19,57,43,15,29
18,Indiana/IN,1801300,"Howard, Cass & Tipton Counties--Kokomo City PUMA, Indiana/IN",18067,"Howard County, Indiana",82387,1313,66,1594,80,0.608,603,121,252,141,71,127,744,192,379,198,373,571,1315,46,11,15,28,5,9,10,19,57,43,15,29
18,Indiana/IN,1801300,"Howard, Cass & Tipton Counties--Kokomo City PUMA, Indiana/IN",18159,"Tipton County, Indiana",15218,230,25,1511,164,0.112,111,22,46,26,13,23,137,35,69,36,68,104,241,46,11,15,28,5,9,10,19,57,43,15,29
18,Indiana/IN,1801400,"Grant, Miami & Wabash Counties PUMA, Indiana/IN",18053,"Grant County, Indiana",66944,1262,37,1885,55,0.497,705,21,14,10,5,0,715,26,14,5,35,40,755,93,1,1,5,1,3,0,2,95,5,3,2
18,Indiana/IN,1801400,"Grant, Miami & Wabash Counties PUMA, Indiana/IN",18103,"Miami County, Indiana",35901,439,3,1223,8,0.267,379,11,8,5,3,0,384,14,8,3,19,22,406,93,1,1,5,1,3,0,2,95,5,3,2
18,Indiana/IN,1801400,"Grant, Miami & Wabash Counties PUMA, Indiana/IN",18169,"Wabash County, Indiana",31631,268,8,847,25,0.236,335,10,7,5,2,0,340,12,7,2,17,19,359,93,1,1,5,1,3,0,2,95,5,3,2
18,Indiana/IN,1801500,"Henry, Randolph, Jay & Blackford Counties PUMA, Indiana/IN",18009,"Blackford County, Indiana",12129,127,3,1047,25,0.114,144,0,11,6,0,1,150,0,12,1,11,12,162,89,4,1,7,0,0,1,7,93,7,0,7
18,Indiana/IN,1801500,"Henry, Randolph, Jay & Blackford Counties PUMA, Indiana/IN",18065,"Henry County, Indiana",48483,810,26,1671,54,0.454,573,0,44,23,0,5,596,0,49,5,44,49,645,89,4,1,7,0,0,1,7,92,8,0,8
18,Indiana/IN,1801500,"Henry, Randolph, Jay & Blackford Counties PUMA, Indiana/IN",18075,"Jay County, Indiana",20993,186,0,886,0,0.197,249,0,19,10,0,2,259,0,21,2,19,21,280,89,4,1,7,0,0,1,7,92,8,0,8
18,Indiana/IN,1801500,"Henry, Randolph, Jay & Blackford Counties PUMA, Indiana/IN",18135,"Randolph County, Indiana",25076,252,7,1005,28,0.235,297,0,23,12,0,2,309,0,25,2,23,25,334,89,4,1,7,0,0,1,7,93,7,0,7
18,Indiana/IN,1801600,"Clay, Sullivan, Parke, Fountain, Vermillion & Warren Counties PUMA, Indiana/IN",18021,"Clay County, Indiana",26268,300,5,1142,19,0.252,189,0,7,6,0,0,195,0,7,0,7,7,202,94,3,0,3,0,0,0,3,97,3,0,3
18,Indiana/IN,1801600,"Clay, Sullivan, Parke, Fountain, Vermillion & Warren Counties PUMA, Indiana/IN",18045,"Fountain County, Indiana",16486,124,2,752,12,0.158,118,0,4,4,0,0,122,0,4,0,4,4,126,94,3,0,3,0,0,0,3,97,3,0,3
18,Indiana/IN,1801600,"Clay, Sullivan, Parke, Fountain, Vermillion & Warren Counties PUMA, Indiana/IN",18121,"Parke County, Indiana",16996,102,2,600,12,0.161,121,0,5,4,0,0,125,0,5,0,5,5,130,93,3,0,4,0,0,0,4,96,4,0,4
18,Indiana/IN,1801600,"Clay, Sullivan, Parke, Fountain, Vermillion & Warren Counties PUMA, Indiana/IN",18153,"Sullivan County, Indiana",20792,341,12,1640,58,0.2,150,0,6,5,0,0,155,0,6,0,6,6,161,93,3,0,4,0,0,0,4,96,4,0,4
18,Indiana/IN,1801600,"Clay, Sullivan, Parke, Fountain, Vermillion & Warren Counties PUMA, Indiana/IN",18165,"Vermillion County, Indiana",15560,129,0,829,0,0.15,112,0,4,4,0,0,116,0,4,0,4,4,120,93,3,0,3,0,0,0,3,97,3,0,3
18,Indiana/IN,1801600,"Clay, Sullivan, Parke, Fountain, Vermillion & Warren Counties PUMA, Indiana/IN",18171,"Warren County, Indiana",8247,40,1,485,12,0.078,58,0,2,2,0,0,60,0,2,0,2,2,62,94,3,0,3,0,0,0,3,97,3,0,3
18,Indiana/IN,1801700,"Vigo County--Terre Haute City PUMA, Indiana/IN",18167,"Vigo County, Indiana",107693,1829,27,1698,25,1,284,0,58,0,0,0,284,0,58,0,58,58,342,83,0,0,17,0,0,0,17,83,17,0,17
18,Indiana/IN,1801801,"Boone & Hamilton (Northwest) Counties PUMA, Indiana/IN",18011,"Boone County, Indiana",64321,988,49,1536,76,0.521,142,0,0,0,0,0,142,0,0,0,0,0,142,100,0,0,0,0,0,0,0,100,0,0,0
18,Indiana/IN,1801801,"Boone & Hamilton (Northwest) Counties PUMA, Indiana/IN",18057,"Hamilton County, Indiana",316095,4880,118,1544,37,0.479,130,0,0,0,0,0,130,0,0,0,0,0,130,100,0,0,0,0,0,0,0,100,0,0,0
18,Indiana/IN,1801803,"Hamilton County (East)--Noblesville City & Fishers Town (East) PUMA, Indiana/IN",18057,"Hamilton County, Indiana",316095,4880,118,1544,37,1,23,0,41,0,0,0,23,0,41,0,41,41,64,36,0,0,64,0,0,0,64,36,64,0,64
18,Indiana/IN,1801900,"Madison County--Anderson City PUMA, Indiana/IN",18095,"Madison County, Indiana",129505,1659,86,1281,66,1,684,0,25,77,0,0,761,0,25,0,25,25,786,87,10,0,3,0,0,0,3,97,3,0,3
18,Indiana/IN,1802000,"Delaware County--Muncie City PUMA, Indiana/IN",18035,"Delaware County, Indiana",115616,1947,63,1684,54,1,494,0,0,0,0,0,494,0,0,0,0,0,494,100,0,0,0,0,0,0,0,100,0,0,0
18,Indiana/IN,1802100,"Morgan, Putnam & Brown Counties PUMA, Indiana/IN",18013,"Brown County, Indiana",15034,104,3,692,20,0.122,57,2,0,0,0,0,57,2,0,0,2,2,59,97,0,0,3,0,3,0,0,97,3,3,0
18,Indiana/IN,1802100,"Morgan, Putnam & Brown Counties PUMA, Indiana/IN",18109,"Morgan County, Indiana",69727,729,41,1046,59,0.571,268,10,0,0,0,0,268,10,0,0,10,10,278,96,0,0,4,0,4,0,0,96,4,4,0
18,Indiana/IN,1802100,"Morgan, Putnam & Brown Counties PUMA, Indiana/IN",18133,"Putnam County, Indiana",37559,569,12,1515,32,0.307,144,6,0,0,0,0,144,6,0,0,6,6,150,96,0,0,4,0,4,0,0,96,4,4,0
18,Indiana/IN,1802200,"Hendricks County PUMA, Indiana/IN",18063,"Hendricks County, Indiana",160940,2749,140,1708,87,1,477,0,0,0,12,11,477,12,11,23,0,23,500,95,0,5,0,2,0,2,0,95,5,2,2
18,Indiana/IN,1802301,"Marion County--Pike & Washington (Northwest) Townships--Indianapolis City (Northwest) PUMA, Indiana/IN",18097,"Marion County, Indiana",944523,21367,817,2262,86,1,253,49,73,25,0,144,278,49,217,144,122,266,544,47,5,26,22,0,9,26,13,51,49,9,40
18,Indiana/IN,1802302,"Marion County--Washington Township (South & East)--Indianapolis City (North) PUMA, Indiana/IN",18097,"Marion County, Indiana",944523,21367,817,2262,86,1,240,0,18,0,0,0,240,0,18,0,18,18,258,93,0,0,7,0,0,0,7,93,7,0,7
18,Indiana/IN,1802303,"Marion County--Lawrence Township--Indianapolis (Northeast) & Lawrence Cities PUMA, Indiana/IN",18097,"Marion County, Indiana",944523,21367,817,2262,86,1,307,0,60,0,0,0,307,0,60,0,60,60,367,84,0,0,16,0,0,0,16,84,16,0,16
18,Indiana/IN,1802304,"Marion County--Wayne & Decatur (Northwest) Townships--Indianapolis City (West) PUMA, Indiana/IN",18097,"Marion County, Indiana",944523,21367,817,2262,86,1,405,7,137,0,0,0,405,7,137,0,144,144,549,74,0,0,26,0,1,0,25,74,26,1,25
18,Indiana/IN,1802305,"Marion County--Center Township--Indianapolis City (Central) PUMA, Indiana/IN",18097,"Marion County, Indiana",944523,21367,817,2262,86,1,177,0,41,18,0,0,195,0,41,0,41,41,236,75,8,0,17,0,0,0,17,83,17,0,17
18,Indiana/IN,1802306,"Marion County--Warren & Franklin Townships--Indianapolis City (East & Southeast) PUMA, Indiana/IN",18097,"Marion County, Indiana",944523,21367,817,2262,86,1,243,0,16,0,0,0,243,0,16,0,16,16,259,94,0,0,6,0,0,0,6,94,6,0,6
18,Indiana/IN,1802307,"Marion County--Perry & Decatur (South & East) Townships--Indianapolis City (South) PUMA, Indiana/IN",18097,"Marion County, Indiana",944523,21367,817,2262,86,1,126,0,0,0,0,107,126,0,107,107,0,107,233,54,0,46,0,0,0,46,0,54,46,0,46
18,Indiana/IN,1802400,"Johnson County--Greenwood City PUMA, Indiana/IN",18081,"Johnson County, Indiana",151564,2344,132,1547,87,1,147,0,0,0,0,0,147,0,0,0,0,0,147,100,0,0,0,0,0,0,0,100,0,0,0
18,Indiana/IN,1802500,"Hancock & Shelby Counties PUMA, Indiana/IN",18059,"Hancock County, Indiana",73830,936,46,1268,62,0.625,248,0,0,9,0,0,257,0,0,0,0,0,257,96,4,0,0,0,0,0,0,100,0,0,0
18,Indiana/IN,1802500,"Hancock & Shelby Counties PUMA, Indiana/IN",18145,"Shelby County, Indiana",44399,1157,37,2606,83,0.375,148,0,0,6,0,0,154,0,0,0,0,0,154,96,4,0,0,0,0,0,0,100,0,0,0
18,Indiana/IN,1802600,"Wayne, Fayette, Rush & Union Counties PUMA, Indiana/IN",18041,"Fayette County, Indiana",23259,533,13,2292,56,0.205,144,7,7,1,0,0,145,7,7,0,14,14,159,91,1,0,9,0,4,0,4,91,9,4,4
18,Indiana/IN,1802600,"Wayne, Fayette, Rush & Union Counties PUMA, Indiana/IN",18139,"Rush County, Indiana",16704,199,4,1191,24,0.146,102,5,5,1,0,0,103,5,5,0,10,10,113,90,1,0,9,0,4,0,4,91,9,4,4
18,Indiana/IN,1802600,"Wayne, Fayette, Rush & Union Counties PUMA, Indiana/IN",18161,"Union County, Indiana",7153,104,0,1454,0,0.063,44,2,2,0,0,0,44,2,2,0,4,4,48,92,0,0,8,0,4,0,4,92,8,4,4
18,Indiana/IN,1802600,"Wayne, Fayette, Rush & Union Counties PUMA, Indiana/IN",18177,"Wayne County, Indiana",66613,1113,14,1671,21,0.585,410,20,19,2,0,0,412,20,19,0,39,39,451,91,0,0,9,0,4,0,4,91,9,4,4
18,Indiana/IN,1802700,"Greene, Daviess, Owen, Orange & Martin Counties PUMA, Indiana/IN",18027,"Daviess County, Indiana",32937,665,30,2019,91,0.205,211,20,45,0,10,4,211,30,49,14,65,79,290,73,0,5,22,3,7,1,16,73,27,10,17
18,Indiana/IN,1802700,"Greene, Daviess, Owen, Orange & Martin Counties PUMA, Indiana/IN",18055,"Greene County, Indiana",32295,429,38,1328,118,0.2,206,20,44,0,10,4,206,30,48,14,64,78,284,73,0,5,23,4,7,1,15,73,27,11,17
18,Indiana/IN,1802700,"Greene, Daviess, Owen, Orange & Martin Counties PUMA, Indiana/IN",18093,"Lawrence County, Indiana",45619,513,31,1125,68,0.283,291,28,62,0,14,6,291,42,68,20,90,110,401,73,0,5,22,3,7,1,15,73,27,10,17
18,Indiana/IN,1802700,"Greene, Daviess, Owen, Orange & Martin Counties PUMA, Indiana/IN",18101,"Martin County, Indiana",10210,165,0,1616,0,0.063,65,6,14,0,3,1,65,9,15,4,20,24,89,73,0,4,22,3,7,1,16,73,27,10,17
18,Indiana/IN,1802700,"Greene, Daviess, Owen, Orange & Martin Counties PUMA, Indiana/IN",18117,"Orange County, Indiana",19547,290,26,1484,133,0.12,123,12,26,0,6,2,123,18,28,8,38,46,169,73,0,5,22,4,7,1,15,73,27,11,17
18,Indiana/IN,1802700,"Greene, Daviess, Owen, Orange & Martin Counties PUMA, Indiana/IN",18119,"Owen County, Indiana",20878,169,2,809,10,0.129,133,13,28,0,6,3,133,19,31,9,41,50,183,73,0,5,22,3,7,2,15,73,27,10,17
18,Indiana/IN,1802800,"Monroe County--Bloomington City PUMA, Indiana/IN",18105,"Monroe County, Indiana",145403,2565,40,1764,28,1,41,0,0,0,0,0,41,0,0,0,0,0,41,100,0,0,0,0,0,0,0,100,0,0,0
18,Indiana/IN,1802900,"Bartholomew & Jackson Counties--Columbus City PUMA, Indiana/IN",18005,"Bartholomew County, Indiana",81893,1179,61,1440,74,0.649,201,0,55,0,0,0,201,0,55,0,55,55,256,79,0,0,21,0,0,0,21,79,21,0,21
18,Indiana/IN,1802900,"Bartholomew & Jackson Counties--Columbus City PUMA, Indiana/IN",18071,"Jackson County, Indiana",43938,753,10,1714,23,0.351,109,0,29,0,0,0,109,0,29,0,29,29,138,79,0,0,21,0,0,0,21,79,21,0,21
18,Indiana/IN,1803000,"Jefferson, Jennings, Decatur & Scott Counties PUMA, Indiana/IN",18031,"Decatur County, Indiana",26552,485,42,1827,158,0.241,245,8,21,0,0,0,245,8,21,0,29,29,274,89,0,0,11,0,3,0,8,89,11,3,8
18,Indiana/IN,1803000,"Jefferson, Jennings, Decatur & Scott Counties PUMA, Indiana/IN",18077,"Jefferson County, Indiana",32237,249,3,772,9,0.293,298,9,26,0,0,0,298,9,26,0,35,35,333,89,0,0,11,0,3,0,8,89,11,3,8
18,Indiana/IN,1803000,"Jefferson, Jennings, Decatur & Scott Counties PUMA, Indiana/IN",18079,"Jennings County, Indiana",27727,316,14,1140,50,0.251,255,8,22,0,0,0,255,8,22,0,30,30,285,89,0,0,11,0,3,0,8,89,11,3,8
18,Indiana/IN,1803000,"Jefferson, Jennings, Decatur & Scott Counties PUMA, Indiana/IN",18143,"Scott County, Indiana",23743,379,13,1596,55,0.215,218,7,19,0,0,0,218,7,19,0,26,26,244,89,0,0,11,0,3,0,8,89,11,3,8
18,Indiana/IN,1803100,"Dearborn, Franklin, Ripley, Switzerland & Ohio Counties PUMA, Indiana/IN",18029,"Dearborn County, Indiana",49501,667,30,1347,61,0.42,231,0,0,0,0,0,231,0,0,0,0,0,231,100,0,0,0,0,0,0,0,100,0,0,0
18,Indiana/IN,1803100,"Dearborn, Franklin, Ripley, Switzerland & Ohio Counties PUMA, Indiana/IN",18047,"Franklin County, Indiana",22842,317,26,1388,114,0.194,107,0,0,0,0,0,107,0,0,0,0,0,107,100,0,0,0,0,0,0,0,100,0,0,0
18,Indiana/IN,1803100,"Dearborn, Franklin, Ripley, Switzerland & Ohio Counties PUMA, Indiana/IN",18115,"Ohio County, Indiana",5887,78,7,1325,119,0.051,28,0,0,0,0,0,28,0,0,0,0,0,28,100,0,0,0,0,0,0,0,100,0,0,0
18,Indiana/IN,1803100,"Dearborn, Franklin, Ripley, Switzerland & Ohio Counties PUMA, Indiana/IN",18137,"Ripley County, Indiana",28425,297,8,1045,28,0.246,136,0,0,0,0,0,136,0,0,0,0,0,136,100,0,0,0,0,0,0,0,100,0,0,0
18,Indiana/IN,1803100,"Dearborn, Franklin, Ripley, Switzerland & Ohio Counties PUMA, Indiana/IN",18155,"Switzerland County, Indiana",10628,71,0,668,0,0.09,50,0,0,0,0,0,50,0,0,0,0,0,50,100,0,0,0,0,0,0,0,100,0,0,0
18,Indiana/IN,1803200,"Warrick, Gibson & Posey Counties PUMA, Indiana/IN",18051,"Gibson County, Indiana",33596,513,4,1527,12,0.277,195,0,24,0,0,9,195,0,33,9,24,33,228,86,0,4,11,0,0,4,11,86,14,0,14
18,Indiana/IN,1803200,"Warrick, Gibson & Posey Counties PUMA, Indiana/IN",18129,"Posey County, Indiana",25589,324,0,1266,0,0.209,147,0,18,0,0,7,147,0,25,7,18,25,172,85,0,4,10,0,0,4,10,85,15,0,15
18,Indiana/IN,1803200,"Warrick, Gibson & Posey Counties PUMA, Indiana/IN",18173,"Warrick County, Indiana",61928,1282,40,2070,65,0.514,361,0,45,0,0,17,361,0,62,17,45,62,423,85,0,4,11,0,0,4,11,85,15,0,15
18,Indiana/IN,1803300,"Vanderburgh County--Evansville City PUMA, Indiana/IN",18163,"Vanderburgh County, Indiana",181313,3612,30,1992,17,1,1100,14,63,14,0,71,1114,14,134,71,77,148,1262,87,1,6,6,0,1,6,5,88,12,1,11
18,Indiana/IN,1803400,"Dubois, Knox, Spencer, Perry, Pike & Crawford Counties PUMA, Indiana/IN",18025,"Crawford County, Indiana",10581,106,1,1002,9,0.074,97,5,8,5,0,0,102,5,8,0,13,13,115,84,4,0,11,0,4,0,7,89,11,4,7
18,Indiana/IN,1803400,"Dubois, Knox, Spencer, Perry, Pike & Crawford Counties PUMA, Indiana/IN",18037,"Dubois County, Indiana",42418,969,19,2284,45,0.298,389,19,34,20,0,0,409,19,34,0,53,53,462,84,4,0,11,0,4,0,7,89,11,4,7
18,Indiana/IN,1803400,"Dubois, Knox, Spencer, Perry, Pike & Crawford Counties PUMA, Indiana/IN",18083,"Knox County, Indiana",37409,516,9,1379,24,0.264,345,17,30,17,0,0,362,17,30,0,47,47,409,84,4,0,11,0,4,0,7,89,11,4,7
18,Indiana/IN,1803400,"Dubois, Knox, Spencer, Perry, Pike & Crawford Counties PUMA, Indiana/IN",18123,"Perry County, Indiana",19141,232,14,1212,73,0.133,174,8,15,9,0,0,183,8,15,0,23,23,206,84,4,0,11,0,4,0,7,89,11,4,7
18,Indiana/IN,1803400,"Dubois, Knox, Spencer, Perry, Pike & Crawford Counties PUMA, Indiana/IN",18125,"Pike County, Indiana",12411,147,1,1184,8,0.087,114,5,10,6,0,0,120,5,10,0,15,15,135,84,4,0,11,0,4,0,7,89,11,4,7
18,Indiana/IN,1803400,"Dubois, Knox, Spencer, Perry, Pike & Crawford Counties PUMA, Indiana/IN",18147,"Spencer County, Indiana",20526,244,3,1189,15,0.145,189,9,17,10,0,0,199,9,17,0,26,26,225,84,4,0,12,0,4,0,8,88,12,4,8
18,Indiana/IN,1803500,"Floyd, Harrison & Washington Counties PUMA, Indiana/IN",18043,"Floyd County, Indiana",76809,1364,65,1776,85,0.533,287,0,0,41,0,0,328,0,0,0,0,0,328,88,12,0,0,0,0,0,0,100,0,0,0
18,Indiana/IN,1803500,"Floyd, Harrison & Washington Counties PUMA, Indiana/IN",18061,"Harrison County, Indiana",39712,579,26,1458,65,0.276,149,0,0,21,0,0,170,0,0,0,0,0,170,88,12,0,0,0,0,0,0,100,0,0,0
18,Indiana/IN,1803500,"Floyd, Harrison & Washington Counties PUMA, Indiana/IN",18175,"Washington County, Indiana",27827,265,1,952,4,0.192,103,0,0,15,0,0,118,0,0,0,0,0,118,87,13,0,0,0,0,0,0,100,0,0,0
18,Indiana/IN,1803600,"Clark County--Jeffersonville City PUMA, Indiana/IN",18019,"Clark County, Indiana",115702,2231,64,1928,55,1,285,41,51,10,0,0,295,41,51,0,92,92,387,74,3,0,24,0,11,0,13,76,24,11,13
19,Iowa/IA,1900100,"Sioux, Clay, Dickinson, O'Brien, Lyon, Emmet, Palo Alto & Osceola Counties PUMA, Iowa/IA",19041,"Clay County, Iowa",16313,319,4,1955,25,0.137,212,22,79,28,0,5,240,22,84,5,101,106,346,61,8,1,29,0,6,1,23,69,31,6,24
19,Iowa/IA,1900100,"Sioux, Clay, Dickinson, O'Brien, Lyon, Emmet, Palo Alto & Osceola Counties PUMA, Iowa/IA",19059,"Dickinson County, Iowa",17056,510,6,2990,35,0.145,224,23,84,30,0,5,254,23,89,5,107,112,366,61,8,1,29,0,6,1,23,69,31,6,24
19,Iowa/IA,1900100,"Sioux, Clay, Dickinson, O'Brien, Lyon, Emmet, Palo Alto & Osceola Counties PUMA, Iowa/IA",19063,"Emmet County, Iowa",9551,261,10,2733,105,0.081,125,13,47,17,0,3,142,13,50,3,60,63,205,61,8,1,29,0,6,1,23,69,31,6,24
19,Iowa/IA,1900100,"Sioux, Clay, Dickinson, O'Brien, Lyon, Emmet, Palo Alto & Osceola Counties PUMA, Iowa/IA",19119,"Lyon County, Iowa",11769,318,4,2702,34,0.099,153,16,57,20,0,4,173,16,61,4,73,77,250,61,8,2,29,0,6,2,23,69,31,6,24
19,Iowa/IA,1900100,"Sioux, Clay, Dickinson, O'Brien, Lyon, Emmet, Palo Alto & Osceola Counties PUMA, Iowa/IA",19141,"O'Brien County, Iowa",13911,360,9,2588,65,0.118,183,19,68,24,0,4,207,19,72,4,87,91,298,61,8,1,29,0,6,1,23,69,31,6,24
19,Iowa/IA,1900100,"Sioux, Clay, Dickinson, O'Brien, Lyon, Emmet, Palo Alto & Osceola Counties PUMA, Iowa/IA",19143,"Osceola County, Iowa",6115,157,0,2567,0,0.051,79,8,29,11,0,2,90,8,31,2,37,39,129,61,9,2,29,0,6,2,22,70,30,6,24
19,Iowa/IA,1900100,"Sioux, Clay, Dickinson, O'Brien, Lyon, Emmet, Palo Alto & Osceola Counties PUMA, Iowa/IA",19147,"Palo Alto County, Iowa",9055,188,0,2076,0,0.076,118,12,44,16,0,3,134,12,47,3,56,59,193,61,8,2,29,0,6,2,23,69,31,6,24
19,Iowa/IA,1900100,"Sioux, Clay, Dickinson, O'Brien, Lyon, Emmet, Palo Alto & Osceola Counties PUMA, Iowa/IA",19167,"Sioux County, Iowa",34825,1565,3,4494,9,0.293,454,47,169,60,0,11,514,47,180,11,216,227,741,61,8,1,29,0,6,1,23,69,31,6,24
19,Iowa/IA,1900200,"Cerro Gordo, Floyd, Kossuth, Hancock, Winnebago, Mitchell & Worth Counties PUMA, Iowa/IA",19033,"Cerro Gordo County, Iowa",42984,1051,21,2445,49,0.378,730,9,11,11,14,7,741,23,18,21,20,41,782,93,1,3,3,2,1,1,1,95,5,3,2
19,Iowa/IA,1900200,"Cerro Gordo, Floyd, Kossuth, Hancock, Winnebago, Mitchell & Worth Counties PUMA, Iowa/IA",19067,"Floyd County, Iowa",15858,342,3,2157,19,0.139,268,3,4,4,5,3,272,8,7,8,7,15,287,93,1,3,2,2,1,1,1,95,5,3,2
19,Iowa/IA,1900200,"Cerro Gordo, Floyd, Kossuth, Hancock, Winnebago, Mitchell & Worth Counties PUMA, Iowa/IA",19081,"Hancock County, Iowa",10888,184,2,1690,18,0.095,183,2,3,3,4,2,186,6,5,6,5,11,197,93,2,3,3,2,1,1,2,94,6,3,3
19,Iowa/IA,1900200,"Cerro Gordo, Floyd, Kossuth, Hancock, Winnebago, Mitchell & Worth Counties PUMA, Iowa/IA",19109,"Kossuth County, Iowa",15075,265,0,1758,0,0.133,257,3,4,4,5,3,261,8,7,8,7,15,276,93,1,3,3,2,1,1,1,95,5,3,3
19,Iowa/IA,1900200,"Cerro Gordo, Floyd, Kossuth, Hancock, Winnebago, Mitchell & Worth Counties PUMA, Iowa/IA",19131,"Mitchell County, Iowa",10631,189,0,1778,0,0.095,183,2,3,3,4,2,186,6,5,6,5,11,197,93,2,3,3,2,1,1,2,94,6,3,3
19,Iowa/IA,1900200,"Cerro Gordo, Floyd, Kossuth, Hancock, Winnebago, Mitchell & Worth Counties PUMA, Iowa/IA",19189,"Winnebago County, Iowa",10571,301,13,2847,123,0.093,180,2,3,3,4,2,183,6,5,6,5,11,194,93,2,3,3,2,1,1,2,94,6,3,3
19,Iowa/IA,1900200,"Cerro Gordo, Floyd, Kossuth, Hancock, Winnebago, Mitchell & Worth Counties PUMA, Iowa/IA",19195,"Worth County, Iowa",7489,107,0,1429,0,0.067,129,2,2,2,3,1,131,5,3,4,4,8,139,93,1,3,3,2,1,1,1,94,6,4,2
19,Iowa/IA,1900400,"Bremer, Winneshiek, Fayette, Clayton, Allamakee, Chickasaw & Howard Counties PUMA, Iowa/IA",19005,"Allamakee County, Iowa",13880,259,6,1866,43,0.117,215,3,33,3,0,14,218,3,47,14,36,50,268,80,1,5,13,0,1,5,12,81,19,1,18
19,Iowa/IA,1900400,"Bremer, Winneshiek, Fayette, Clayton, Allamakee, Chickasaw & Howard Counties PUMA, Iowa/IA",19017,"Bremer County, Iowa",24782,488,7,1969,28,0.21,386,6,60,6,0,25,392,6,85,25,66,91,483,80,1,5,14,0,1,5,12,81,19,1,18
19,Iowa/IA,1900400,"Bremer, Winneshiek, Fayette, Clayton, Allamakee, Chickasaw & Howard Counties PUMA, Iowa/IA",19037,"Chickasaw County, Iowa",12099,246,0,2033,0,0.102,188,3,29,3,0,12,191,3,41,12,32,44,235,80,1,5,14,0,1,5,12,81,19,1,17
19,Iowa/IA,1900400,"Bremer, Winneshiek, Fayette, Clayton, Allamakee, Chickasaw & Howard Counties PUMA, Iowa/IA",19043,"Clayton County, Iowa",17672,252,3,1426,17,0.149,274,4,42,4,0,18,278,4,60,18,46,64,342,80,1,5,13,0,1,5,12,81,19,1,18
19,Iowa/IA,1900400,"Bremer, Winneshiek, Fayette, Clayton, Allamakee, Chickasaw & Howard Counties PUMA, Iowa/IA",19065,"Fayette County, Iowa",19929,217,2,1089,10,0.17,313,5,48,5,0,21,318,5,69,21,53,74,392,80,1,5,14,0,1,5,12,81,19,1,18
19,Iowa/IA,1900400,"Bremer, Winneshiek, Fayette, Clayton, Allamakee, Chickasaw & Howard Counties PUMA, Iowa/IA",19089,"Howard County, Iowa",9264,187,6,2019,65,0.079,145,2,23,2,0,10,147,2,33,10,25,35,182,80,1,5,14,0,1,5,13,81,19,1,18
19,Iowa/IA,1900400,"Bremer, Winneshiek, Fayette, Clayton, Allamakee, Chickasaw & Howard Counties PUMA, Iowa/IA",19191,"Winneshiek County, Iowa",20401,330,6,1618,29,0.174,320,5,50,5,0,21,325,5,71,21,55,76,401,80,1,5,14,0,1,5,12,81,19,1,18
19,Iowa/IA,1900500,"Black Hawk County--Waterloo & Cedar Falls Cities PUMA, Iowa/IA",19013,"Black Hawk County, Iowa",133009,4472,90,3362,68,1,1102,256,347,189,104,409,1291,360,756,513,603,1116,2407,46,8,21,25,4,11,17,14,54,46,15,31
19,Iowa/IA,1900600,"Webster, Hardin, Hamilton, Butler, Wright, Grundy, Franklin & Humboldt Counties PUMA, Iowa/IA",19023,"Butler County, Iowa",14735,270,2,1832,14,0.115,262,3,23,10,0,0,272,3,23,0,26,26,298,88,3,0,9,0,1,0,8,91,9,1,8
19,Iowa/IA,1900600,"Webster, Hardin, Hamilton, Butler, Wright, Grundy, Franklin & Humboldt Counties PUMA, Iowa/IA",19069,"Franklin County, Iowa",10245,347,18,3387,176,0.079,180,2,16,7,0,0,187,2,16,0,18,18,205,88,3,0,9,0,1,0,8,91,9,1,8
19,Iowa/IA,1900600,"Webster, Hardin, Hamilton, Butler, Wright, Grundy, Franklin & Humboldt Counties PUMA, Iowa/IA",19075,"Grundy County, Iowa",12341,219,3,1775,24,0.096,218,3,19,9,0,0,227,3,19,0,22,22,249,88,4,0,9,0,1,0,8,91,9,1,8
19,Iowa/IA,1900600,"Webster, Hardin, Hamilton, Butler, Wright, Grundy, Franklin & Humboldt Counties PUMA, Iowa/IA",19079,"Hamilton County, Iowa",15110,322,3,2131,20,0.117,266,3,24,10,0,0,276,3,24,0,27,27,303,88,3,0,9,0,1,0,8,91,9,1,8
19,Iowa/IA,1900600,"Webster, Hardin, Hamilton, Butler, Wright, Grundy, Franklin & Humboldt Counties PUMA, Iowa/IA",19083,"Hardin County, Iowa",17127,299,1,1746,6,0.134,305,4,27,12,0,0,317,4,27,0,31,31,348,88,3,0,9,0,1,0,8,91,9,1,8
19,Iowa/IA,1900600,"Webster, Hardin, Hamilton, Butler, Wright, Grundy, Franklin & Humboldt Counties PUMA, Iowa/IA",19091,"Humboldt County, Iowa",9566,188,3,1965,31,0.074,168,2,15,7,0,0,175,2,15,0,17,17,192,88,4,0,9,0,1,0,8,91,9,1,8
19,Iowa/IA,1900600,"Webster, Hardin, Hamilton, Butler, Wright, Grundy, Franklin & Humboldt Counties PUMA, Iowa/IA",19187,"Webster County, Iowa",36757,1251,14,3403,38,0.286,651,8,58,25,0,0,676,8,58,0,66,66,742,88,3,0,9,0,1,0,8,91,9,1,8
19,Iowa/IA,1900600,"Webster, Hardin, Hamilton, Butler, Wright, Grundy, Franklin & Humboldt Counties PUMA, Iowa/IA",19197,"Wright County, Iowa",12804,581,1,4538,8,0.099,225,3,20,9,0,0,234,3,20,0,23,23,257,88,4,0,9,0,1,0,8,91,9,1,8
19,Iowa/IA,1900700,"Dubuque, Buchanan, Jackson & Delaware Counties--Dubuque City PUMA, Iowa/IA",19019,"Buchanan County, Iowa",21125,274,1,1297,5,0.136,206,0,15,0,3,0,206,3,15,3,15,18,224,92,0,1,7,1,0,0,7,92,8,1,7
19,Iowa/IA,1900700,"Dubuque, Buchanan, Jackson & Delaware Counties--Dubuque City PUMA, Iowa/IA",19055,"Delaware County, Iowa",17258,397,3,2300,17,0.112,169,0,12,0,2,0,169,2,12,2,12,14,183,92,0,1,7,1,0,0,7,92,8,1,7
19,Iowa/IA,1900700,"Dubuque, Buchanan, Jackson & Delaware Counties--Dubuque City PUMA, Iowa/IA",19061,"Dubuque County, Iowa",96802,3173,41,3278,42,0.627,948,0,70,0,13,0,948,13,70,13,70,83,1031,92,0,1,7,1,0,0,7,92,8,1,7
19,Iowa/IA,1900700,"Dubuque, Buchanan, Jackson & Delaware Counties--Dubuque City PUMA, Iowa/IA",19097,"Jackson County, Iowa",19395,337,3,1738,15,0.126,191,0,14,0,3,0,191,3,14,3,14,17,208,92,0,1,7,1,0,0,7,92,8,1,7
19,Iowa/IA,1900800,"Clinton, Muscatine, Jones & Cedar Counties PUMA, Iowa/IA",19031,"Cedar County, Iowa",18445,241,1,1307,5,0.143,252,18,37,65,3,11,317,21,48,14,55,69,386,65,17,4,14,1,5,3,10,82,18,5,12
19,Iowa/IA,1900800,"Clinton, Muscatine, Jones & Cedar Counties PUMA, Iowa/IA",19045,"Clinton County, Iowa",47218,1112,21,2355,44,0.366,645,47,94,168,8,29,813,55,123,37,141,178,991,65,17,4,14,1,5,3,9,82,18,6,12
19,Iowa/IA,1900800,"Clinton, Muscatine, Jones & Cedar Counties PUMA, Iowa/IA",19105,"Jones County, Iowa",20568,269,3,1308,15,0.158,278,20,41,72,3,12,350,23,53,15,61,76,426,65,17,4,14,1,5,3,10,82,18,5,12
19,Iowa/IA,1900800,"Clinton, Muscatine, Jones & Cedar Counties PUMA, Iowa/IA",19139,"Muscatine County, Iowa",42950,1100,54,2561,126,0.333,587,43,86,153,7,26,740,50,112,33,129,162,902,65,17,4,14,1,5,3,10,82,18,6,12
19,Iowa/IA,1900900,"Scott County--Davenport City PUMA, Iowa/IA",19163,"Scott County, Iowa",172288,2971,28,1724,16,1,1106,28,82,98,90,62,1204,118,144,152,110,262,1466,75,7,10,8,6,2,4,6,82,18,8,10
19,Iowa/IA,1901000,"Linn County--Cedar Rapids City PUMA, Iowa/IA",19113,"Linn County, Iowa",222121,3973,111,1789,50,1,1585,59,127,74,0,242,1659,59,369,242,186,428,2087,76,4,12,9,0,3,12,6,79,21,3,18
19,Iowa/IA,1901100,"Johnson County--Iowa City PUMA, Iowa/IA",19103,"Johnson County, Iowa",147001,5100,27,3469,18,1,520,0,0,85,0,333,605,0,333,333,0,333,938,55,9,36,0,0,0,36,0,64,36,0,36
19,Iowa/IA,1901200,"Marshall, Benton, Poweshiek, Tama & Iowa Counties PUMA, Iowa/IA",19011,"Benton County, Iowa",25626,309,1,1206,4,0.217,413,64,188,55,7,115,468,71,303,122,252,374,842,49,7,14,30,1,8,14,22,56,44,8,36
19,Iowa/IA,1901200,"Marshall, Benton, Poweshiek, Tama & Iowa Counties PUMA, Iowa/IA",19095,"Iowa County, Iowa",16207,204,1,1259,6,0.138,262,41,120,35,4,73,297,45,193,77,161,238,535,49,7,14,30,1,8,14,22,56,44,8,36
19,Iowa/IA,1901200,"Marshall, Benton, Poweshiek, Tama & Iowa Counties PUMA, Iowa/IA",19127,"Marshall County, Iowa",40271,1777,34,4413,84,0.341,648,101,296,87,10,181,735,111,477,191,397,588,1323,49,7,14,30,1,8,14,22,56,44,8,36
19,Iowa/IA,1901200,"Marshall, Benton, Poweshiek, Tama & Iowa Counties PUMA, Iowa/IA",19157,"Poweshiek County, Iowa",18605,292,8,1569,43,0.157,298,46,136,40,5,83,338,51,219,88,182,270,608,49,7,14,30,1,8,14,22,56,44,8,36
19,Iowa/IA,1901200,"Marshall, Benton, Poweshiek, Tama & Iowa Counties PUMA, Iowa/IA",19171,"Tama County, Iowa",17136,708,31,4132,181,0.147,279,44,128,37,4,78,316,48,206,82,172,254,570,49,6,14,30,1,8,14,22,55,45,8,36
19,Iowa/IA,1901300,"Story & Boone Counties--Ames City PUMA, Iowa/IA",19015,"Boone County, Iowa",26399,505,8,1913,30,0.215,175,0,8,0,5,0,175,5,8,5,8,13,188,93,0,3,4,3,0,0,4,93,7,3,4
19,Iowa/IA,1901300,"Story & Boone Counties--Ames City PUMA, Iowa/IA",19169,"Story County, Iowa",96922,3429,17,3538,18,0.785,640,0,31,0,16,0,640,16,31,16,31,47,687,93,0,2,5,2,0,0,5,93,7,2,5
19,Iowa/IA,1901400,"Warren, Jasper, Marion, Dallas (West) & Madison Counties PUMA, Iowa/IA",19049,"Dallas County, Iowa",84002,2771,38,3299,45,0.164,176,34,16,19,21,31,195,55,47,52,50,102,297,59,6,18,17,7,11,10,5,66,34,19,16
19,Iowa/IA,1901400,"Warren, Jasper, Marion, Dallas (West) & Madison Counties PUMA, Iowa/IA",19099,"Jasper County, Iowa",36891,833,32,2258,87,0.227,243,47,22,26,29,42,269,76,64,71,69,140,409,59,6,17,17,7,11,10,5,66,34,19,16
19,Iowa/IA,1901400,"Warren, Jasper, Marion, Dallas (West) & Madison Counties PUMA, Iowa/IA",19121,"Madison County, Iowa",15890,212,2,1334,13,0.098,105,20,10,11,12,18,116,32,28,30,30,60,176,60,6,17,17,7,11,10,6,66,34,18,16
19,Iowa/IA,1901400,"Warren, Jasper, Marion, Dallas (West) & Madison Counties PUMA, Iowa/IA",19125,"Marion County, Iowa",33207,756,7,2277,21,0.205,220,43,20,24,26,38,244,69,58,64,63,127,371,59,6,17,17,7,12,10,5,66,34,19,16
19,Iowa/IA,1901400,"Warren, Jasper, Marion, Dallas (West) & Madison Counties PUMA, Iowa/IA",19181,"Warren County, Iowa",49361,951,6,1927,12,0.307,329,64,30,36,39,57,365,103,87,96,94,190,555,59,6,17,17,7,12,10,5,66,34,19,16
19,Iowa/IA,1901500,"Polk (Southwest) & Dallas (East) Counties--West Des Moines & Urbandale Cities PUMA, Iowa/IA",19049,"Dallas County, Iowa",84002,2771,38,3299,45,0.305,178,0,13,11,0,0,189,0,13,0,13,13,202,88,5,0,6,0,0,0,6,94,6,0,6
19,Iowa/IA,1901500,"Polk (Southwest) & Dallas (East) Counties--West Des Moines & Urbandale Cities PUMA, Iowa/IA",19153,"Polk County, Iowa",474274,15779,262,3327,55,0.695,404,0,31,24,0,0,428,0,31,0,31,31,459,88,5,0,7,0,0,0,7,93,7,0,7
19,Iowa/IA,1901600,"Polk County (East)--Ankeny & Altoona Cities PUMA, Iowa/IA",19153,"Polk County, Iowa",474274,15779,262,3327,55,1,510,0,0,66,0,0,576,0,0,0,0,0,576,89,11,0,0,0,0,0,0,100,0,0,0
19,Iowa/IA,1901700,"Des Moines City PUMA, Iowa/IA",19153,"Polk County, Iowa",474274,15779,262,3327,55,1,578,66,282,9,121,1173,587,187,1455,1294,348,1642,2229,26,0,58,16,5,3,53,13,26,74,8,65
19,Iowa/IA,1901800,"South Central Iowa PUMA, Iowa/IA",19001,"Adair County, Iowa",7124,71,1,997,14,0.068,140,1,9,7,4,1,147,5,10,5,10,15,162,86,4,3,6,2,1,1,6,91,9,3,6
19,Iowa/IA,1901800,"South Central Iowa PUMA, Iowa/IA",19003,"Adams County, Iowa",3726,33,0,886,0,0.036,74,0,5,4,2,0,78,2,5,2,5,7,85,87,5,2,6,2,0,0,6,92,8,2,6
19,Iowa/IA,1901800,"South Central Iowa PUMA, Iowa/IA",19007,"Appanoose County, Iowa",12510,136,3,1087,24,0.12,248,1,16,13,7,1,261,8,17,8,17,25,286,87,5,3,6,2,0,0,6,91,9,3,6
19,Iowa/IA,1901800,"South Central Iowa PUMA, Iowa/IA",19009,"Audubon County, Iowa",5637,82,1,1455,18,0.055,114,0,7,6,3,0,120,3,7,3,7,10,130,88,5,2,5,2,0,0,5,92,8,2,5
19,Iowa/IA,1901800,"South Central Iowa PUMA, Iowa/IA",19039,"Clarke County, Iowa",9282,265,3,2855,32,0.09,186,1,12,10,6,1,196,7,13,7,13,20,216,86,5,3,6,3,0,0,6,91,9,3,6
19,Iowa/IA,1901800,"South Central Iowa PUMA, Iowa/IA",19053,"Decatur County, Iowa",8044,67,0,833,0,0.079,163,1,11,9,5,1,172,6,12,6,12,18,190,86,5,3,6,3,1,1,6,91,9,3,6
19,Iowa/IA,1901800,"South Central Iowa PUMA, Iowa/IA",19077,"Guthrie County, Iowa",10674,244,6,2286,56,0.102,211,1,14,11,6,1,222,7,15,7,15,22,244,86,5,3,6,2,0,0,6,91,9,3,6
19,Iowa/IA,1901800,"South Central Iowa PUMA, Iowa/IA",19117,"Lucas County, Iowa",8597,156,6,1815,70,0.083,171,1,11,9,5,1,180,6,12,6,12,18,198,86,5,3,6,3,1,1,6,91,9,3,6
19,Iowa/IA,1901800,"South Central Iowa PUMA, Iowa/IA",19135,"Monroe County, Iowa",7863,157,10,1997,127,0.076,157,1,10,8,5,1,165,6,11,6,11,17,182,86,4,3,6,3,1,1,5,91,9,3,6
19,Iowa/IA,1901800,"South Central Iowa PUMA, Iowa/IA",19159,"Ringgold County, Iowa",4984,50,2,1003,40,0.049,101,0,7,5,3,0,106,3,7,3,7,10,116,87,4,3,6,3,0,0,6,91,9,3,6
19,Iowa/IA,1901800,"South Central Iowa PUMA, Iowa/IA",19173,"Taylor County, Iowa",6201,127,1,2048,16,0.06,124,1,8,6,4,1,130,5,9,5,9,14,144,86,4,3,6,3,1,1,6,90,10,3,6
19,Iowa/IA,1901800,"South Central Iowa PUMA, Iowa/IA",19175,"Union County, Iowa",12453,131,3,1052,24,0.12,248,1,16,13,7,1,261,8,17,8,17,25,286,87,5,3,6,2,0,0,6,91,9,3,6
19,Iowa/IA,1901800,"South Central Iowa PUMA, Iowa/IA",19185,"Wayne County, Iowa",6413,86,2,1341,31,0.062,128,1,8,7,4,1,135,5,9,5,9,14,149,86,5,3,6,3,1,1,5,91,9,3,6
19,Iowa/IA,1901900,"Northwest Central Iowa--Storm Lake, Denison & Cherokee Region PUMA, Iowa/IA",19021,"Buena Vista County, Iowa",20260,1984,12,9793,59,0.168,516,140,307,36,88,80,552,228,387,168,447,615,1167,44,3,14,38,8,12,7,26,47,53,20,33
19,Iowa/IA,1901900,"Northwest Central Iowa--Storm Lake, Denison & Cherokee Region PUMA, Iowa/IA",19025,"Calhoun County, Iowa",9780,182,3,1861,31,0.082,252,68,150,17,43,39,269,111,189,82,218,300,569,44,3,14,38,8,12,7,26,47,53,20,33
19,Iowa/IA,1901900,"Northwest Central Iowa--Storm Lake, Denison & Cherokee Region PUMA, Iowa/IA",19027,"Carroll County, Iowa",20344,660,5,3244,25,0.169,519,140,308,36,89,80,555,229,388,169,448,617,1172,44,3,14,38,8,12,7,26,47,53,20,33
19,Iowa/IA,1901900,"Northwest Central Iowa--Storm Lake, Denison & Cherokee Region PUMA, Iowa/IA",19035,"Cherokee County, Iowa",11468,246,2,2145,17,0.095,292,79,173,20,50,45,312,129,218,95,252,347,659,44,3,14,38,8,12,7,26,47,53,20,33
19,Iowa/IA,1901900,"Northwest Central Iowa--Storm Lake, Denison & Cherokee Region PUMA, Iowa/IA",19047,"Crawford County, Iowa",17132,1077,5,6286,29,0.14,430,116,256,30,73,66,460,189,322,139,372,511,971,44,3,14,38,8,12,7,26,47,53,19,33
19,Iowa/IA,1901900,"Northwest Central Iowa--Storm Lake, Denison & Cherokee Region PUMA, Iowa/IA",19073,"Greene County, Iowa",9003,100,0,1111,0,0.075,230,62,137,16,39,36,246,101,173,75,199,274,520,44,3,14,38,8,12,7,26,47,53,19,33
19,Iowa/IA,1901900,"Northwest Central Iowa--Storm Lake, Denison & Cherokee Region PUMA, Iowa/IA",19093,"Ida County, Iowa",6916,120,1,1735,14,0.058,178,48,106,12,30,27,190,78,133,57,154,211,401,44,3,14,38,7,12,7,26,47,53,19,33
19,Iowa/IA,1901900,"Northwest Central Iowa--Storm Lake, Denison & Cherokee Region PUMA, Iowa/IA",19133,"Monona County, Iowa",8796,150,1,1705,11,0.074,227,61,135,16,39,35,243,100,170,74,196,270,513,44,3,14,38,8,12,7,26,47,53,19,33
19,Iowa/IA,1901900,"Northwest Central Iowa--Storm Lake, Denison & Cherokee Region PUMA, Iowa/IA",19151,"Pocahontas County, Iowa",6898,157,2,2276,29,0.057,175,47,104,12,30,27,187,77,131,57,151,208,395,44,3,14,38,8,12,7,26,47,53,19,33
19,Iowa/IA,1901900,"Northwest Central Iowa--Storm Lake, Denison & Cherokee Region PUMA, Iowa/IA",19161,"Sac County, Iowa",9868,248,0,2513,0,0.082,252,68,150,17,43,39,269,111,189,82,218,300,569,44,3,14,38,8,12,7,26,47,53,20,33
19,Iowa/IA,1902000,"Woodbury & Plymouth Counties--Sioux City PUMA, Iowa/IA",19149,"Plymouth County, Iowa",25039,1122,20,4481,80,0.197,435,193,168,80,60,100,515,253,268,160,361,521,1036,42,8,15,35,6,19,10,16,50,50,24,26
19,Iowa/IA,1902000,"Woodbury & Plymouth Counties--Sioux City PUMA, Iowa/IA",19193,"Woodbury County, Iowa",102398,5356,64,5231,63,0.803,1773,785,687,327,243,407,2100,1028,1094,650,1472,2122,4222,42,8,15,35,6,19,10,16,50,50,24,26
19,Iowa/IA,1902100,"Southwest Iowa--Council Bluffs City PUMA, Iowa/IA",19029,"Cass County, Iowa",13191,163,2,1236,15,0.073,182,10,40,5,2,4,187,12,44,6,50,56,243,75,2,2,21,1,4,2,16,77,23,5,18
19,Iowa/IA,1902100,"Southwest Iowa--Council Bluffs City PUMA, Iowa/IA",19071,"Fremont County, Iowa",6968,115,0,1650,0,0.039,97,5,21,3,1,2,100,6,23,3,26,29,129,75,2,2,20,1,4,2,16,78,22,5,18
19,Iowa/IA,1902100,"Southwest Iowa--Council Bluffs City PUMA, Iowa/IA",19085,"Harrison County, Iowa",14143,214,3,1513,21,0.079,197,10,43,6,2,5,203,12,48,7,53,60,263,75,2,3,20,1,4,2,16,77,23,5,18
19,Iowa/IA,1902100,"Southwest Iowa--Council Bluffs City PUMA, Iowa/IA",19129,"Mills County, Iowa",14957,178,1,1190,7,0.083,207,11,45,6,2,5,213,13,50,7,56,63,276,75,2,3,20,1,4,2,16,77,23,5,18
19,Iowa/IA,1902100,"Southwest Iowa--Council Bluffs City PUMA, Iowa/IA",19137,"Montgomery County, Iowa",10155,92,5,906,49,0.057,142,7,31,4,2,3,146,9,34,5,38,43,189,75,2,3,20,1,4,2,16,77,23,5,18
19,Iowa/IA,1902100,"Southwest Iowa--Council Bluffs City PUMA, Iowa/IA",19145,"Page County, Iowa",15363,154,0,1002,0,0.085,212,11,46,6,2,5,218,13,51,7,57,64,282,75,2,2,20,1,4,2,16,77,23,5,18
19,Iowa/IA,1902100,"Southwest Iowa--Council Bluffs City PUMA, Iowa/IA",19155,"Pottawattamie County, Iowa",93503,2089,38,2234,41,0.519,1296,68,282,38,14,30,1334,82,312,44,350,394,1728,75,2,3,20,1,4,2,16,77,23,5,18
19,Iowa/IA,1902100,"Southwest Iowa--Council Bluffs City PUMA, Iowa/IA",19165,"Shelby County, Iowa",11694,265,1,2266,9,0.065,162,9,35,5,2,4,167,11,39,6,44,50,217,75,2,3,20,1,4,2,16,77,23,5,18
19,Iowa/IA,1902200,"Wapello, Mahaska, Washington, Jefferson, Keokuk, Davis & Van Buren Counties PUMA, Iowa/IA",19051,"Davis County, Iowa",8885,124,4,1396,45,0.072,186,35,23,10,4,10,196,39,33,14,58,72,268,69,4,5,22,1,13,4,9,73,27,15,12
19,Iowa/IA,1902200,"Wapello, Mahaska, Washington, Jefferson, Keokuk, Davis & Van Buren Counties PUMA, Iowa/IA",19101,"Jefferson County, Iowa",18077,138,1,763,6,0.146,376,72,46,21,9,19,397,81,65,28,118,146,543,69,4,5,22,2,13,3,8,73,27,15,12
19,Iowa/IA,1902200,"Wapello, Mahaska, Washington, Jefferson, Keokuk, Davis & Van Buren Counties PUMA, Iowa/IA",19107,"Keokuk County, Iowa",10200,107,1,1049,10,0.082,211,40,26,12,5,11,223,45,37,16,66,82,305,69,4,5,22,2,13,4,9,73,27,15,12
19,Iowa/IA,1902200,"Wapello, Mahaska, Washington, Jefferson, Keokuk, Davis & Van Buren Counties PUMA, Iowa/IA",19123,"Mahaska County, Iowa",22208,406,19,1828,86,0.179,461,88,56,25,11,24,486,99,80,35,144,179,665,69,4,5,22,2,13,4,8,73,27,15,12
19,Iowa/IA,1902200,"Wapello, Mahaska, Washington, Jefferson, Keokuk, Davis & Van Buren Counties PUMA, Iowa/IA",19177,"Van Buren County, Iowa",7223,114,1,1578,14,0.059,152,29,18,8,4,8,160,33,26,12,47,59,219,69,4,5,21,2,13,4,8,73,27,15,12
19,Iowa/IA,1902200,"Wapello, Mahaska, Washington, Jefferson, Keokuk, Davis & Van Buren Counties PUMA, Iowa/IA",19179,"Wapello County, Iowa",35315,1328,57,3760,161,0.283,730,139,89,40,17,38,770,156,127,55,228,283,1053,69,4,5,22,2,13,4,8,73,27,15,12
19,Iowa/IA,1902200,"Wapello, Mahaska, Washington, Jefferson, Keokuk, Davis & Van Buren Counties PUMA, Iowa/IA",19183,"Washington County, Iowa",22143,456,11,2059,50,0.18,464,88,56,25,11,24,489,99,80,35,144,179,668,69,4,5,22,2,13,4,8,73,27,15,12
19,Iowa/IA,1902300,"Des Moines, Lee, Henry & Louisa Counties PUMA, Iowa/IA",19057,"Des Moines County, Iowa",39600,774,8,1955,20,0.377,700,24,75,68,22,13,768,46,88,35,99,134,902,78,8,4,11,2,3,1,8,85,15,5,10
19,Iowa/IA,1902300,"Des Moines, Lee, Henry & Louisa Counties PUMA, Iowa/IA",19087,"Henry County, Iowa",19926,730,5,3664,25,0.188,349,12,37,34,11,6,383,23,43,17,49,66,449,78,8,4,11,2,3,1,8,85,15,5,10
19,Iowa/IA,1902300,"Des Moines, Lee, Henry & Louisa Counties PUMA, Iowa/IA",19111,"Lee County, Iowa",34541,624,7,1807,20,0.329,611,21,65,59,19,11,670,40,76,30,86,116,786,78,8,4,11,2,3,1,8,85,15,5,10
19,Iowa/IA,1902300,"Des Moines, Lee, Henry & Louisa Counties PUMA, Iowa/IA",19115,"Louisa County, Iowa",11223,428,15,3814,134,0.106,197,7,21,19,6,4,216,13,25,10,28,38,254,78,7,4,11,2,3,2,8,85,15,5,10
20,Kansas/KS,2000100,"Northwest Kansas PUMA, Kansas/KS",20023,"Cheyenne County, Kansas",2677,56,0,2092,0,0.024,40,1,7,7,0,0,47,1,7,0,8,8,55,73,13,0,15,0,2,0,13,85,15,2,13
20,Kansas/KS,2000100,"Northwest Kansas PUMA, Kansas/KS",20039,"Decatur County, Kansas",2881,22,0,764,0,0.026,43,1,7,7,0,0,50,1,7,0,8,8,58,74,12,0,14,0,2,0,12,86,14,2,12
20,Kansas/KS,2000100,"Northwest Kansas PUMA, Kansas/KS",20051,"Ellis County, Kansas",28878,970,3,3359,10,0.265,441,12,73,72,0,3,513,12,76,3,85,88,601,73,12,0,14,0,2,0,12,85,15,2,13
20,Kansas/KS,2000100,"Northwest Kansas PUMA, Kansas/KS",20063,"Gove County, Kansas",2619,29,0,1107,0,0.024,40,1,7,7,0,0,47,1,7,0,8,8,55,73,13,0,15,0,2,0,13,85,15,2,13
20,Kansas/KS,2000100,"Northwest Kansas PUMA, Kansas/KS",20065,"Graham County, Kansas",2545,36,1,1415,39,0.024,40,1,7,7,0,0,47,1,7,0,8,8,55,73,13,0,15,0,2,0,13,85,15,2,13
20,Kansas/KS,2000100,"Northwest Kansas PUMA, Kansas/KS",20071,"Greeley County, Kansas",1200,8,0,667,0,0.012,20,1,3,3,0,0,23,1,3,0,4,4,27,74,11,0,15,0,4,0,11,85,15,4,11
20,Kansas/KS,2000100,"Northwest Kansas PUMA, Kansas/KS",20101,"Lane County, Kansas",1642,13,0,792,0,0.015,25,1,4,4,0,0,29,1,4,0,5,5,34,74,12,0,15,0,3,0,12,85,15,3,12
20,Kansas/KS,2000100,"Northwest Kansas PUMA, Kansas/KS",20109,"Logan County, Kansas",2810,14,0,498,0,0.026,43,1,7,7,0,0,50,1,7,0,8,8,58,74,12,0,14,0,2,0,12,86,14,2,12
20,Kansas/KS,2000100,"Northwest Kansas PUMA, Kansas/KS",20135,"Ness County, Kansas",2955,75,6,2538,203,0.027,45,1,7,7,0,0,52,1,7,0,8,8,60,75,12,0,13,0,2,0,12,87,13,2,12
20,Kansas/KS,2000100,"Northwest Kansas PUMA, Kansas/KS",20137,"Norton County, Kansas",5486,31,0,565,0,0.05,83,2,14,14,0,1,97,2,15,1,16,17,114,73,12,1,14,0,2,1,12,85,15,2,13
20,Kansas/KS,2000100,"Northwest Kansas PUMA, Kansas/KS",20141,"Osborne County, Kansas",3603,7,0,194,0,0.033,55,1,9,9,0,0,64,1,9,0,10,10,74,74,12,0,14,0,1,0,12,86,14,1,12
20,Kansas/KS,2000100,"Northwest Kansas PUMA, Kansas/KS",20147,"Phillips County, Kansas",5408,116,8,2145,148,0.05,83,2,14,14,0,1,97,2,15,1,16,17,114,73,12,1,14,0,2,1,12,85,15,2,13
20,Kansas/KS,2000100,"Northwest Kansas PUMA, Kansas/KS",20153,"Rawlins County, Kansas",2509,34,0,1355,0,0.023,38,1,6,6,0,0,44,1,6,0,7,7,51,75,12,0,14,0,2,0,12,86,14,2,12
20,Kansas/KS,2000100,"Northwest Kansas PUMA, Kansas/KS",20163,"Rooks County, Kansas",5118,70,0,1368,0,0.047,78,2,13,13,0,1,91,2,14,1,15,16,107,73,12,1,14,0,2,1,12,85,15,2,13
20,Kansas/KS,2000100,"Northwest Kansas PUMA, Kansas/KS",20167,"Russell County, Kansas",6977,84,0,1204,0,0.064,106,3,18,17,0,1,123,3,19,1,21,22,145,73,12,1,14,0,2,1,12,85,15,2,13
20,Kansas/KS,2000100,"Northwest Kansas PUMA, Kansas/KS",20171,"Scott County, Kansas",4949,121,1,2445,20,0.046,76,2,13,12,0,1,88,2,14,1,15,16,104,73,12,1,14,0,2,1,12,85,15,2,13
20,Kansas/KS,2000100,"Northwest Kansas PUMA, Kansas/KS",20179,"Sheridan County, Kansas",2506,16,0,638,0,0.023,38,1,6,6,0,0,44,1,6,0,7,7,51,75,12,0,14,0,2,0,12,86,14,2,12
20,Kansas/KS,2000100,"Northwest Kansas PUMA, Kansas/KS",20181,"Sherman County, Kansas",5966,31,0,520,0,0.055,91,2,15,15,0,1,106,2,16,1,17,18,124,73,12,1,14,0,2,1,12,85,15,2,13
20,Kansas/KS,2000100,"Northwest Kansas PUMA, Kansas/KS",20183,"Smith County, Kansas",3663,7,0,191,0,0.033,55,1,9,9,0,0,64,1,9,0,10,10,74,74,12,0,14,0,1,0,12,86,14,1,12
20,Kansas/KS,2000100,"Northwest Kansas PUMA, Kansas/KS",20193,"Thomas County, Kansas",7824,131,0,1674,0,0.072,120,3,20,20,0,1,140,3,21,1,23,24,164,73,12,1,14,0,2,1,12,85,15,2,13
20,Kansas/KS,2000100,"Northwest Kansas PUMA, Kansas/KS",20195,"Trego County, Kansas",2858,46,3,1610,105,0.026,43,1,7,7,0,0,50,1,7,0,8,8,58,74,12,0,14,0,2,0,12,86,14,2,12
20,Kansas/KS,2000100,"Northwest Kansas PUMA, Kansas/KS",20199,"Wallace County, Kansas",1575,17,0,1079,0,0.014,23,1,4,4,0,0,27,1,4,0,5,5,32,72,12,0,16,0,3,0,12,84,16,3,12
20,Kansas/KS,2000100,"Northwest Kansas PUMA, Kansas/KS",20203,"Wichita County, Kansas",2143,5,0,233,0,0.019,32,1,5,5,0,0,37,1,5,0,6,6,43,74,12,0,14,0,2,0,12,86,14,2,12
20,Kansas/KS,2000200,"North Central Kansas--Salina City PUMA, Kansas/KS",20027,"Clay County, Kansas",8142,50,2,614,25,0.056,114,1,6,3,7,4,117,8,10,11,7,18,135,84,2,8,5,5,1,3,4,87,13,6,7
20,Kansas/KS,2000200,"North Central Kansas--Salina City PUMA, Kansas/KS",20029,"Cloud County, Kansas",9060,68,1,751,11,0.063,128,2,7,3,8,4,131,10,11,12,9,21,152,84,2,8,6,5,1,3,5,86,14,7,7
20,Kansas/KS,2000200,"North Central Kansas--Salina City PUMA, Kansas/KS",20041,"Dickinson County, Kansas",19004,171,1,900,5,0.13,264,3,15,6,17,9,270,20,24,26,18,44,314,84,2,8,6,5,1,3,5,86,14,6,8
20,Kansas/KS,2000200,"North Central Kansas--Salina City PUMA, Kansas/KS",20053,"Ellsworth County, Kansas",6293,32,0,509,0,0.043,87,1,5,2,6,3,89,7,8,9,6,15,104,84,2,9,6,6,1,3,5,86,14,7,8
20,Kansas/KS,2000200,"North Central Kansas--Salina City PUMA, Kansas/KS",20089,"Jewell County, Kansas",2916,17,1,583,34,0.02,41,1,2,1,3,1,42,4,3,4,3,7,49,84,2,8,6,6,2,2,4,86,14,8,6
20,Kansas/KS,2000200,"North Central Kansas--Salina City PUMA, Kansas/KS",20105,"Lincoln County, Kansas",3097,12,0,387,0,0.021,43,1,2,1,3,1,44,4,3,4,3,7,51,84,2,8,6,6,2,2,4,86,14,8,6
20,Kansas/KS,2000200,"North Central Kansas--Salina City PUMA, Kansas/KS",20117,"Marshall County, Kansas",9798,23,0,235,0,0.067,136,2,8,3,9,5,139,11,13,14,10,24,163,83,2,9,6,6,1,3,5,85,15,7,8
20,Kansas/KS,2000200,"North Central Kansas--Salina City PUMA, Kansas/KS",20123,"Mitchell County, Kansas",6222,44,0,707,0,0.043,87,1,5,2,6,3,89,7,8,9,6,15,104,84,2,9,6,6,1,3,5,86,14,7,8
20,Kansas/KS,2000200,"North Central Kansas--Salina City PUMA, Kansas/KS",20131,"Nemaha County, Kansas",10104,101,1,1000,10,0.07,142,2,8,3,9,5,145,11,13,14,10,24,169,84,2,8,6,5,1,3,5,86,14,7,8
20,Kansas/KS,2000200,"North Central Kansas--Salina City PUMA, Kansas/KS",20143,"Ottawa County, Kansas",5902,53,0,898,0,0.04,81,1,5,2,5,3,83,6,8,8,6,14,97,84,2,8,6,5,1,3,5,86,14,6,8
20,Kansas/KS,2000200,"North Central Kansas--Salina City PUMA, Kansas/KS",20157,"Republic County, Kansas",4686,49,1,1046,21,0.032,65,1,4,2,4,2,67,5,6,6,5,11,78,83,3,8,6,5,1,3,5,86,14,6,8
20,Kansas/KS,2000200,"North Central Kansas--Salina City PUMA, Kansas/KS",20169,"Saline County, Kansas",54977,719,11,1308,20,0.377,766,10,43,18,50,27,784,60,70,77,53,130,914,84,2,8,6,5,1,3,5,86,14,7,8
20,Kansas/KS,2000200,"North Central Kansas--Salina City PUMA, Kansas/KS",20201,"Washington County, Kansas",5525,17,0,308,0,0.038,77,1,4,2,5,3,79,6,7,8,5,13,92,84,2,9,5,5,1,3,4,86,14,7,8
20,Kansas/KS,2000300,"Riley, Geary & Pottawatomie Counties--Manhattan City PUMA, Kansas/KS",20061,"Geary County, Kansas",34895,416,2,1192,6,0.268,140,16,10,49,13,0,189,29,10,13,26,39,228,61,21,6,11,6,7,0,4,83,17,13,4
20,Kansas/KS,2000300,"Riley, Geary & Pottawatomie Counties--Manhattan City PUMA, Kansas/KS",20149,"Pottawatomie County, Kansas",23545,249,0,1058,0,0.178,93,10,7,33,9,0,126,19,7,9,17,26,152,61,22,6,11,6,7,0,5,83,17,12,5
20,Kansas/KS,2000300,"Riley, Geary & Pottawatomie Counties--Manhattan City PUMA, Kansas/KS",20161,"Riley County, Kansas",75296,1795,8,2384,11,0.553,290,32,20,101,27,0,391,59,20,27,52,79,470,62,21,6,11,6,7,0,4,83,17,13,4
20,Kansas/KS,2000400,"Northeast Kansas PUMA, Kansas/KS",20005,"Atchison County, Kansas",16363,307,2,1876,12,0.133,67,0,0,2,0,0,69,0,0,0,0,0,69,97,3,0,0,0,0,0,0,100,0,0,0
20,Kansas/KS,2000400,"Northeast Kansas PUMA, Kansas/KS",20043,"Doniphan County, Kansas",7736,100,0,1293,0,0.062,31,0,0,1,0,0,32,0,0,0,0,0,32,97,3,0,0,0,0,0,0,100,0,0,0
20,Kansas/KS,2000400,"Northeast Kansas PUMA, Kansas/KS",20087,"Jefferson County, Kansas",18888,186,4,985,21,0.153,77,0,0,3,0,0,80,0,0,0,0,0,80,96,4,0,0,0,0,0,0,100,0,0,0
20,Kansas/KS,2000400,"Northeast Kansas PUMA, Kansas/KS",20103,"Leavenworth County, Kansas",80042,2080,11,2599,14,0.651,329,0,0,12,2,0,341,2,0,2,0,2,343,96,3,1,0,1,0,0,0,99,1,1,0
20,Kansas/KS,2000500,"Wyandotte County--Kansas City PUMA, Kansas/KS",20209,"Wyandotte County, Kansas",164345,6989,134,4253,82,1,611,172,325,148,138,158,759,310,483,296,497,793,1552,39,10,19,32,9,11,10,21,49,51,20,31
20,Kansas/KS,2000601,"Johnson County (Northwest)--Shawnee, Lenexa & De Soto Cities PUMA, Kansas/KS",20091,"Johnson County, Kansas",585502,10997,146,1878,25,1,75,0,30,23,27,0,98,27,30,27,30,57,155,48,15,17,19,17,0,0,19,63,37,17,19
20,Kansas/KS,2000602,"Johnson County (Northeast)--Overland Park (North), Prairie Village & Merriam Cities PUMA, Kansas/KS",20091,"Johnson County, Kansas",585502,10997,146,1878,25,1,97,0,53,0,43,0,97,43,53,43,53,96,193,50,0,22,27,22,0,0,27,50,50,22,27
20,Kansas/KS,2000603,"Johnson County (Southwest)--Olathe, Gardner, Spring Hill & Edgerton Cities PUMA, Kansas/KS",20091,"Johnson County, Kansas",585502,10997,146,1878,25,1,329,65,165,76,23,127,405,88,292,150,230,380,785,42,10,19,29,3,8,16,21,52,48,11,37
20,Kansas/KS,2000604,"Johnson County (Southeast)--Blue Valley Region PUMA, Kansas/KS",20091,"Johnson County, Kansas",585502,10997,146,1878,25,1,76,0,0,34,26,0,110,26,0,26,0,26,136,56,25,19,0,19,0,0,0,81,19,19,0
20,Kansas/KS,2000700,"Douglas County--Lawrence City PUMA, Kansas/KS",20045,"Douglas County, Kansas",119319,2174,10,1822,8,1,431,0,0,8,0,0,439,0,0,0,0,0,439,98,2,0,0,0,0,0,0,100,0,0,0
20,Kansas/KS,2000801,"Shawnee County (Central)--Topeka City PUMA, Kansas/KS",20177,"Shawnee County, Kansas",178284,2710,32,1520,18,1,964,16,271,640,15,20,1604,31,291,35,287,322,1926,50,33,2,15,1,1,1,14,83,17,2,15
20,Kansas/KS,2000802,"Shawnee (Outside Topeka City), Osage, Jackson, Brown & Wabaunsee Counties PUMA, Kansas/KS",20013,"Brown County, Kansas",9664,114,3,1180,31,0.081,79,0,3,0,0,3,79,0,6,3,3,6,85,93,0,4,4,0,0,4,4,93,7,0,7
20,Kansas/KS,2000802,"Shawnee (Outside Topeka City), Osage, Jackson, Brown & Wabaunsee Counties PUMA, Kansas/KS",20085,"Jackson County, Kansas",13318,237,2,1780,15,0.111,109,0,4,0,1,5,109,1,9,6,4,10,119,92,0,5,3,1,0,4,3,92,8,1,8
20,Kansas/KS,2000802,"Shawnee (Outside Topeka City), Osage, Jackson, Brown & Wabaunsee Counties PUMA, Kansas/KS",20139,"Osage County, Kansas",15882,107,0,674,0,0.133,130,0,5,1,1,5,131,1,10,6,5,11,142,92,1,4,4,1,0,4,4,92,8,1,7
20,Kansas/KS,2000802,"Shawnee (Outside Topeka City), Osage, Jackson, Brown & Wabaunsee Counties PUMA, Kansas/KS",20177,"Shawnee County, Kansas",178284,2710,32,1520,18,0.617,603,0,25,2,4,25,605,4,50,29,25,54,659,92,0,4,4,1,0,4,4,92,8,1,8
20,Kansas/KS,2000802,"Shawnee (Outside Topeka City), Osage, Jackson, Brown & Wabaunsee Counties PUMA, Kansas/KS",20197,"Wabaunsee County, Kansas",6888,68,1,987,15,0.058,57,0,2,0,0,2,57,0,4,2,2,4,61,93,0,3,3,0,0,3,3,93,7,0,7
20,Kansas/KS,2000900,"Flint Hills Region--Emporia City PUMA, Kansas/KS",20017,"Chase County, Kansas",2645,81,1,3062,38,0.025,42,6,9,7,0,0,49,6,9,0,15,15,64,66,11,0,23,0,9,0,14,77,23,9,14
20,Kansas/KS,2000900,"Flint Hills Region--Emporia City PUMA, Kansas/KS",20019,"Chautauqua County, Kansas",3367,16,0,475,0,0.032,54,7,12,9,1,0,63,8,12,1,19,20,83,65,11,1,23,1,8,0,14,76,24,10,14
20,Kansas/KS,2000900,"Flint Hills Region--Emporia City PUMA, Kansas/KS",20031,"Coffey County, Kansas",8296,118,8,1422,96,0.079,133,18,29,21,1,0,154,19,29,1,47,48,202,66,10,0,23,0,9,0,14,76,24,9,14
20,Kansas/KS,2000900,"Flint Hills Region--Emporia City PUMA, Kansas/KS",20035,"Cowley County, Kansas",35591,373,5,1048,14,0.191,322,43,69,52,3,0,374,46,69,3,112,115,489,66,11,1,23,1,9,0,14,76,24,9,14
20,Kansas/KS,2000900,"Flint Hills Region--Emporia City PUMA, Kansas/KS",20049,"Elk County, Kansas",2562,4,0,156,0,0.024,40,5,9,7,0,0,47,5,9,0,14,14,61,66,11,0,23,0,8,0,15,77,23,8,15
20,Kansas/KS,2000900,"Flint Hills Region--Emporia City PUMA, Kansas/KS",20073,"Greenwood County, Kansas",6156,49,0,796,0,0.058,98,13,21,16,1,0,114,14,21,1,34,35,149,66,11,1,23,1,9,0,14,77,23,9,14
20,Kansas/KS,2000900,"Flint Hills Region--Emporia City PUMA, Kansas/KS",20111,"Lyon County, Kansas",33299,1051,33,3156,99,0.314,529,71,114,85,6,0,614,77,114,6,185,191,805,66,11,1,23,1,9,0,14,76,24,10,14
20,Kansas/KS,2000900,"Flint Hills Region--Emporia City PUMA, Kansas/KS",20115,"Marion County, Kansas",12032,90,1,748,8,0.114,192,26,41,31,2,0,223,28,41,2,67,69,292,66,11,1,23,1,9,0,14,76,24,10,14
20,Kansas/KS,2000900,"Flint Hills Region--Emporia City PUMA, Kansas/KS",20127,"Morris County, Kansas",5566,35,0,629,0,0.052,88,12,19,14,1,0,102,13,19,1,31,32,134,66,10,1,23,1,9,0,14,76,24,10,14
20,Kansas/KS,2000900,"Flint Hills Region--Emporia City PUMA, Kansas/KS",20205,"Wilson County, Kansas",8780,60,2,683,23,0.082,138,18,30,22,1,0,160,19,30,1,48,49,209,66,11,0,23,0,9,0,14,77,23,9,14
20,Kansas/KS,2000900,"Flint Hills Region--Emporia City PUMA, Kansas/KS",20207,"Woodson County, Kansas",3170,20,0,631,0,0.03,51,7,11,8,1,0,59,8,11,1,18,19,78,65,10,1,23,1,9,0,14,76,24,10,14
20,Kansas/KS,2001000,"Central Kansas--Hutchinson City PUMA, Kansas/KS",20113,"McPherson County, Kansas",28630,260,1,908,3,0.283,405,4,6,14,0,0,419,4,6,0,10,10,429,94,3,0,2,0,1,0,1,98,2,1,1
20,Kansas/KS,2001000,"Central Kansas--Hutchinson City PUMA, Kansas/KS",20155,"Reno County, Kansas",63101,1094,3,1734,5,0.621,889,8,12,30,0,0,919,8,12,0,20,20,939,95,3,0,2,0,1,0,1,98,2,1,1
20,Kansas/KS,2001000,"Central Kansas--Hutchinson City PUMA, Kansas/KS",20159,"Rice County, Kansas",9762,73,1,748,10,0.097,139,1,2,5,0,0,144,1,2,0,3,3,147,95,3,0,2,0,1,0,1,98,2,1,1
20,Kansas/KS,2001100,"South Central Kansas PUMA, Kansas/KS",20007,"Barber County, Kansas",4733,5,0,106,0,0.041,53,11,9,9,0,1,62,11,10,1,20,21,83,64,11,1,24,0,13,1,11,75,25,13,12
20,Kansas/KS,2001100,"South Central Kansas PUMA, Kansas/KS",20009,"Barton County, Kansas",26791,492,7,1836,26,0.235,302,61,52,51,1,4,353,62,56,5,113,118,471,64,11,1,24,0,13,1,11,75,25,13,12
20,Kansas/KS,2001100,"South Central Kansas PUMA, Kansas/KS",20033,"Comanche County, Kansas",1780,11,0,618,0,0.016,21,4,4,3,0,0,24,4,4,0,8,8,32,66,9,0,25,0,12,0,12,75,25,12,12
20,Kansas/KS,2001100,"South Central Kansas PUMA, Kansas/KS",20035,"Cowley County, Kansas",35591,373,5,1048,14,0.135,173,35,30,29,1,2,202,36,32,3,65,68,270,64,11,1,24,0,13,1,11,75,25,13,12
20,Kansas/KS,2001100,"South Central Kansas PUMA, Kansas/KS",20047,"Edwards County, Kansas",2925,46,0,1573,0,0.026,33,7,6,6,0,0,39,7,6,0,13,13,52,63,12,0,25,0,13,0,12,75,25,13,12
20,Kansas/KS,2001100,"South Central Kansas PUMA, Kansas/KS",20077,"Harper County, Kansas",5673,120,2,2115,35,0.05,64,13,11,11,0,1,75,13,12,1,24,25,100,64,11,1,24,0,13,1,11,75,25,13,12
20,Kansas/KS,2001100,"South Central Kansas PUMA, Kansas/KS",20095,"Kingman County, Kansas",7470,90,1,1205,13,0.065,83,17,14,14,0,1,97,17,15,1,31,32,129,64,11,1,24,0,13,1,11,75,25,13,12
20,Kansas/KS,2001100,"South Central Kansas PUMA, Kansas/KS",20097,"Kiowa County, Kansas",2526,23,0,911,0,0.022,28,6,5,5,0,0,33,6,5,0,11,11,44,64,11,0,25,0,14,0,11,75,25,14,11
20,Kansas/KS,2001100,"South Central Kansas PUMA, Kansas/KS",20145,"Pawnee County, Kansas",6709,374,0,5575,0,0.059,76,15,13,13,0,1,89,15,14,1,28,29,118,64,11,1,24,0,13,1,11,75,25,13,12
20,Kansas/KS,2001100,"South Central Kansas PUMA, Kansas/KS",20151,"Pratt County, Kansas",9582,72,0,751,0,0.084,108,22,18,18,0,1,126,22,19,1,40,41,167,65,11,1,24,0,13,1,11,75,25,13,11
20,Kansas/KS,2001100,"South Central Kansas PUMA, Kansas/KS",20165,"Rush County, Kansas",3102,53,0,1709,0,0.027,35,7,6,6,0,0,41,7,6,0,13,13,54,65,11,0,24,0,13,0,11,76,24,13,11
20,Kansas/KS,2001100,"South Central Kansas PUMA, Kansas/KS",20185,"Stafford County, Kansas",4214,56,1,1329,24,0.037,48,10,8,8,0,1,56,10,9,1,18,19,75,64,11,1,24,0,13,1,11,75,25,13,12
20,Kansas/KS,2001100,"South Central Kansas PUMA, Kansas/KS",20191,"Sumner County, Kansas",23208,198,3,853,13,0.204,262,53,45,44,1,3,306,54,48,4,98,102,408,64,11,1,24,0,13,1,11,75,25,13,12
20,Kansas/KS,2001200,"Southwest Kansas--Dodge City, Garden City & Liberal City PUMA, Kansas/KS",20025,"Clark County, Kansas",2053,50,1,2435,49,0.015,23,29,62,19,6,11,42,35,73,17,91,108,150,15,13,11,61,4,19,7,41,28,72,23,49
20,Kansas/KS,2001200,"Southwest Kansas--Dodge City, Garden City & Liberal City PUMA, Kansas/KS",20055,"Finney County, Kansas",36957,2129,12,5761,32,0.27,415,514,1109,346,110,191,761,624,1300,301,1623,1924,2685,15,13,11,60,4,19,7,41,28,72,23,48
20,Kansas/KS,2001200,"Southwest Kansas--Dodge City, Garden City & Liberal City PUMA, Kansas/KS",20057,"Ford County, Kansas",34484,2800,10,8120,29,0.249,383,474,1023,319,102,176,702,576,1199,278,1497,1775,2477,15,13,11,60,4,19,7,41,28,72,23,48
20,Kansas/KS,2001200,"Southwest Kansas--Dodge City, Garden City & Liberal City PUMA, Kansas/KS",20067,"Grant County, Kansas",7616,268,5,3519,66,0.056,86,107,230,72,23,40,158,130,270,63,337,400,558,15,13,11,60,4,19,7,41,28,72,23,48
20,Kansas/KS,2001200,"Southwest Kansas--Dodge City, Garden City & Liberal City PUMA, Kansas/KS",20069,"Gray County, Kansas",6037,121,0,2004,0,0.044,68,84,181,56,18,31,124,102,212,49,265,314,438,16,13,11,61,4,19,7,41,28,72,23,48
20,Kansas/KS,2001200,"Southwest Kansas--Dodge City, Garden City & Liberal City PUMA, Kansas/KS",20075,"Hamilton County, Kansas",2616,46,0,1758,0,0.019,29,36,78,24,8,13,53,44,91,21,114,135,188,15,13,11,61,4,19,7,41,28,72,23,48
20,Kansas/KS,2001200,"Southwest Kansas--Dodge City, Garden City & Liberal City PUMA, Kansas/KS",20081,"Haskell County, Kansas",4047,116,1,2866,25,0.029,45,55,119,37,12,20,82,67,139,32,174,206,288,16,13,11,60,4,19,7,41,28,72,23,48
20,Kansas/KS,2001200,"Southwest Kansas--Dodge City, Garden City & Liberal City PUMA, Kansas/KS",20083,"Hodgeman County, Kansas",1842,19,0,1031,0,0.014,22,27,58,18,6,10,40,33,68,16,85,101,141,16,13,11,60,4,19,7,41,28,72,23,48
20,Kansas/KS,2001200,"Southwest Kansas--Dodge City, Garden City & Liberal City PUMA, Kansas/KS",20093,"Kearny County, Kansas",3932,92,1,2340,25,0.029,45,55,119,37,12,20,82,67,139,32,174,206,288,16,13,11,60,4,19,7,41,28,72,23,48
20,Kansas/KS,2001200,"Southwest Kansas--Dodge City, Garden City & Liberal City PUMA, Kansas/KS",20119,"Meade County, Kansas",4261,125,1,2934,23,0.031,48,59,127,40,13,22,88,72,149,35,186,221,309,16,13,11,60,4,19,7,41,28,72,23,48
20,Kansas/KS,2001200,"Southwest Kansas--Dodge City, Garden City & Liberal City PUMA, Kansas/KS",20129,"Morton County, Kansas",2838,14,2,493,70,0.021,32,40,86,27,9,15,59,49,101,24,126,150,209,15,13,11,60,4,19,7,41,28,72,23,48
20,Kansas/KS,2001200,"Southwest Kansas--Dodge City, Garden City & Liberal City PUMA, Kansas/KS",20175,"Seward County, Kansas",22692,1669,5,7355,22,0.167,257,318,686,214,68,118,471,386,804,186,1004,1190,1661,15,13,11,60,4,19,7,41,28,72,23,48
20,Kansas/KS,2001200,"Southwest Kansas--Dodge City, Garden City & Liberal City PUMA, Kansas/KS",20187,"Stanton County, Kansas",2063,59,2,2860,97,0.015,23,29,62,19,6,11,42,35,73,17,91,108,150,15,13,11,61,4,19,7,41,28,72,23,49
20,Kansas/KS,2001200,"Southwest Kansas--Dodge City, Garden City & Liberal City PUMA, Kansas/KS",20189,"Stevens County, Kansas",5686,144,1,2533,18,0.041,63,78,168,52,17,29,115,95,197,46,246,292,407,15,13,11,60,4,19,7,41,28,72,23,48
20,Kansas/KS,2001301,"Sedgwick (Northwest) & Harvey Counties--Wichita (Northwest) & Newton Cities PUMA, Kansas/KS",20079,"Harvey County, Kansas",34555,352,8,1019,23,0.217,92,16,24,0,0,0,92,16,24,0,40,40,132,70,0,0,30,0,12,0,18,70,30,12,18
20,Kansas/KS,2001301,"Sedgwick (Northwest) & Harvey Counties--Wichita (Northwest) & Newton Cities PUMA, Kansas/KS",20173,"Sedgwick County, Kansas",512064,8757,86,1710,17,0.783,330,56,86,0,0,0,330,56,86,0,142,142,472,70,0,0,30,0,12,0,18,70,30,12,18
20,Kansas/KS,2001302,"Sedgwick (Northeast) & Butler (North & East) Counties--Wichita City (Northeast) PUMA, Kansas/KS",20015,"Butler County, Kansas",66468,922,4,1387,6,0.343,156,0,10,0,0,10,156,0,20,10,10,20,176,89,0,6,6,0,0,6,6,89,11,0,11
20,Kansas/KS,2001302,"Sedgwick (Northeast) & Butler (North & East) Counties--Wichita City (Northeast) PUMA, Kansas/KS",20173,"Sedgwick County, Kansas",512064,8757,86,1710,17,0.657,299,0,19,0,0,20,299,0,39,20,19,39,338,88,0,6,6,0,0,6,6,88,12,0,12
20,Kansas/KS,2001303,"Sedgwick County (Central)--Wichita City (Central) PUMA, Kansas/KS",20173,"Sedgwick County, Kansas",512064,8757,86,1710,17,1,162,0,154,0,0,28,162,0,182,28,154,182,344,47,0,8,45,0,0,8,45,47,53,0,53
20,Kansas/KS,2001304,"Sedgwick (South) & Butler (Southwest) Counties--Wichita (South) & Derby Cities PUMA, Kansas/KS",20015,"Butler County, Kansas",66468,922,4,1387,6,0.072,30,3,9,6,4,10,36,7,19,14,12,26,62,48,10,23,19,6,5,16,15,58,42,11,31
20,Kansas/KS,2001304,"Sedgwick (South) & Butler (Southwest) Counties--Wichita (South) & Derby Cities PUMA, Kansas/KS",20173,"Sedgwick County, Kansas",512064,8757,86,1710,17,0.928,393,37,117,80,49,125,473,86,242,174,154,328,801,49,10,22,19,6,5,16,15,59,41,11,30
20,Kansas/KS,2001400,"East Central Kansas PUMA, Kansas/KS",20001,"Allen County, Kansas",12630,57,0,451,0,0.123,70,0,0,0,1,0,70,1,0,1,0,1,71,99,0,1,0,1,0,0,0,99,1,1,0
20,Kansas/KS,2001400,"East Central Kansas PUMA, Kansas/KS",20003,"Anderson County, Kansas",7852,74,0,942,0,0.076,43,0,0,0,1,0,43,1,0,1,0,1,44,98,0,2,0,2,0,0,0,98,2,2,0
20,Kansas/KS,2001400,"East Central Kansas PUMA, Kansas/KS",20011,"Bourbon County, Kansas",14702,175,3,1190,20,0.142,81,0,0,0,2,0,81,2,0,2,0,2,83,98,0,2,0,2,0,0,0,98,2,2,0
20,Kansas/KS,2001400,"East Central Kansas PUMA, Kansas/KS",20059,"Franklin County, Kansas",25563,349,3,1365,12,0.248,142,0,0,0,3,0,142,3,0,3,0,3,145,98,0,2,0,2,0,0,0,98,2,2,0
20,Kansas/KS,2001400,"East Central Kansas PUMA, Kansas/KS",20107,"Linn County, Kansas",9635,75,0,778,0,0.093,53,0,0,0,1,0,53,1,0,1,0,1,54,98,0,2,0,2,0,0,0,98,2,2,0
20,Kansas/KS,2001400,"East Central Kansas PUMA, Kansas/KS",20121,"Miami County, Kansas",33127,375,1,1132,3,0.319,182,0,0,0,4,0,182,4,0,4,0,4,186,98,0,2,0,2,0,0,0,98,2,2,0
20,Kansas/KS,2001500,"Southeast Kansas PUMA, Kansas/KS",20021,"Cherokee County, Kansas",20331,489,8,2405,39,0.157,124,0,5,12,0,0,136,0,5,0,5,5,141,88,9,0,4,0,0,0,4,96,4,0,4
20,Kansas/KS,2001500,"Southeast Kansas PUMA, Kansas/KS",20037,"Crawford County, Kansas",39108,1038,6,2654,15,0.304,240,0,9,23,0,0,263,0,9,0,9,9,272,88,8,0,3,0,0,0,3,97,3,0,3
20,Kansas/KS,2001500,"Southeast Kansas PUMA, Kansas/KS",20099,"Labette County, Kansas",20367,240,4,1178,20,0.159,125,0,5,12,0,0,137,0,5,0,5,5,142,88,8,0,4,0,0,0,4,96,4,0,4
20,Kansas/KS,2001500,"Southeast Kansas PUMA, Kansas/KS",20125,"Montgomery County, Kansas",32970,404,6,1225,18,0.254,200,0,7,20,0,0,220,0,7,0,7,7,227,88,9,0,3,0,0,0,3,97,3,0,3
20,Kansas/KS,2001500,"Southeast Kansas PUMA, Kansas/KS",20133,"Neosho County, Kansas",16125,166,0,1029,0,0.125,99,0,4,10,0,0,109,0,4,0,4,4,113,88,9,0,4,0,0,0,4,96,4,0,4
21,Kentucky/KY,2100100,"Purchase Area Development District PUMA, Kentucky/KY",21007,"Ballard County, Kentucky",8090,56,1,692,12,0.041,67,1,7,0,5,3,67,6,10,8,8,16,83,81,0,10,10,6,1,4,8,81,19,7,12
21,Kentucky/KY,2100100,"Purchase Area Development District PUMA, Kentucky/KY",21035,"Calloway County, Kentucky",38776,568,8,1465,21,0.196,319,5,31,0,23,14,319,28,45,37,36,73,392,81,0,9,9,6,1,4,8,81,19,7,11
21,Kentucky/KY,2100100,"Purchase Area Development District PUMA, Kentucky/KY",21039,"Carlisle County, Kentucky",4841,79,1,1632,21,0.025,41,1,4,0,3,2,41,4,6,5,5,10,51,80,0,10,10,6,2,4,8,80,20,8,12
21,Kentucky/KY,2100100,"Purchase Area Development District PUMA, Kentucky/KY",21075,"Fulton County, Kentucky",6210,145,3,2335,48,0.032,52,1,5,0,4,2,52,5,7,6,6,12,64,81,0,9,9,6,2,3,8,81,19,8,11
21,Kentucky/KY,2100100,"Purchase Area Development District PUMA, Kentucky/KY",21083,"Graves County, Kentucky",37294,729,29,1955,78,0.19,310,5,30,0,22,13,310,27,43,35,35,70,380,82,0,9,9,6,1,3,8,82,18,7,11
21,Kentucky/KY,2100100,"Purchase Area Development District PUMA, Kentucky/KY",21105,"Hickman County, Kentucky",4568,77,0,1686,0,0.024,39,1,4,0,3,2,39,4,6,5,5,10,49,80,0,10,10,6,2,4,8,80,20,8,12
21,Kentucky/KY,2100100,"Purchase Area Development District PUMA, Kentucky/KY",21145,"McCracken County, Kentucky",65284,714,10,1094,15,0.333,542,9,53,0,39,23,542,48,76,62,62,124,666,81,0,9,9,6,1,3,8,81,19,7,11
21,Kentucky/KY,2100100,"Purchase Area Development District PUMA, Kentucky/KY",21157,"Marshall County, Kentucky",31166,297,4,953,13,0.16,261,4,25,0,19,11,261,23,36,30,29,59,320,82,0,9,9,6,1,3,8,82,18,7,11
21,Kentucky/KY,2100200,"Pennyrile Area Development District (North) PUMA, Kentucky/KY",21033,"Caldwell County, Kentucky",12727,152,0,1194,0,0.116,83,0,0,0,0,2,83,0,2,2,0,2,85,98,0,2,0,0,0,2,0,98,2,0,2
21,Kentucky/KY,2100200,"Pennyrile Area Development District (North) PUMA, Kentucky/KY",21055,"Crittenden County, Kentucky",9083,121,1,1332,11,0.085,61,0,0,0,0,2,61,0,2,2,0,2,63,97,0,3,0,0,0,3,0,97,3,0,3
21,Kentucky/KY,2100200,"Pennyrile Area Development District (North) PUMA, Kentucky/KY",21107,"Hopkins County, Kentucky",45664,627,40,1373,88,0.425,304,0,0,0,0,9,304,0,9,9,0,9,313,97,0,3,0,0,0,3,0,97,3,0,3
21,Kentucky/KY,2100200,"Pennyrile Area Development District (North) PUMA, Kentucky/KY",21139,"Livingston County, Kentucky",9263,87,1,939,11,0.086,62,0,0,0,0,2,62,0,2,2,0,2,64,97,0,3,0,0,0,3,0,97,3,0,3
21,Kentucky/KY,2100200,"Pennyrile Area Development District (North) PUMA, Kentucky/KY",21177,"Muhlenberg County, Kentucky",31081,788,13,2535,42,0.287,205,0,0,0,0,6,205,0,6,6,0,6,211,97,0,3,0,0,0,3,0,97,3,0,3
21,Kentucky/KY,2100300,"Pennyrile Area Development District (South) PUMA, Kentucky/KY",21047,"Christian County, Kentucky",72263,1290,22,1785,30,0.676,363,0,112,2,0,0,365,0,112,0,112,112,477,76,0,0,23,0,0,0,23,77,23,0,23
21,Kentucky/KY,2100300,"Pennyrile Area Development District (South) PUMA, Kentucky/KY",21143,"Lyon County, Kentucky",8186,70,4,855,49,0.075,40,0,12,0,0,0,40,0,12,0,12,12,52,77,0,0,23,0,0,0,23,77,23,0,23
21,Kentucky/KY,2100300,"Pennyrile Area Development District (South) PUMA, Kentucky/KY",21219,"Todd County, Kentucky",12350,184,8,1490,65,0.115,62,0,19,0,0,0,62,0,19,0,19,19,81,77,0,0,23,0,0,0,23,77,23,0,23
21,Kentucky/KY,2100300,"Pennyrile Area Development District (South) PUMA, Kentucky/KY",21221,"Trigg County, Kentucky",14344,172,0,1199,0,0.133,71,0,22,0,0,0,71,0,22,0,22,22,93,76,0,0,24,0,0,0,24,76,24,0,24
21,Kentucky/KY,2100400,"Barren River Area Development District (Outer) PUMA, Kentucky/KY",21003,"Allen County, Kentucky",20794,331,9,1592,43,0.119,223,9,32,8,4,1,231,13,33,5,41,46,277,81,3,2,15,1,3,0,12,83,17,5,12
21,Kentucky/KY,2100400,"Barren River Area Development District (Outer) PUMA, Kentucky/KY",21009,"Barren County, Kentucky",43680,747,13,1710,30,0.254,476,19,69,17,9,2,493,28,71,11,88,99,592,80,3,2,15,2,3,0,12,83,17,5,12
21,Kentucky/KY,2100400,"Barren River Area Development District (Outer) PUMA, Kentucky/KY",21031,"Butler County, Kentucky",12745,356,16,2793,126,0.074,139,5,20,5,3,1,144,8,21,4,25,29,173,80,3,2,14,2,3,1,12,83,17,5,12
21,Kentucky/KY,2100400,"Barren River Area Development District (Outer) PUMA, Kentucky/KY",21061,"Edmonson County, Kentucky",12122,152,12,1254,99,0.07,131,5,19,5,3,0,136,8,19,3,24,27,163,80,3,2,15,2,3,0,12,83,17,5,12
21,Kentucky/KY,2100400,"Barren River Area Development District (Outer) PUMA, Kentucky/KY",21099,"Hart County, Kentucky",18627,186,1,999,5,0.107,201,8,29,7,4,1,208,12,30,5,37,42,250,80,3,2,15,2,3,0,12,83,17,5,12
21,Kentucky/KY,2100400,"Barren River Area Development District (Outer) PUMA, Kentucky/KY",21141,"Logan County, Kentucky",26849,571,28,2127,104,0.153,287,11,42,10,6,1,297,17,43,7,53,60,357,80,3,2,15,2,3,0,12,83,17,5,12
21,Kentucky/KY,2100400,"Barren River Area Development District (Outer) PUMA, Kentucky/KY",21169,"Metcalfe County, Kentucky",10004,118,2,1180,20,0.058,109,4,16,4,2,0,113,6,16,2,20,22,135,81,3,1,15,1,3,0,12,84,16,4,12
21,Kentucky/KY,2100400,"Barren River Area Development District (Outer) PUMA, Kentucky/KY",21171,"Monroe County, Kentucky",10634,203,4,1909,38,0.061,114,5,17,4,2,0,118,7,17,2,22,24,142,80,3,1,15,1,4,0,12,83,17,5,12
21,Kentucky/KY,2100400,"Barren River Area Development District (Outer) PUMA, Kentucky/KY",21213,"Simpson County, Kentucky",18063,280,8,1550,44,0.104,195,8,28,7,4,1,202,12,29,5,36,41,243,80,3,2,15,2,3,0,12,83,17,5,12
21,Kentucky/KY,2100500,"Barren River Area Development District (Central)--Warren County PUMA, Kentucky/KY",21227,"Warren County, Kentucky",126427,4333,50,3427,40,1,360,37,203,0,44,353,360,81,556,397,240,637,997,36,0,40,24,4,4,35,20,36,64,8,56
21,Kentucky/KY,2100600,"Lake Cumberland Area Development District (West) PUMA, Kentucky/KY",21001,"Adair County, Kentucky",19241,316,19,1642,99,0.182,126,0,0,0,0,0,126,0,0,0,0,0,126,100,0,0,0,0,0,0,0,100,0,0,0
21,Kentucky/KY,2100600,"Lake Cumberland Area Development District (West) PUMA, Kentucky/KY",21045,"Casey County, Kentucky",15796,271,16,1716,101,0.149,104,0,0,0,0,0,104,0,0,0,0,0,104,100,0,0,0,0,0,0,0,100,0,0,0
21,Kentucky/KY,2100600,"Lake Cumberland Area Development District (West) PUMA, Kentucky/KY",21053,"Clinton County, Kentucky",10211,118,2,1156,20,0.096,67,0,0,0,0,0,67,0,0,0,0,0,67,100,0,0,0,0,0,0,0,100,0,0,0
21,Kentucky/KY,2100600,"Lake Cumberland Area Development District (West) PUMA, Kentucky/KY",21057,"Cumberland County, Kentucky",6713,104,0,1549,0,0.063,44,0,0,0,0,0,44,0,0,0,0,0,44,100,0,0,0,0,0,0,0,100,0,0,0
21,Kentucky/KY,2100600,"Lake Cumberland Area Development District (West) PUMA, Kentucky/KY",21087,"Green County, Kentucky",11023,274,9,2486,82,0.104,72,0,0,0,0,0,72,0,0,0,0,0,72,100,0,0,0,0,0,0,0,100,0,0,0
21,Kentucky/KY,2100600,"Lake Cumberland Area Development District (West) PUMA, Kentucky/KY",21207,"Russell County, Kentucky",17760,258,6,1453,34,0.167,116,0,0,0,0,0,116,0,0,0,0,0,116,100,0,0,0,0,0,0,0,100,0,0,0
21,Kentucky/KY,2100600,"Lake Cumberland Area Development District (West) PUMA, Kentucky/KY",21217,"Taylor County, Kentucky",25500,296,7,1161,27,0.239,166,0,0,0,0,0,166,0,0,0,0,0,166,100,0,0,0,0,0,0,0,100,0,0,0
21,Kentucky/KY,2100700,"Lake Cumberland Area Development District (East) PUMA, Kentucky/KY",21147,"McCreary County, Kentucky",17635,160,0,907,0,0.172,115,0,4,13,0,6,128,0,10,6,4,10,138,83,9,4,3,0,0,4,3,93,7,0,7
21,Kentucky/KY,2100700,"Lake Cumberland Area Development District (East) PUMA, Kentucky/KY",21199,"Pulaski County, Kentucky",64145,795,10,1239,16,0.628,418,0,16,48,0,22,466,0,38,22,16,38,504,83,10,4,3,0,0,4,3,92,8,0,8
21,Kentucky/KY,2100700,"Lake Cumberland Area Development District (East) PUMA, Kentucky/KY",21231,"Wayne County, Kentucky",20609,151,0,733,0,0.201,134,0,5,15,0,7,149,0,12,7,5,12,161,83,9,4,3,0,0,4,3,93,7,0,7
21,Kentucky/KY,2100800,"Cumberland Valley Area Development District (North) PUMA, Kentucky/KY",21051,"Clay County, Kentucky",20621,317,6,1537,29,0.187,257,0,0,0,0,0,257,0,0,0,0,0,257,100,0,0,0,0,0,0,0,100,0,0,0
21,Kentucky/KY,2100800,"Cumberland Valley Area Development District (North) PUMA, Kentucky/KY",21109,"Jackson County, Kentucky",13373,364,17,2722,127,0.12,165,0,0,0,0,0,165,0,0,0,0,0,165,100,0,0,0,0,0,0,0,100,0,0,0
21,Kentucky/KY,2100800,"Cumberland Valley Area Development District (North) PUMA, Kentucky/KY",21125,"Laurel County, Kentucky",60180,851,6,1414,10,0.542,746,0,0,0,0,0,746,0,0,0,0,0,746,100,0,0,0,0,0,0,0,100,0,0,0
21,Kentucky/KY,2100800,"Cumberland Valley Area Development District (North) PUMA, Kentucky/KY",21203,"Rockcastle County, Kentucky",16827,170,1,1010,6,0.151,208,0,0,0,0,0,208,0,0,0,0,0,208,100,0,0,0,0,0,0,0,100,0,0,0
21,Kentucky/KY,2100900,"Cumberland Valley Area Development District (South) PUMA, Kentucky/KY",21013,"Bell County, Kentucky",27188,490,13,1802,48,0.222,108,0,0,0,0,0,108,0,0,0,0,0,108,100,0,0,0,0,0,0,0,100,0,0,0
21,Kentucky/KY,2100900,"Cumberland Valley Area Development District (South) PUMA, Kentucky/KY",21095,"Harlan County, Kentucky",27134,382,10,1408,37,0.223,108,0,0,0,0,0,108,0,0,0,0,0,108,100,0,0,0,0,0,0,0,100,0,0,0
21,Kentucky/KY,2100900,"Cumberland Valley Area Development District (South) PUMA, Kentucky/KY",21121,"Knox County, Kentucky",31467,477,9,1516,29,0.26,126,0,0,0,0,0,126,0,0,0,0,0,126,100,0,0,0,0,0,0,0,100,0,0,0
21,Kentucky/KY,2100900,"Cumberland Valley Area Development District (South) PUMA, Kentucky/KY",21235,"Whitley County, Kentucky",36089,337,2,934,6,0.296,144,0,0,0,0,0,144,0,0,0,0,0,144,100,0,0,0,0,0,0,0,100,0,0,0
21,Kentucky/KY,2101000,"Kentucky River Area Development District PUMA, Kentucky/KY",21025,"Breathitt County, Kentucky",13116,87,0,663,0,0.123,24,0,0,1,0,0,25,0,0,0,0,0,25,96,4,0,0,0,0,0,0,100,0,0,0
21,Kentucky/KY,2101000,"Kentucky River Area Development District PUMA, Kentucky/KY",21119,"Knott County, Kentucky",15513,198,1,1276,6,0.144,28,0,0,2,0,0,30,0,0,0,0,0,30,93,7,0,0,0,0,0,0,100,0,0,0
21,Kentucky/KY,2101000,"Kentucky River Area Development District PUMA, Kentucky/KY",21129,"Lee County, Kentucky",6751,17,0,252,0,0.061,12,0,0,1,0,0,13,0,0,0,0,0,13,92,8,0,0,0,0,0,0,100,0,0,0
21,Kentucky/KY,2101000,"Kentucky River Area Development District PUMA, Kentucky/KY",21131,"Leslie County, Kentucky",10472,70,0,668,0,0.098,19,0,0,1,0,0,20,0,0,0,0,0,20,95,5,0,0,0,0,0,0,100,0,0,0
21,Kentucky/KY,2101000,"Kentucky River Area Development District PUMA, Kentucky/KY",21133,"Letcher County, Kentucky",22676,137,2,604,9,0.211,41,0,0,2,0,0,43,0,0,0,0,0,43,95,5,0,0,0,0,0,0,100,0,0,0
21,Kentucky/KY,2101000,"Kentucky River Area Development District PUMA, Kentucky/KY",21189,"Owsley County, Kentucky",4463,37,1,829,22,0.042,8,0,0,0,0,0,8,0,0,0,0,0,8,100,0,0,0,0,0,0,0,100,0,0,0
21,Kentucky/KY,2101000,"Kentucky River Area Development District PUMA, Kentucky/KY",21193,"Perry County, Kentucky",26917,331,9,1230,33,0.254,50,0,0,3,0,0,53,0,0,0,0,0,53,94,6,0,0,0,0,0,0,100,0,0,0
21,Kentucky/KY,2101000,"Kentucky River Area Development District PUMA, Kentucky/KY",21237,"Wolfe County, Kentucky",7223,32,0,443,0,0.066,13,0,0,1,0,0,14,0,0,0,0,0,14,93,7,0,0,0,0,0,0,100,0,0,0
21,Kentucky/KY,2101100,"Big Sandy Area Development District PUMA, Kentucky/KY",21071,"Floyd County, Kentucky",36926,179,2,485,5,0.255,152,0,0,0,0,0,152,0,0,0,0,0,152,100,0,0,0,0,0,0,0,100,0,0,0
21,Kentucky/KY,2101100,"Big Sandy Area Development District PUMA, Kentucky/KY",21115,"Johnson County, Kentucky",22843,150,1,657,4,0.158,94,0,0,0,0,0,94,0,0,0,0,0,94,100,0,0,0,0,0,0,0,100,0,0,0
21,Kentucky/KY,2101100,"Big Sandy Area Development District PUMA, Kentucky/KY",21153,"Magoffin County, Kentucky",12666,83,0,655,0,0.087,52,0,0,0,0,0,52,0,0,0,0,0,52,100,0,0,0,0,0,0,0,100,0,0,0
21,Kentucky/KY,2101100,"Big Sandy Area Development District PUMA, Kentucky/KY",21159,"Martin County, Kentucky",11919,77,3,646,25,0.083,49,0,0,0,0,0,49,0,0,0,0,0,49,100,0,0,0,0,0,0,0,100,0,0,0
21,Kentucky/KY,2101100,"Big Sandy Area Development District PUMA, Kentucky/KY",21195,"Pike County, Kentucky",60483,417,3,689,5,0.417,248,0,0,0,0,0,248,0,0,0,0,0,248,100,0,0,0,0,0,0,0,100,0,0,0
21,Kentucky/KY,2101200,"Lincoln Trail Area Development District (East) PUMA, Kentucky/KY",21093,"Hardin County, Kentucky",108095,1287,12,1191,11,0.165,70,0,30,0,0,0,70,0,30,0,30,30,100,70,0,0,30,0,0,0,30,70,30,0,30
21,Kentucky/KY,2101200,"Lincoln Trail Area Development District (East) PUMA, Kentucky/KY",21123,"Larue County, Kentucky",14156,148,1,1045,7,0.129,55,0,24,0,0,0,55,0,24,0,24,24,79,70,0,0,30,0,0,0,30,70,30,0,30
21,Kentucky/KY,2101200,"Lincoln Trail Area Development District (East) PUMA, Kentucky/KY",21155,"Marion County, Kentucky",19232,225,10,1170,52,0.176,75,0,32,0,0,0,75,0,32,0,32,32,107,70,0,0,30,0,0,0,30,70,30,0,30
21,Kentucky/KY,2101200,"Lincoln Trail Area Development District (East) PUMA, Kentucky/KY",21179,"Nelson County, Kentucky",45388,496,4,1093,9,0.418,178,0,77,0,0,0,178,0,77,0,77,77,255,70,0,0,30,0,0,0,30,70,30,0,30
21,Kentucky/KY,2101200,"Lincoln Trail Area Development District (East) PUMA, Kentucky/KY",21229,"Washington County, Kentucky",12019,144,1,1198,8,0.112,48,0,21,0,0,0,48,0,21,0,21,21,69,70,0,0,30,0,0,0,30,70,30,0,30
21,Kentucky/KY,2101300,"Lincoln Trail Area Development District (West) PUMA, Kentucky/KY",21027,"Breckinridge County, Kentucky",20080,135,2,672,10,0.122,155,0,3,0,0,0,155,0,3,0,3,3,158,98,0,0,2,0,0,0,2,98,2,0,2
21,Kentucky/KY,2101300,"Lincoln Trail Area Development District (West) PUMA, Kentucky/KY",21085,"Grayson County, Kentucky",26178,392,14,1497,53,0.16,203,0,4,0,0,0,203,0,4,0,4,4,207,98,0,0,2,0,0,0,2,98,2,0,2
21,Kentucky/KY,2101300,"Lincoln Trail Area Development District (West) PUMA, Kentucky/KY",21093,"Hardin County, Kentucky",108095,1287,12,1191,11,0.546,693,0,14,0,0,0,693,0,14,0,14,14,707,98,0,0,2,0,0,0,2,98,2,0,2
21,Kentucky/KY,2101300,"Lincoln Trail Area Development District (West) PUMA, Kentucky/KY",21163,"Meade County, Kentucky",28326,235,3,830,11,0.172,218,0,4,0,0,0,218,0,4,0,4,4,222,98,0,0,2,0,0,0,2,98,2,0,2
21,Kentucky/KY,2101400,"Green River Area Development District (Southwest) PUMA, Kentucky/KY",21101,"Henderson County, Kentucky",46137,707,4,1532,9,0.427,598,9,41,21,0,0,619,9,41,0,50,50,669,89,3,0,7,0,1,0,6,93,7,1,6
21,Kentucky/KY,2101400,"Green River Area Development District (Southwest) PUMA, Kentucky/KY",21149,"McLean County, Kentucky",9331,78,0,836,0,0.087,122,2,8,4,0,0,126,2,8,0,10,10,136,90,3,0,7,0,1,0,6,93,7,1,6
21,Kentucky/KY,2101400,"Green River Area Development District (Southwest) PUMA, Kentucky/KY",21183,"Ohio County, Kentucky",24071,463,9,1923,37,0.225,315,5,22,11,0,0,326,5,22,0,27,27,353,89,3,0,8,0,1,0,6,92,8,1,6
21,Kentucky/KY,2101400,"Green River Area Development District (Southwest) PUMA, Kentucky/KY",21225,"Union County, Kentucky",14802,318,3,2148,20,0.137,192,3,13,7,0,0,199,3,13,0,16,16,215,89,3,0,7,0,1,0,6,93,7,1,6
21,Kentucky/KY,2101400,"Green River Area Development District (Southwest) PUMA, Kentucky/KY",21233,"Webster County, Kentucky",13155,161,3,1224,23,0.123,172,3,12,6,0,0,178,3,12,0,15,15,193,89,3,0,8,0,2,0,6,92,8,2,6
21,Kentucky/KY,2101500,"Green River Area Development District (Northeast)--Daviess & Hancock Counties PUMA, Kentucky/KY",21059,"Daviess County, Kentucky",99937,1359,16,1360,16,0.919,793,28,220,0,18,92,793,46,312,110,248,358,1151,69,0,10,22,2,2,8,19,69,31,4,27
21,Kentucky/KY,2101500,"Green River Area Development District (Northeast)--Daviess & Hancock Counties PUMA, Kentucky/KY",21091,"Hancock County, Kentucky",8719,80,0,918,0,0.081,70,3,19,0,2,8,70,5,27,10,22,32,102,69,0,10,22,2,3,8,19,69,31,5,26
21,Kentucky/KY,2101600,"KIPDA Area Development District (Southeast) PUMA, Kentucky/KY",21029,"Bullitt County, Kentucky",79466,860,9,1082,11,0.69,250,0,199,0,0,0,250,0,199,0,199,199,449,56,0,0,44,0,0,0,44,56,44,0,44
21,Kentucky/KY,2101600,"KIPDA Area Development District (Southeast) PUMA, Kentucky/KY",21211,"Shelby County, Kentucky",46786,1055,25,2255,53,0.151,55,0,44,0,0,0,55,0,44,0,44,44,99,56,0,0,44,0,0,0,44,56,44,0,44
21,Kentucky/KY,2101600,"KIPDA Area Development District (Southeast) PUMA, Kentucky/KY",21215,"Spencer County, Kentucky",18246,208,0,1140,0,0.159,58,0,46,0,0,0,58,0,46,0,46,46,104,56,0,0,44,0,0,0,44,56,44,0,44
21,Kentucky/KY,2101701,"KIPDA Area Development District (West)--Louisville/Jefferson County (Northwest) PUMA, Kentucky/KY",21111,"Jefferson County, Kentucky",767154,16652,319,2171,42,1,451,29,89,10,0,14,461,29,103,14,118,132,593,76,2,2,20,0,5,2,15,78,22,5,17
21,Kentucky/KY,2101702,"KIPDA Area Development District (West)--Louisville/Jefferson County (North Central) PUMA, Kentucky/KY",21111,"Jefferson County, Kentucky",767154,16652,319,2171,42,1,168,0,28,19,18,38,187,18,66,56,28,84,271,62,7,21,10,7,0,14,10,69,31,7,24
21,Kentucky/KY,2101703,"KIPDA Area Development District (West)--Louisville/Jefferson County (Northeast) PUMA, Kentucky/KY",21111,"Jefferson County, Kentucky",767154,16652,319,2171,42,1,90,3,0,11,0,19,101,3,19,19,3,22,123,73,9,15,2,0,2,15,0,82,18,2,15
21,Kentucky/KY,2101704,"KIPDA Area Development District (West)--Louisville/Jefferson County (Southeast) PUMA, Kentucky/KY",21111,"Jefferson County, Kentucky",767154,16652,319,2171,42,1,201,0,180,8,75,74,209,75,254,149,180,329,538,37,1,28,33,14,0,14,33,39,61,14,47
21,Kentucky/KY,2101705,"KIPDA Area Development District (West)--Louisville/Jefferson County (South Central) PUMA, Kentucky/KY",21111,"Jefferson County, Kentucky",767154,16652,319,2171,42,1,378,84,209,8,21,89,386,105,298,110,293,403,789,48,1,14,37,3,11,11,26,49,51,13,38
21,Kentucky/KY,2101706,"KIPDA Area Development District (West)--Louisville/Jefferson County (Southwest) PUMA, Kentucky/KY",21111,"Jefferson County, Kentucky",767154,16652,319,2171,42,1,568,0,191,94,0,230,662,0,421,230,191,421,1083,52,9,21,18,0,0,21,18,61,39,0,39
21,Kentucky/KY,2101800,"KIPDA Area Development District (Northeast) PUMA, Kentucky/KY",21103,"Henry County, Kentucky",15814,194,2,1227,13,0.133,68,0,9,0,0,0,68,0,9,0,9,9,77,88,0,0,12,0,0,0,12,88,12,0,12
21,Kentucky/KY,2101800,"KIPDA Area Development District (Northeast) PUMA, Kentucky/KY",21185,"Oldham County, Kentucky",65374,1109,25,1696,38,0.55,281,0,38,0,0,0,281,0,38,0,38,38,319,88,0,0,12,0,0,0,12,88,12,0,12
21,Kentucky/KY,2101800,"KIPDA Area Development District (Northeast) PUMA, Kentucky/KY",21211,"Shelby County, Kentucky",46786,1055,25,2255,53,0.244,125,0,17,0,0,0,125,0,17,0,17,17,142,88,0,0,12,0,0,0,12,88,12,0,12
21,Kentucky/KY,2101800,"KIPDA Area Development District (Northeast) PUMA, Kentucky/KY",21223,"Trimble County, Kentucky",8637,63,0,729,0,0.072,37,0,5,0,0,0,37,0,5,0,5,5,42,88,0,0,12,0,0,0,12,88,12,0,12
21,Kentucky/KY,2101901,"Bluegrass Area Development District (Central)--Lexington-Fayette County (Central) PUMA, Kentucky/KY",21067,"Fayette County, Kentucky",318734,8162,73,2561,23,1,188,57,521,0,0,115,188,57,636,115,578,693,881,21,0,13,66,0,6,13,59,21,79,6,72
21,Kentucky/KY,2101902,"Bluegrass Area Development District (Central)--Lexington-Fayette County (Outer) PUMA, Kentucky/KY",21067,"Fayette County, Kentucky",318734,8162,73,2561,23,1,488,31,495,14,15,34,502,46,529,49,526,575,1077,45,1,5,49,1,3,3,46,47,53,4,49
21,Kentucky/KY,2102000,"Bluegrass Area Development District (West) PUMA, Kentucky/KY",21005,"Anderson County, Kentucky",22214,155,1,698,5,0.184,108,0,67,2,6,17,110,6,84,23,67,90,200,54,1,12,34,3,0,8,34,55,45,3,42
21,Kentucky/KY,2102000,"Bluegrass Area Development District (West) PUMA, Kentucky/KY",21073,"Franklin County, Kentucky",50296,635,11,1263,22,0.42,247,0,153,4,13,39,251,13,192,52,153,205,456,54,1,11,34,3,0,9,34,55,45,3,42
21,Kentucky/KY,2102000,"Bluegrass Area Development District (West) PUMA, Kentucky/KY",21167,"Mercer County, Kentucky",21516,218,2,1013,9,0.179,105,0,65,2,5,17,107,5,82,22,65,87,194,54,1,11,34,3,0,9,34,55,45,3,42
21,Kentucky/KY,2102000,"Bluegrass Area Development District (West) PUMA, Kentucky/KY",21239,"Woodford County, Kentucky",26097,270,0,1035,0,0.217,127,0,79,2,7,20,129,7,99,27,79,106,235,54,1,11,34,3,0,9,34,55,45,3,42
21,Kentucky/KY,2102100,"Bluegrass Area Development District (South) PUMA, Kentucky/KY",21021,"Boyle County, Kentucky",29913,276,0,923,0,0.242,88,0,58,7,0,6,95,0,64,6,58,64,159,55,4,4,36,0,0,4,36,60,40,0,40
21,Kentucky/KY,2102100,"Bluegrass Area Development District (South) PUMA, Kentucky/KY",21079,"Garrard County, Kentucky",17328,154,3,889,17,0.139,50,0,33,4,0,3,54,0,36,3,33,36,90,56,4,3,37,0,0,3,37,60,40,0,40
21,Kentucky/KY,2102100,"Bluegrass Area Development District (South) PUMA, Kentucky/KY",21113,"Jessamine County, Kentucky",52422,590,0,1125,0,0.422,153,0,101,11,0,11,164,0,112,11,101,112,276,55,4,4,37,0,0,4,37,59,41,0,41
21,Kentucky/KY,2102100,"Bluegrass Area Development District (South) PUMA, Kentucky/KY",21137,"Lincoln County, Kentucky",24458,188,13,769,53,0.196,71,0,47,5,0,5,76,0,52,5,47,52,128,55,4,4,37,0,0,4,37,59,41,0,41
21,Kentucky/KY,2102200,"Bluegrass Area Development District (Southeast) PUMA, Kentucky/KY",21065,"Estill County, Kentucky",14313,152,0,1062,0,0.123,65,4,3,0,0,0,65,4,3,0,7,7,72,90,0,0,10,0,6,0,4,90,10,6,4
21,Kentucky/KY,2102200,"Bluegrass Area Development District (Southeast) PUMA, Kentucky/KY",21151,"Madison County, Kentucky",89700,1724,7,1922,8,0.771,406,27,16,0,0,0,406,27,16,0,43,43,449,90,0,0,10,0,6,0,4,90,10,6,4
21,Kentucky/KY,2102200,"Bluegrass Area Development District (Southeast) PUMA, Kentucky/KY",21197,"Powell County, Kentucky",12321,93,0,755,0,0.106,56,4,2,0,0,0,56,4,2,0,6,6,62,90,0,0,10,0,6,0,3,90,10,6,3
21,Kentucky/KY,2102300,"Bluegrass Area Development District (Northeast) PUMA, Kentucky/KY",21017,"Bourbon County, Kentucky",20144,194,1,963,5,0.148,58,0,34,4,0,0,62,0,34,0,34,34,96,60,4,0,35,0,0,0,35,65,35,0,35
21,Kentucky/KY,2102300,"Bluegrass Area Development District (Northeast) PUMA, Kentucky/KY",21049,"Clark County, Kentucky",35872,309,8,861,22,0.264,103,0,61,7,0,0,110,0,61,0,61,61,171,60,4,0,36,0,0,0,36,64,36,0,36
21,Kentucky/KY,2102300,"Bluegrass Area Development District (Northeast) PUMA, Kentucky/KY",21097,"Harrison County, Kentucky",18668,176,0,943,0,0.138,54,0,32,3,0,0,57,0,32,0,32,32,89,61,3,0,36,0,0,0,36,64,36,0,36
21,Kentucky/KY,2102300,"Bluegrass Area Development District (Northeast) PUMA, Kentucky/KY",21181,"Nicholas County, Kentucky",7100,32,1,451,14,0.052,20,0,12,1,0,0,21,0,12,0,12,12,33,61,3,0,36,0,0,0,36,64,36,0,36
21,Kentucky/KY,2102300,"Bluegrass Area Development District (Northeast) PUMA, Kentucky/KY",21209,"Scott County, Kentucky",53517,746,10,1394,19,0.398,156,0,92,10,0,0,166,0,92,0,92,92,258,60,4,0,36,0,0,0,36,64,36,0,36
21,Kentucky/KY,2102400,"Northern Kentucky Area Development District (North Central)--Kenton County PUMA, Kentucky/KY",21117,"Kenton County, Kentucky",164688,2005,45,1217,27,1,457,17,0,0,0,0,457,17,0,0,17,17,474,96,0,0,4,0,4,0,0,96,4,4,0
21,Kentucky/KY,2102500,"Northern Kentucky Area Development District (Northwest)--Boone County PUMA, Kentucky/KY",21015,"Boone County, Kentucky",129095,1550,25,1201,19,1,390,119,18,27,0,0,417,119,18,0,137,137,554,70,5,0,25,0,21,0,3,75,25,21,3
21,Kentucky/KY,2102600,"Northern Kentucky Area Development District (Southeast) PUMA, Kentucky/KY",21037,"Campbell County, Kentucky",92267,864,19,936,21,0.571,420,0,9,0,0,0,420,0,9,0,9,9,429,98,0,0,2,0,0,0,2,98,2,0,2
21,Kentucky/KY,2102600,"Northern Kentucky Area Development District (Southeast) PUMA, Kentucky/KY",21041,"Carroll County, Kentucky",10711,199,5,1858,47,0.066,49,0,1,0,0,0,49,0,1,0,1,1,50,98,0,0,2,0,0,0,2,98,2,0,2
21,Kentucky/KY,2102600,"Northern Kentucky Area Development District (Southeast) PUMA, Kentucky/KY",21077,"Gallatin County, Kentucky",8703,99,8,1138,92,0.053,39,0,1,0,0,0,39,0,1,0,1,1,40,98,0,0,2,0,0,0,2,98,2,0,2
21,Kentucky/KY,2102600,"Northern Kentucky Area Development District (Southeast) PUMA, Kentucky/KY",21081,"Grant County, Kentucky",24915,162,6,650,24,0.154,113,0,2,0,0,0,113,0,2,0,2,2,115,98,0,0,2,0,0,0,2,98,2,0,2
21,Kentucky/KY,2102600,"Northern Kentucky Area Development District (Southeast) PUMA, Kentucky/KY",21187,"Owen County, Kentucky",10741,99,2,922,19,0.066,49,0,1,0,0,0,49,0,1,0,1,1,50,98,0,0,2,0,0,0,2,98,2,0,2
21,Kentucky/KY,2102600,"Northern Kentucky Area Development District (Southeast) PUMA, Kentucky/KY",21191,"Pendleton County, Kentucky",14520,99,0,682,0,0.09,66,0,1,0,0,0,66,0,1,0,1,1,67,99,0,0,1,0,0,0,1,99,1,0,1
21,Kentucky/KY,2102700,"Buffalo Trace & Gateway Area Development Districts PUMA, Kentucky/KY",21011,"Bath County, Kentucky",12268,87,1,709,8,0.088,143,0,2,0,0,0,143,0,2,0,2,2,145,99,0,0,1,0,0,0,1,99,1,0,1
21,Kentucky/KY,2102700,"Buffalo Trace & Gateway Area Development Districts PUMA, Kentucky/KY",21023,"Bracken County, Kentucky",8306,40,0,482,0,0.06,97,0,1,0,0,0,97,0,1,0,1,1,98,99,0,0,1,0,0,0,1,99,1,0,1
21,Kentucky/KY,2102700,"Buffalo Trace & Gateway Area Development Districts PUMA, Kentucky/KY",21069,"Fleming County, Kentucky",14479,84,0,580,0,0.104,168,0,2,0,0,0,168,0,2,0,2,2,170,99,0,0,1,0,0,0,1,99,1,0,1
21,Kentucky/KY,2102700,"Buffalo Trace & Gateway Area Development Districts PUMA, Kentucky/KY",21135,"Lewis County, Kentucky",13490,221,14,1638,104,0.096,156,0,2,0,0,0,156,0,2,0,2,2,158,99,0,0,1,0,0,0,1,99,1,0,1
21,Kentucky/KY,2102700,"Buffalo Trace & Gateway Area Development Districts PUMA, Kentucky/KY",21161,"Mason County, Kentucky",17153,122,2,711,12,0.123,199,0,2,0,0,0,199,0,2,0,2,2,201,99,0,0,1,0,0,0,1,99,1,0,1
21,Kentucky/KY,2102700,"Buffalo Trace & Gateway Area Development Districts PUMA, Kentucky/KY",21165,"Menifee County, Kentucky",6405,45,0,703,0,0.046,75,0,1,0,0,0,75,0,1,0,1,1,76,99,0,0,1,0,0,0,1,99,1,0,1
21,Kentucky/KY,2102700,"Buffalo Trace & Gateway Area Development Districts PUMA, Kentucky/KY",21173,"Montgomery County, Kentucky",27759,277,3,998,11,0.198,321,0,4,0,0,0,321,0,4,0,4,4,325,99,0,0,1,0,0,0,1,99,1,0,1
21,Kentucky/KY,2102700,"Buffalo Trace & Gateway Area Development Districts PUMA, Kentucky/KY",21175,"Morgan County, Kentucky",13285,55,0,414,0,0.095,154,0,2,0,0,0,154,0,2,0,2,2,156,99,0,0,1,0,0,0,1,99,1,0,1
21,Kentucky/KY,2102700,"Buffalo Trace & Gateway Area Development Districts PUMA, Kentucky/KY",21201,"Robertson County, Kentucky",2143,12,0,560,0,0.015,24,0,0,0,0,0,24,0,0,0,0,0,24,100,0,0,0,0,0,0,0,100,0,0,0
21,Kentucky/KY,2102700,"Buffalo Trace & Gateway Area Development Districts PUMA, Kentucky/KY",21205,"Rowan County, Kentucky",24499,218,1,890,4,0.175,284,0,4,0,0,0,284,0,4,0,4,4,288,99,0,0,1,0,0,0,1,99,1,0,1
21,Kentucky/KY,2102800,"FIVCO Area Development District PUMA, Kentucky/KY",21019,"Boyd County, Kentucky",48091,426,6,886,12,0.358,144,0,0,0,0,0,144,0,0,0,0,0,144,100,0,0,0,0,0,0,0,100,0,0,0
21,Kentucky/KY,2102800,"FIVCO Area Development District PUMA, Kentucky/KY",21043,"Carter County, Kentucky",27290,173,3,634,11,0.201,81,0,0,0,0,0,81,0,0,0,0,0,81,100,0,0,0,0,0,0,0,100,0,0,0
21,Kentucky/KY,2102800,"FIVCO Area Development District PUMA, Kentucky/KY",21063,"Elliott County, Kentucky",7517,39,0,519,0,0.056,23,0,0,0,0,0,23,0,0,0,0,0,23,100,0,0,0,0,0,0,0,100,0,0,0
21,Kentucky/KY,2102800,"FIVCO Area Development District PUMA, Kentucky/KY",21089,"Greenup County, Kentucky",35765,396,4,1107,11,0.267,107,0,0,0,0,0,107,0,0,0,0,0,107,100,0,0,0,0,0,0,0,100,0,0,0
21,Kentucky/KY,2102800,"FIVCO Area Development District PUMA, Kentucky/KY",21127,"Lawrence County, Kentucky",15783,56,0,355,0,0.118,47,0,0,0,0,0,47,0,0,0,0,0,47,100,0,0,0,0,0,0,0,100,0,0,0
22,Louisiana/LA,2200100,"Coordinating & Development Corporation 1--Shreveport City (North) PUMA, Louisiana/LA",22017,"Caddo Parish, Louisiana",248361,8457,353,3405,142,1,168,0,0,33,12,0,201,12,0,12,0,12,213,79,15,6,0,6,0,0,0,94,6,6,0
22,Louisiana/LA,2200101,"Coordinating & Development Corporation 2--Shreveport City (South) PUMA, Louisiana/LA",22017,"Caddo Parish, Louisiana",248361,8457,353,3405,142,1,109,0,0,0,0,0,109,0,0,0,0,0,109,100,0,0,0,0,0,0,0,100,0,0,0
22,Louisiana/LA,2200200,"Coordinating & Development Corporation 3--Bossier & Webster Parishes PUMA, Louisiana/LA",22015,"Bossier Parish, Louisiana",126131,3241,106,2570,84,0.76,142,0,0,0,0,0,142,0,0,0,0,0,142,100,0,0,0,0,0,0,0,100,0,0,0
22,Louisiana/LA,2200200,"Coordinating & Development Corporation 3--Bossier & Webster Parishes PUMA, Louisiana/LA",22119,"Webster Parish, Louisiana",39631,1232,23,3109,58,0.24,45,0,0,0,0,0,45,0,0,0,0,0,45,100,0,0,0,0,0,0,0,100,0,0,0
22,Louisiana/LA,2200300,"Coordinating & Development Corporation 4--Northwest Louisiana PUMA, Louisiana/LA",22013,"Bienville Parish, Louisiana",13668,478,32,3497,234,0.079,133,0,5,1,0,0,134,0,5,0,5,5,139,96,1,0,4,0,0,0,4,96,4,0,4
22,Louisiana/LA,2200300,"Coordinating & Development Corporation 4--Northwest Louisiana PUMA, Louisiana/LA",22027,"Claiborne Parish, Louisiana",16153,508,23,3145,142,0.091,154,0,6,1,0,0,155,0,6,0,6,6,161,96,1,0,4,0,0,0,4,96,4,0,4
22,Louisiana/LA,2200300,"Coordinating & Development Corporation 4--Northwest Louisiana PUMA, Louisiana/LA",22031,"De Soto Parish, Louisiana",27216,895,35,3289,129,0.154,260,0,10,2,0,0,262,0,10,0,10,10,272,96,1,0,4,0,0,0,4,96,4,0,4
22,Louisiana/LA,2200300,"Coordinating & Development Corporation 4--Northwest Louisiana PUMA, Louisiana/LA",22061,"Lincoln Parish, Louisiana",47356,1269,48,2680,101,0.27,455,0,17,4,0,0,459,0,17,0,17,17,476,96,1,0,4,0,0,0,4,96,4,0,4
22,Louisiana/LA,2200300,"Coordinating & Development Corporation 4--Northwest Louisiana PUMA, Louisiana/LA",22069,"Natchitoches Parish, Louisiana",38963,1129,26,2898,67,0.222,375,0,14,3,0,0,378,0,14,0,14,14,392,96,1,0,4,0,0,0,4,96,4,0,4
22,Louisiana/LA,2200300,"Coordinating & Development Corporation 4--Northwest Louisiana PUMA, Louisiana/LA",22081,"Red River Parish, Louisiana",8618,356,22,4131,255,0.048,81,0,3,1,0,0,82,0,3,0,3,3,85,95,1,0,4,0,0,0,4,96,4,0,4
22,Louisiana/LA,2200300,"Coordinating & Development Corporation 4--Northwest Louisiana PUMA, Louisiana/LA",22085,"Sabine Parish, Louisiana",24088,848,13,3520,54,0.136,229,0,9,2,0,0,231,0,9,0,9,9,240,95,1,0,4,0,0,0,4,96,4,0,4
22,Louisiana/LA,2200400,"North Delta Regional Planning & Development District 1--Ouachita Parish PUMA, Louisiana/LA",22073,"Ouachita Parish, Louisiana",156075,6193,142,3968,91,1,171,0,0,0,0,0,171,0,0,0,0,0,171,100,0,0,0,0,0,0,0,100,0,0,0
22,Louisiana/LA,2200500,"North Delta Regional Planning & Development District 2--Northeast Louisiana PUMA, Louisiana/LA",22021,"Caldwell Parish, Louisiana",9996,300,3,3001,30,0.067,133,0,8,9,0,0,142,0,8,0,8,8,150,89,6,0,5,0,0,0,5,95,5,0,5
22,Louisiana/LA,2200500,"North Delta Regional Planning & Development District 2--Northeast Louisiana PUMA, Louisiana/LA",22035,"East Carroll Parish, Louisiana",7225,543,4,7516,55,0.049,97,0,5,6,0,0,103,0,5,0,5,5,108,90,6,0,5,0,0,0,5,95,5,0,5
22,Louisiana/LA,2200500,"North Delta Regional Planning & Development District 2--Northeast Louisiana PUMA, Louisiana/LA",22041,"Franklin Parish, Louisiana",20322,1202,38,5915,187,0.136,270,0,15,18,0,0,288,0,15,0,15,15,303,89,6,0,5,0,0,0,5,95,5,0,5
22,Louisiana/LA,2200500,"North Delta Regional Planning & Development District 2--Northeast Louisiana PUMA, Louisiana/LA",22049,"Jackson Parish, Louisiana",15926,640,22,4019,138,0.106,210,0,12,14,0,0,224,0,12,0,12,12,236,89,6,0,5,0,0,0,5,95,5,0,5
22,Louisiana/LA,2200500,"North Delta Regional Planning & Development District 2--Northeast Louisiana PUMA, Louisiana/LA",22065,"Madison Parish, Louisiana",11472,870,8,7584,70,0.077,153,0,9,10,0,0,163,0,9,0,9,9,172,89,6,0,5,0,0,0,5,95,5,0,5
22,Louisiana/LA,2200500,"North Delta Regional Planning & Development District 2--Northeast Louisiana PUMA, Louisiana/LA",22067,"Morehouse Parish, Louisiana",25992,776,22,2986,85,0.174,345,0,19,23,0,0,368,0,19,0,19,19,387,89,6,0,5,0,0,0,5,95,5,0,5
22,Louisiana/LA,2200500,"North Delta Regional Planning & Development District 2--Northeast Louisiana PUMA, Louisiana/LA",22083,"Richland Parish, Louisiana",20474,752,10,3673,49,0.136,270,0,15,18,0,0,288,0,15,0,15,15,303,89,6,0,5,0,0,0,5,95,5,0,5
22,Louisiana/LA,2200500,"North Delta Regional Planning & Development District 2--Northeast Louisiana PUMA, Louisiana/LA",22107,"Tensas Parish, Louisiana",4666,161,2,3450,43,0.031,62,0,3,4,0,0,66,0,3,0,3,3,69,90,6,0,4,0,0,0,4,96,4,0,4
22,Louisiana/LA,2200500,"North Delta Regional Planning & Development District 2--Northeast Louisiana PUMA, Louisiana/LA",22111,"Union Parish, Louisiana",22475,963,42,4285,187,0.15,298,0,17,20,0,0,318,0,17,0,17,17,335,89,6,0,5,0,0,0,5,95,5,0,5
22,Louisiana/LA,2200500,"North Delta Regional Planning & Development District 2--Northeast Louisiana PUMA, Louisiana/LA",22123,"West Carroll Parish, Louisiana",11180,345,10,3086,89,0.074,147,0,8,10,0,0,157,0,8,0,8,8,165,89,6,0,5,0,0,0,5,95,5,0,5
22,Louisiana/LA,2200600,"Kisatchie Delta Regional Planning & Development District 1 PUMA, Louisiana/LA",22009,"Avoyelles Parish, Louisiana",40882,1514,54,3703,132,0.335,81,0,12,1,0,0,82,0,12,0,12,12,94,86,1,0,13,0,0,0,13,87,13,0,13
22,Louisiana/LA,2200600,"Kisatchie Delta Regional Planning & Development District 1 PUMA, Louisiana/LA",22025,"Catahoula Parish, Louisiana",9893,433,10,4377,101,0.081,20,0,3,0,0,0,20,0,3,0,3,3,23,87,0,0,13,0,0,0,13,87,13,0,13
22,Louisiana/LA,2200600,"Kisatchie Delta Regional Planning & Development District 1 PUMA, Louisiana/LA",22029,"Concordia Parish, Louisiana",20021,510,13,2547,65,0.162,39,0,6,1,0,0,40,0,6,0,6,6,46,85,2,0,13,0,0,0,13,87,13,0,13
22,Louisiana/LA,2200600,"Kisatchie Delta Regional Planning & Development District 1 PUMA, Louisiana/LA",22043,"Grant Parish, Louisiana",22348,490,30,2193,134,0.182,44,0,7,1,0,0,45,0,7,0,7,7,52,85,2,0,13,0,0,0,13,87,13,0,13
22,Louisiana/LA,2200600,"Kisatchie Delta Regional Planning & Development District 1 PUMA, Louisiana/LA",22059,"LaSalle Parish, Louisiana",14949,425,7,2843,47,0.123,30,0,5,0,0,0,30,0,5,0,5,5,35,86,0,0,14,0,0,0,14,86,14,0,14
22,Louisiana/LA,2200600,"Kisatchie Delta Regional Planning & Development District 1 PUMA, Louisiana/LA",22127,"Winn Parish, Louisiana",14494,622,18,4291,124,0.117,28,0,4,0,0,0,28,0,4,0,4,4,32,88,0,0,12,0,0,0,12,88,12,0,12
22,Louisiana/LA,2200700,"Kisatchie Delta Regional Planning & Development District 2--Rapides & Vernon Parishes PUMA, Louisiana/LA",22079,"Rapides Parish, Louisiana",131546,4182,148,3179,113,0.724,221,21,84,43,0,11,264,21,95,11,105,116,380,58,11,3,28,0,6,3,22,69,31,6,25
22,Louisiana/LA,2200700,"Kisatchie Delta Regional Planning & Development District 2--Rapides & Vernon Parishes PUMA, Louisiana/LA",22115,"Vernon Parish, Louisiana",51007,1049,49,2057,96,0.276,84,8,32,17,0,4,101,8,36,4,40,44,145,58,12,3,28,0,6,3,22,70,30,6,25
22,Louisiana/LA,2200800,"Imperial Calcasieu Regional Planning & Development District 1 (North) PUMA, Louisiana/LA",22003,"Allen Parish, Louisiana",25661,1580,49,6157,191,0.172,30,0,0,0,0,0,30,0,0,0,0,0,30,100,0,0,0,0,0,0,0,100,0,0,0
22,Louisiana/LA,2200800,"Imperial Calcasieu Regional Planning & Development District 1 (North) PUMA, Louisiana/LA",22011,"Beauregard Parish, Louisiana",36769,995,37,2706,101,0.247,43,0,0,0,0,0,43,0,0,0,0,0,43,100,0,0,0,0,0,0,0,100,0,0,0
22,Louisiana/LA,2200800,"Imperial Calcasieu Regional Planning & Development District 1 (North) PUMA, Louisiana/LA",22019,"Calcasieu Parish, Louisiana",200182,7831,210,3912,105,0.581,102,0,1,0,0,0,102,0,1,0,1,1,103,99,0,0,1,0,0,0,1,99,1,0,1
22,Louisiana/LA,2200900,"Imperial Calcasieu Regional Planning & Development District 2 (South) PUMA, Louisiana/LA",22019,"Calcasieu Parish, Louisiana",200182,7831,210,3912,105,0.748,168,0,6,17,6,0,185,6,6,6,6,12,197,85,9,3,3,3,0,0,3,94,6,3,3
22,Louisiana/LA,2200900,"Imperial Calcasieu Regional Planning & Development District 2 (South) PUMA, Louisiana/LA",22023,"Cameron Parish, Louisiana",6868,226,2,3291,29,0.045,10,0,0,1,0,0,11,0,0,0,0,0,11,91,9,0,0,0,0,0,0,100,0,0,0
22,Louisiana/LA,2200900,"Imperial Calcasieu Regional Planning & Development District 2 (South) PUMA, Louisiana/LA",22053,"Jefferson Davis Parish, Louisiana",31467,1239,39,3937,124,0.207,47,0,2,5,2,0,52,2,2,2,2,4,56,84,9,4,4,4,0,0,4,93,7,4,4
22,Louisiana/LA,2201000,"Acadiana Regional Development District 1--St. Landry & Evangeline Parishes PUMA, Louisiana/LA",22039,"Evangeline Parish, Louisiana",33636,1314,32,3907,95,0.287,78,0,1,0,0,0,78,0,1,0,1,1,79,99,0,0,1,0,0,0,1,99,1,0,1
22,Louisiana/LA,2201000,"Acadiana Regional Development District 1--St. Landry & Evangeline Parishes PUMA, Louisiana/LA",22097,"St. Landry Parish, Louisiana",83449,3299,124,3953,149,0.713,193,0,4,0,0,0,193,0,4,0,4,4,197,98,0,0,2,0,0,0,2,98,2,0,2
22,Louisiana/LA,2201100,"Acadiana Regional Development District 2--Acadia & Vermilion Parishes PUMA, Louisiana/LA",22001,"Acadia Parish, Louisiana",62568,2946,96,4708,153,0.51,132,0,18,7,0,0,139,0,18,0,18,18,157,84,4,0,11,0,0,0,11,89,11,0,11
22,Louisiana/LA,2201100,"Acadiana Regional Development District 2--Acadia & Vermilion Parishes PUMA, Louisiana/LA",22113,"Vermilion Parish, Louisiana",59867,2038,61,3404,102,0.49,127,0,17,6,0,0,133,0,17,0,17,17,150,85,4,0,11,0,0,0,11,89,11,0,11
22,Louisiana/LA,2201200,"Acadiana Regional Development District 3--Lafayette Parish (North) PUMA, Louisiana/LA",22055,"Lafayette Parish, Louisiana",240091,8938,130,3723,54,1,159,0,77,0,0,0,159,0,77,0,77,77,236,67,0,0,33,0,0,0,33,67,33,0,33
22,Louisiana/LA,2201201,"Acadiana Regional Development District 4--Lafayette Parish (South) PUMA, Louisiana/LA",22055,"Lafayette Parish, Louisiana",240091,8938,130,3723,54,1,52,0,6,0,0,0,52,0,6,0,6,6,58,90,0,0,10,0,0,0,10,90,10,0,10
22,Louisiana/LA,2201300,"Acadiana Regional Development District 5--Iberia, St. Mary & St. Martin Parishes PUMA, Louisiana/LA",22045,"Iberia Parish, Louisiana",72691,2918,89,4014,122,0.408,341,16,52,5,0,0,346,16,52,0,68,68,414,82,1,0,16,0,4,0,13,84,16,4,13
22,Louisiana/LA,2201300,"Acadiana Regional Development District 5--Iberia, St. Mary & St. Martin Parishes PUMA, Louisiana/LA",22099,"St. Martin Parish, Louisiana",53752,2094,61,3896,113,0.301,252,12,38,4,0,0,256,12,38,0,50,50,306,82,1,0,16,0,4,0,12,84,16,4,12
22,Louisiana/LA,2201300,"Acadiana Regional Development District 5--Iberia, St. Mary & St. Martin Parishes PUMA, Louisiana/LA",22101,"St. Mary Parish, Louisiana",51734,1911,77,3694,149,0.29,243,11,37,4,0,0,247,11,37,0,48,48,295,82,1,0,16,0,4,0,13,84,16,4,13
22,Louisiana/LA,2201400,"Capital Region Planning Commission 1--Baton Rouge Metropolitan Area (West) PUMA, Louisiana/LA",22037,"East Feliciana Parish, Louisiana",19499,1739,67,8918,344,0.17,23,0,47,0,0,0,23,0,47,0,47,47,70,33,0,0,67,0,0,0,67,33,67,0,67
22,Louisiana/LA,2201400,"Capital Region Planning Commission 1--Baton Rouge Metropolitan Area (West) PUMA, Louisiana/LA",22047,"Iberville Parish, Louisiana",32956,1407,58,4269,176,0.284,39,0,78,0,0,0,39,0,78,0,78,78,117,33,0,0,67,0,0,0,67,33,67,0,67
22,Louisiana/LA,2201400,"Capital Region Planning Commission 1--Baton Rouge Metropolitan Area (West) PUMA, Louisiana/LA",22077,"Pointe Coupee Parish, Louisiana",22158,1055,40,4761,181,0.191,26,0,53,0,0,0,26,0,53,0,53,53,79,33,0,0,67,0,0,0,67,33,67,0,67
22,Louisiana/LA,2201400,"Capital Region Planning Commission 1--Baton Rouge Metropolitan Area (West) PUMA, Louisiana/LA",22121,"West Baton Rouge Parish, Louisiana",25860,903,41,3492,159,0.223,30,0,62,0,0,0,30,0,62,0,62,62,92,33,0,0,67,0,0,0,67,33,67,0,67
22,Louisiana/LA,2201400,"Capital Region Planning Commission 1--Baton Rouge Metropolitan Area (West) PUMA, Louisiana/LA",22125,"West Feliciana Parish, Louisiana",15377,752,25,4890,163,0.132,18,0,36,0,0,0,18,0,36,0,36,36,54,33,0,0,67,0,0,0,67,33,67,0,67
22,Louisiana/LA,2201500,"Capital Region Planning Commission 2--East Baton Rouge Parish (South) PUMA, Louisiana/LA",22033,"East Baton Rouge Parish, Louisiana",444094,15042,441,3387,99,1,129,0,0,0,15,0,129,15,0,15,0,15,144,90,0,10,0,10,0,0,0,90,10,10,0
22,Louisiana/LA,2201501,"Capital Region Planning Commission 3--Baton Rouge City PUMA, Louisiana/LA",22033,"East Baton Rouge Parish, Louisiana",444094,15042,441,3387,99,1,187,0,9,0,18,0,187,18,9,18,9,27,214,87,0,8,4,8,0,0,4,87,13,8,4
22,Louisiana/LA,2201502,"Capital Region Planning Commission 4--East Baton Rouge Parish (North) PUMA, Louisiana/LA",22033,"East Baton Rouge Parish, Louisiana",444094,15042,441,3387,99,1,273,0,0,0,19,0,273,19,0,19,0,19,292,93,0,7,0,7,0,0,0,93,7,7,0
22,Louisiana/LA,2201600,"Capital Region Planning Commission 5--Ascension Parish PUMA, Louisiana/LA",22005,"Ascension Parish, Louisiana",121176,3736,97,3083,80,1,312,0,0,0,0,20,312,0,20,20,0,20,332,94,0,6,0,0,0,6,0,94,6,0,6
22,Louisiana/LA,2201700,"Capital Region Planning Commission 6--Livingston & St. Helena Parishes PUMA, Louisiana/LA",22063,"Livingston Parish, Louisiana",138111,3758,74,2721,54,0.93,112,0,20,0,0,0,112,0,20,0,20,20,132,85,0,0,15,0,0,0,15,85,15,0,15
22,Louisiana/LA,2201700,"Capital Region Planning Commission 6--Livingston & St. Helena Parishes PUMA, Louisiana/LA",22091,"St. Helena Parish, Louisiana",10411,413,4,3967,38,0.07,8,0,2,0,0,0,8,0,2,0,2,2,10,80,0,0,20,0,0,0,20,80,20,0,20
22,Louisiana/LA,2201800,"Capital Region Planning Commission 7--Tangipahoa & Washington Parishes PUMA, Louisiana/LA",22105,"Tangipahoa Parish, Louisiana",130504,4441,118,3403,90,0.738,311,0,246,0,0,0,311,0,246,0,246,246,557,56,0,0,44,0,0,0,44,56,44,0,44
22,Louisiana/LA,2201800,"Capital Region Planning Commission 7--Tangipahoa & Washington Parishes PUMA, Louisiana/LA",22117,"Washington Parish, Louisiana",46457,1624,65,3496,140,0.262,111,0,88,0,0,0,111,0,88,0,88,88,199,56,0,0,44,0,0,0,44,56,44,0,44
22,Louisiana/LA,2201900,"South Central Planning & Development Commission 1--River Parishes PUMA, Louisiana/LA",22089,"St. Charles Parish, Louisiana",52724,1791,59,3397,112,0.448,155,0,1,5,0,0,160,0,1,0,1,1,161,96,3,0,1,0,0,0,1,99,1,0,1
22,Louisiana/LA,2201900,"South Central Planning & Development Commission 1--River Parishes PUMA, Louisiana/LA",22093,"St. James Parish, Louisiana",21357,805,40,3769,187,0.183,63,0,1,2,0,0,65,0,1,0,1,1,66,95,3,0,2,0,0,0,2,98,2,0,2
22,Louisiana/LA,2201900,"South Central Planning & Development Commission 1--River Parishes PUMA, Louisiana/LA",22095,"St. John the Baptist Parish, Louisiana",43446,1581,100,3639,230,0.369,128,0,1,4,0,0,132,0,1,0,1,1,133,96,3,0,1,0,0,0,1,99,1,0,1
22,Louisiana/LA,2202000,"South Central Planning & Development Commission 2--Lafourche & Assumption Parishes PUMA, Louisiana/LA",22007,"Assumption Parish, Louisiana",22714,758,24,3337,106,0.188,56,0,23,0,0,0,56,0,23,0,23,23,79,71,0,0,29,0,0,0,29,71,29,0,29
22,Louisiana/LA,2202000,"South Central Planning & Development Commission 2--Lafourche & Assumption Parishes PUMA, Louisiana/LA",22057,"Lafourche Parish, Louisiana",98214,3625,121,3691,123,0.812,241,0,100,0,0,0,241,0,100,0,100,100,341,71,0,0,29,0,0,0,29,71,29,0,29
22,Louisiana/LA,2202100,"South Central Planning & Development Commission 3--Terrebonne Parish PUMA, Louisiana/LA",22109,"Terrebonne Parish, Louisiana",112587,3623,113,3218,100,1,239,0,0,0,0,0,239,0,0,0,0,0,239,100,0,0,0,0,0,0,0,100,0,0,0
22,Louisiana/LA,2202200,"Regional Planning Commission 1--St. Tammany Parish (Northwest) PUMA, Louisiana/LA",22103,"St. Tammany Parish, Louisiana",252093,6907,252,2740,100,1,187,2,1,0,0,57,187,2,58,57,3,60,247,76,0,23,1,0,1,23,0,76,24,1,23
22,Louisiana/LA,2202201,"Regional Planning Commission 2--St. Tammany Parish (Southeast) PUMA, Louisiana/LA",22103,"St. Tammany Parish, Louisiana",252093,6907,252,2740,100,1,201,0,71,0,0,0,201,0,71,0,71,71,272,74,0,0,26,0,0,0,26,74,26,0,26
22,Louisiana/LA,2202300,"Regional Planning Commission 3--Jefferson Parish (North) PUMA, Louisiana/LA",22051,"Jefferson Parish, Louisiana",435300,17459,568,4011,130,1,51,0,0,0,0,52,51,0,52,52,0,52,103,50,0,50,0,0,0,50,0,50,50,0,50
22,Louisiana/LA,2202301,"Regional Planning Commission 4--Jefferson Parish (Central) PUMA, Louisiana/LA",22051,"Jefferson Parish, Louisiana",435300,17459,568,4011,130,1,231,0,34,0,0,0,231,0,34,0,34,34,265,87,0,0,13,0,0,0,13,87,13,0,13
22,Louisiana/LA,2202302,"Regional Planning Commission 5--Jefferson Parish (West Bank) PUMA, Louisiana/LA",22051,"Jefferson Parish, Louisiana",435300,17459,568,4011,130,1,114,0,0,0,57,0,114,57,0,57,0,57,171,67,0,33,0,33,0,0,0,67,33,33,0
22,Louisiana/LA,2202400,"Regional Planning Commission 6--New Orleans City (Northeast) PUMA, Louisiana/LA",22071,"Orleans Parish, Louisiana",389648,12524,587,3214,151,1,278,0,20,0,26,12,278,26,32,38,20,58,336,83,0,11,6,8,0,4,6,83,17,8,10
22,Louisiana/LA,2202401,"Regional Planning Commission 7--New Orleans City (Central) PUMA, Louisiana/LA",22071,"Orleans Parish, Louisiana",389648,12524,587,3214,151,1,134,13,6,10,0,0,144,13,6,0,19,19,163,82,6,0,12,0,8,0,4,88,12,8,4
22,Louisiana/LA,2202402,"Regional Planning Commission 8--New Orleans City (South) PUMA, Louisiana/LA",22071,"Orleans Parish, Louisiana",389648,12524,587,3214,151,1,150,0,10,0,0,0,150,0,10,0,10,10,160,94,0,0,6,0,0,0,6,94,6,0,6
22,Louisiana/LA,2202500,"Regional Planning Commission 9--St. Bernard, Jefferson (South) & Plaquemines Parishes PUMA, Louisiana/LA",22051,"Jefferson Parish, Louisiana",435300,17459,568,4011,130,0.446,167,0,78,3,0,0,170,0,78,0,78,78,248,67,1,0,31,0,0,0,31,69,31,0,31
22,Louisiana/LA,2202500,"Regional Planning Commission 9--St. Bernard, Jefferson (South) & Plaquemines Parishes PUMA, Louisiana/LA",22075,"Plaquemines Parish, Louisiana",23373,676,19,2892,81,0.188,70,0,33,1,0,0,71,0,33,0,33,33,104,67,1,0,32,0,0,0,32,68,32,0,32
22,Louisiana/LA,2202500,"Regional Planning Commission 9--St. Bernard, Jefferson (South) & Plaquemines Parishes PUMA, Louisiana/LA",22087,"St. Bernard Parish, Louisiana",45694,1401,29,3066,63,0.366,137,0,64,2,0,0,139,0,64,0,64,64,203,67,1,0,32,0,0,0,32,68,32,0,32
23,Maine/ME,2300100,"Northeast Maine--Aroostook & Washington Counties PUMA, Maine/ME",23003,"Aroostook County, Maine",68269,43,1,63,1,0.684,708,0,42,12,3,22,720,3,64,25,42,67,787,90,2,3,5,0,0,3,5,91,9,0,8
23,Maine/ME,2300100,"Northeast Maine--Aroostook & Washington Counties PUMA, Maine/ME",23029,"Washington County, Maine",31694,16,0,50,0,0.316,327,0,20,6,2,10,333,2,30,12,20,32,365,90,2,3,5,1,0,3,5,91,9,1,8
23,Maine/ME,2300200,"Northwest Maine--Oxford, Somerset, Franklin & Piscataquis Counties PUMA, Maine/ME",23007,"Franklin County, Maine",30019,61,1,203,3,0.194,169,0,0,0,0,1,169,0,1,1,0,1,170,99,0,1,0,0,0,1,0,99,1,0,1
23,Maine/ME,2300200,"Northwest Maine--Oxford, Somerset, Franklin & Piscataquis Counties PUMA, Maine/ME",23017,"Oxford County, Maine",57325,139,1,242,2,0.369,322,0,0,0,0,2,322,0,2,2,0,2,324,99,0,1,0,0,0,1,0,99,1,0,1
23,Maine/ME,2300200,"Northwest Maine--Oxford, Somerset, Franklin & Piscataquis Counties PUMA, Maine/ME",23021,"Piscataquis County, Maine",16887,9,0,53,0,0.109,95,0,0,0,0,1,95,0,1,1,0,1,96,99,0,1,0,0,0,1,0,99,1,0,1
23,Maine/ME,2300200,"Northwest Maine--Oxford, Somerset, Franklin & Piscataquis Counties PUMA, Maine/ME",23025,"Somerset County, Maine",50710,84,8,166,16,0.329,287,0,0,0,0,2,287,0,2,2,0,2,289,99,0,1,0,0,0,1,0,99,1,0,1
23,Maine/ME,2300300,"Penobscot County PUMA, Maine/ME",23019,"Penobscot County, Maine",151748,253,6,167,4,1,380,0,0,76,0,0,456,0,0,0,0,0,456,83,17,0,0,0,0,0,0,100,0,0,0
23,Maine/ME,2300400,"Kennebec County PUMA, Maine/ME",23011,"Kennebec County, Maine",121545,211,11,174,9,1,182,0,0,0,0,77,182,0,77,77,0,77,259,70,0,30,0,0,0,30,0,70,30,0,30
23,Maine/ME,2300500,"Coastal Maine Region--Hancock, Knox, Waldo & Lincoln Counties PUMA, Maine/ME",23009,"Hancock County, Maine",54541,53,1,97,2,0.324,279,0,0,0,3,10,279,3,10,13,0,13,292,96,0,4,0,1,0,3,0,96,4,1,3
23,Maine/ME,2300500,"Coastal Maine Region--Hancock, Knox, Waldo & Lincoln Counties PUMA, Maine/ME",23013,"Knox County, Maine",39823,36,1,90,3,0.237,204,0,0,0,2,7,204,2,7,9,0,9,213,96,0,4,0,1,0,3,0,96,4,1,3
23,Maine/ME,2300500,"Coastal Maine Region--Hancock, Knox, Waldo & Lincoln Counties PUMA, Maine/ME",23015,"Lincoln County, Maine",34067,42,1,123,3,0.204,175,0,0,0,2,6,175,2,6,8,0,8,183,96,0,4,0,1,0,3,0,96,4,1,3
23,Maine/ME,2300500,"Coastal Maine Region--Hancock, Knox, Waldo & Lincoln Counties PUMA, Maine/ME",23027,"Waldo County, Maine",39418,73,14,185,36,0.235,202,0,0,0,2,7,202,2,7,9,0,9,211,96,0,4,0,1,0,3,0,96,4,1,3
23,Maine/ME,2300600,"Androscoggin County PUMA, Maine/ME",23001,"Androscoggin County, Maine",107444,705,10,656,9,1,353,0,0,90,0,13,443,0,13,13,0,13,456,77,20,3,0,0,0,3,0,97,3,0,3
23,Maine/ME,2300700,"Sagadahoc & Cumberland (North) Counties--Bath City & Brunswick PUMA, Maine/ME",23005,"Cumberland County, Maine",290944,2302,70,791,24,0.666,199,0,0,0,0,0,199,0,0,0,0,0,199,100,0,0,0,0,0,0,0,100,0,0,0
23,Maine/ME,2300700,"Sagadahoc & Cumberland (North) Counties--Bath City & Brunswick PUMA, Maine/ME",23023,"Sagadahoc County, Maine",35277,66,0,187,0,0.334,100,0,0,0,0,0,100,0,0,0,0,0,100,100,0,0,0,0,0,0,0,100,0,0,0
23,Maine/ME,2300800,"South Maine--York (West) & Cumberland (West) Counties PUMA, Maine/ME",23005,"Cumberland County, Maine",290944,2302,70,791,24,0.145,27,0,0,0,0,0,27,0,0,0,0,0,27,100,0,0,0,0,0,0,0,100,0,0,0
23,Maine/ME,2300800,"South Maine--York (West) & Cumberland (West) Counties PUMA, Maine/ME",23031,"York County, Maine",203102,1141,15,562,7,0.855,161,0,0,0,0,0,161,0,0,0,0,0,161,100,0,0,0,0,0,0,0,100,0,0,0
23,Maine/ME,2300900,"Cumberland (Outside Portland) & York (East) Counties--Biddeford & Saco Cities PUMA, Maine/ME",23005,"Cumberland County, Maine",290944,2302,70,791,24,0.626,252,0,0,43,0,53,295,0,53,53,0,53,348,72,12,15,0,0,0,15,0,85,15,0,15
23,Maine/ME,2300900,"Cumberland (Outside Portland) & York (East) Counties--Biddeford & Saco Cities PUMA, Maine/ME",23031,"York County, Maine",203102,1141,15,562,7,0.374,151,0,0,25,0,32,176,0,32,32,0,32,208,73,12,15,0,0,0,15,0,85,15,0,15
23,Maine/ME,2301000,"Cumberland County (Southeast)--Portland, South Portland & Westbrook Cities PUMA, Maine/ME",23005,"Cumberland County, Maine",290944,2302,70,791,24,1,134,0,0,0,45,41,134,45,41,86,0,86,220,61,0,39,0,20,0,19,0,61,39,20,19
24,Maryland/MD,2400100,"Allegany & Garrett Counties--Cumberland City PUMA, Maryland/MD",24001,"Allegany County, Maryland",71977,460,22,639,31,0.71,102,0,0,0,0,0,102,0,0,0,0,0,102,100,0,0,0,0,0,0,0,100,0,0,0
24,Maryland/MD,2400100,"Allegany & Garrett Counties--Cumberland City PUMA, Maryland/MD",24023,"Garrett County, Maryland",29376,72,1,245,3,0.29,42,0,0,0,0,0,42,0,0,0,0,0,42,100,0,0,0,0,0,0,0,100,0,0,0
24,Maryland/MD,2400200,"Washington County--Hagerstown City PUMA, Maryland/MD",24043,"Washington County, Maryland",149811,1720,37,1148,25,1,530,0,24,0,0,0,530,0,24,0,24,24,554,96,0,0,4,0,0,0,4,96,4,0,4
24,Maryland/MD,2400301,"Frederick County (Outside Greater Frederick City) PUMA, Maryland/MD",24021,"Frederick County, Maryland",248472,4002,131,1611,53,1,250,0,4,0,0,0,250,0,4,0,4,4,254,98,0,0,2,0,0,0,2,98,2,0,2
24,Maryland/MD,2400302,"Frederick County (Central)--Greater Frederick City PUMA, Maryland/MD",24021,"Frederick County, Maryland",248472,4002,131,1611,53,1,330,0,112,0,41,0,330,41,112,41,112,153,483,68,0,8,23,8,0,0,23,68,32,8,23
24,Maryland/MD,2400400,"Carroll County PUMA, Maryland/MD",24013,"Carroll County, Maryland",167522,1940,125,1158,75,1,165,0,50,0,36,0,165,36,50,36,50,86,251,66,0,14,20,14,0,0,20,66,34,14,20
24,Maryland/MD,2400501,"Baltimore County (Outer) PUMA, Maryland/MD",24005,"Baltimore County, Maryland",827625,17743,622,2144,75,1,271,0,4,18,0,0,289,0,4,0,4,4,293,92,6,0,1,0,0,0,1,99,1,0,1
24,Maryland/MD,2400502,"Baltimore County--Randallstown (East), Owings Mills, Milford Mill & Reisterstown PUMA, Maryland/MD",24005,"Baltimore County, Maryland",827625,17743,622,2144,75,1,209,0,17,0,0,0,209,0,17,0,17,17,226,92,0,0,8,0,0,0,8,92,8,0,8
24,Maryland/MD,2400503,"Baltimore County--Pikesville (South), Lochearn, Cockeysville & Mays Chapel PUMA, Maryland/MD",24005,"Baltimore County, Maryland",827625,17743,622,2144,75,1,56,0,0,0,0,0,56,0,0,0,0,0,56,100,0,0,0,0,0,0,0,100,0,0,0
24,Maryland/MD,2400504,"Baltimore County--Towson (East & Central), Parkville & Carney PUMA, Maryland/MD",24005,"Baltimore County, Maryland",827625,17743,622,2144,75,1,166,0,1,0,0,0,166,0,1,0,1,1,167,99,0,0,1,0,0,0,1,99,1,0,1
24,Maryland/MD,2400505,"Baltimore County--Perry Hall, Middle River & Rosedale PUMA, Maryland/MD",24005,"Baltimore County, Maryland",827625,17743,622,2144,75,1,161,0,41,0,0,9,161,0,50,9,41,50,211,76,0,4,19,0,0,4,19,76,24,0,24
24,Maryland/MD,2400506,"Baltimore County--Dundalk, Essex & Edgemere PUMA, Maryland/MD",24005,"Baltimore County, Maryland",827625,17743,622,2144,75,1,239,0,6,0,0,18,239,0,24,18,6,24,263,91,0,7,2,0,0,7,2,91,9,0,9
24,Maryland/MD,2400507,"Baltimore County--Catonsville, Woodlawn & Arbutus PUMA, Maryland/MD",24005,"Baltimore County, Maryland",827625,17743,622,2144,75,1,166,0,187,0,0,157,166,0,344,157,187,344,510,33,0,31,37,0,0,31,37,33,67,0,67
24,Maryland/MD,2400601,"Harford County (North & West)--Bel Air Town, Fallston & Jarrettsville PUMA, Maryland/MD",24025,"Harford County, Maryland",251025,2990,76,1191,30,1,148,0,8,0,0,20,148,0,28,20,8,28,176,84,0,11,5,0,0,11,5,84,16,0,16
24,Maryland/MD,2400602,"Harford County (South & East)--Aberdeen & Havre de Grace Cities PUMA, Maryland/MD",24025,"Harford County, Maryland",251025,2990,76,1191,30,1,329,0,4,50,0,0,379,0,4,0,4,4,383,86,13,0,1,0,0,0,1,99,1,0,1
24,Maryland/MD,2400700,"Cecil County PUMA, Maryland/MD",24015,"Cecil County, Maryland",102517,1039,35,1013,34,1,351,0,74,0,17,0,351,17,74,17,74,91,442,79,0,4,17,4,0,0,17,79,21,4,17
24,Maryland/MD,2400801,"Baltimore City--Sandtown-Winchester, Ashburton & Mount Washington PUMA, Maryland/MD",24510,"Baltimore city, Maryland",614700,15449,486,2513,79,1,414,0,0,0,32,0,414,32,0,32,0,32,446,93,0,7,0,7,0,0,0,93,7,7,0
24,Maryland/MD,2400802,"Baltimore City--Guilford, Roland Park & Druid Lake PUMA, Maryland/MD",24510,"Baltimore city, Maryland",614700,15449,486,2513,79,1,139,0,0,0,0,0,139,0,0,0,0,0,139,100,0,0,0,0,0,0,0,100,0,0,0
24,Maryland/MD,2400803,"Baltimore City--Frankford, Belair-Edison & Loch Raven PUMA, Maryland/MD",24510,"Baltimore city, Maryland",614700,15449,486,2513,79,1,398,0,4,0,0,6,398,0,10,6,4,10,408,98,0,1,1,0,0,1,1,98,2,0,2
24,Maryland/MD,2400804,"Baltimore City--Inner Harbor, Canton & Bayview PUMA, Maryland/MD",24510,"Baltimore city, Maryland",614700,15449,486,2513,79,1,172,0,33,0,9,64,172,9,97,73,33,106,278,62,0,26,12,3,0,23,12,62,38,3,35
24,Maryland/MD,2400805,"Baltimore City--Irvington, Ten Hills & Cherry Hill PUMA, Maryland/MD",24510,"Baltimore city, Maryland",614700,15449,486,2513,79,1,182,0,7,7,0,0,189,0,7,0,7,7,196,93,4,0,4,0,0,0,4,96,4,0,4
24,Maryland/MD,2400901,"Howard County (West)--Columbia (West) & Ellicott City (Northwest) PUMA, Maryland/MD",24027,"Howard County, Maryland",315327,5019,123,1592,39,1,463,0,9,0,0,0,463,0,9,0,9,9,472,98,0,0,2,0,0,0,2,98,2,0,2
24,Maryland/MD,2400902,"Howard County (East)--Columbia (East), Ellicott City (Southeast) & Elkridge PUMA, Maryland/MD",24027,"Howard County, Maryland",315327,5019,123,1592,39,1,63,0,0,0,0,0,63,0,0,0,0,0,63,100,0,0,0,0,0,0,0,100,0,0,0
24,Maryland/MD,2401001,"Montgomery County (North & West)--Olney, Damascus, Clarksburg & Darnestown PUMA, Maryland/MD",24031,"Montgomery County, Maryland",1040133,22225,842,2137,81,1,122,0,79,107,0,0,229,0,79,0,79,79,308,40,35,0,26,0,0,0,26,74,26,0,26
24,Maryland/MD,2401002,"Montgomery County (West Central)--Germantown & Montgomery Village PUMA, Maryland/MD",24031,"Montgomery County, Maryland",1040133,22225,842,2137,81,1,0,9,25,30,0,0,30,9,25,0,34,34,64,0,47,0,53,0,14,0,39,47,53,14,39
24,Maryland/MD,2401003,"Montgomery County (Central)--Rockville, Gaithersburg Cities & North Potomac PUMA, Maryland/MD",24031,"Montgomery County, Maryland",1040133,22225,842,2137,81,1,142,0,50,0,25,24,142,25,74,49,50,99,241,59,0,20,21,10,0,10,21,59,41,10,31
24,Maryland/MD,2401004,"Montgomery County (South)--Bethesda, Potomac & North Bethesda PUMA, Maryland/MD",24031,"Montgomery County, Maryland",1040133,22225,842,2137,81,1,34,0,0,0,0,0,34,0,0,0,0,0,34,100,0,0,0,0,0,0,0,100,0,0,0
24,Maryland/MD,2401005,"Montgomery County (East Central)--Wheaton, Aspen Hill & Glenmont PUMA, Maryland/MD",24031,"Montgomery County, Maryland",1040133,22225,842,2137,81,1,0,23,0,36,0,53,36,23,53,53,23,76,112,0,32,47,21,0,21,47,0,32,68,21,47
24,Maryland/MD,2401006,"Montgomery County (East)--Fairland, Calverton, White Oak & Burtonsville PUMA, Maryland/MD",24031,"Montgomery County, Maryland",1040133,22225,842,2137,81,1,38,0,55,0,24,75,38,24,130,99,55,154,192,20,0,52,29,12,0,39,29,20,80,12,68
24,Maryland/MD,2401007,"Montgomery County (Southeast)--Takoma Park City & Silver Spring PUMA, Maryland/MD",24031,"Montgomery County, Maryland",1040133,22225,842,2137,81,1,45,34,84,0,0,169,45,34,253,169,118,287,332,14,0,51,36,0,10,51,25,14,86,10,76
24,Maryland/MD,2401101,"Prince George's County (Northwest)--College Park City & Langley Park PUMA, Maryland/MD",24033,"Prince George's County, Maryland",906202,29365,825,3240,91,1,54,0,272,0,0,44,54,0,316,44,272,316,370,15,0,12,74,0,0,12,74,15,85,0,85
24,Maryland/MD,2401102,"Prince George's County (North)--Laurel, Greenbelt (North & East) Cities & Beltsville PUMA, Maryland/MD",24033,"Prince George's County, Maryland",906202,29365,825,3240,91,1,0,14,34,0,34,14,0,48,48,48,48,96,96,0,0,50,50,35,15,15,35,0,100,50,50
24,Maryland/MD,2401103,"Prince George's County (Northwest)--New Carrollton & Hyattsville (Southeast) Cities PUMA, Maryland/MD",24033,"Prince George's County, Maryland",906202,29365,825,3240,91,1,0,0,84,20,20,14,20,20,98,34,84,118,138,0,14,25,61,14,0,10,61,14,86,14,71
24,Maryland/MD,2401104,"Prince George's County (Central)--Seat Pleasant City, Capitol Heights Town & Landover PUMA, Maryland/MD",24033,"Prince George's County, Maryland",906202,29365,825,3240,91,1,33,0,0,0,1,51,33,1,51,52,0,52,85,39,0,61,0,1,0,60,0,39,61,1,60
24,Maryland/MD,2401105,"Prince George's County (East)--Bowie City, Kettering, Largo, Mitchellville & Lanham PUMA, Maryland/MD",24033,"Prince George's County, Maryland",906202,29365,825,3240,91,1,56,0,2,0,0,16,56,0,18,16,2,18,74,76,0,22,3,0,0,22,3,76,24,0,24
24,Maryland/MD,2401106,"Prince George's County (South)--Clinton, Fort Washington (South), Rosaryville & Croom PUMA, Maryland/MD",24033,"Prince George's County, Maryland",906202,29365,825,3240,91,1,0,0,3,12,0,0,12,0,3,0,3,3,15,0,80,0,20,0,0,0,20,80,20,0,20
24,Maryland/MD,2401107,"Prince George's County (Southwest)--Oxon Hill, Hillcrest Heights & Temple Hills PUMA, Maryland/MD",24033,"Prince George's County, Maryland",906202,29365,825,3240,91,1,29,0,5,0,0,0,29,0,5,0,5,5,34,85,0,0,15,0,0,0,15,85,15,0,15
24,Maryland/MD,2401201,"Anne Arundel County (Northwest)--Severn, Odenton, Crofton, Maryland City & Fort Meade PUMA, Maryland/MD",24003,"Anne Arundel County, Maryland",567696,9885,246,1741,43,1,220,0,4,41,0,0,261,0,4,0,4,4,265,83,15,0,2,0,0,0,2,98,2,0,2
24,Maryland/MD,2401202,"Anne Arundel County (North)--Glen Burnie, Pasadena, Ferndale & Brooklyn Park PUMA, Maryland/MD",24003,"Anne Arundel County, Maryland",567696,9885,246,1741,43,1,177,0,11,0,0,62,177,0,73,62,11,73,250,71,0,25,4,0,0,25,4,71,29,0,29
24,Maryland/MD,2401203,"Anne Arundel County (Central)--Severna Park, Arnold & Lake Shore PUMA, Maryland/MD",24003,"Anne Arundel County, Maryland",567696,9885,246,1741,43,1,127,0,2,0,0,0,127,0,2,0,2,2,129,98,0,0,2,0,0,0,2,98,2,0,2
24,Maryland/MD,2401204,"Anne Arundel County (Southeast)--Annapolis City, Parole, Annapolis Neck & Edgewater PUMA, Maryland/MD",24003,"Anne Arundel County, Maryland",567696,9885,246,1741,43,1,143,0,4,16,0,0,159,0,4,0,4,4,163,88,10,0,2,0,0,0,2,98,2,0,2
24,Maryland/MD,2401300,"Queen Anne's, Talbot, Caroline, Dorchester & Kent Counties PUMA, Maryland/MD",24011,"Caroline County, Maryland",32875,640,6,1947,18,0.192,256,3,81,3,7,7,259,10,88,14,84,98,357,72,1,4,24,2,1,2,23,73,27,3,25
24,Maryland/MD,2401300,"Queen Anne's, Talbot, Caroline, Dorchester & Kent Counties PUMA, Maryland/MD",24019,"Dorchester County, Maryland",32261,587,10,1820,31,0.189,252,3,80,3,7,7,255,10,87,14,83,97,352,72,1,4,24,2,1,2,23,72,28,3,25
24,Maryland/MD,2401300,"Queen Anne's, Talbot, Caroline, Dorchester & Kent Counties PUMA, Maryland/MD",24029,"Kent County, Maryland",19593,302,24,1541,122,0.115,153,2,49,2,4,4,155,6,53,8,51,59,214,71,1,4,24,2,1,2,23,72,28,3,25
24,Maryland/MD,2401300,"Queen Anne's, Talbot, Caroline, Dorchester & Kent Counties PUMA, Maryland/MD",24035,"Queen Anne's County, Maryland",49355,653,26,1323,53,0.286,381,4,121,5,11,11,386,15,132,22,125,147,533,71,1,4,23,2,1,2,23,72,28,3,25
24,Maryland/MD,2401300,"Queen Anne's, Talbot, Caroline, Dorchester & Kent Counties PUMA, Maryland/MD",24041,"Talbot County, Maryland",37211,551,6,1481,16,0.218,290,3,92,3,8,8,293,11,100,16,95,111,404,72,1,4,24,2,1,2,23,73,27,3,25
24,Maryland/MD,2401400,"Wicomico, Worcester & Somerset Counties--Salisbury City PUMA, Maryland/MD",24039,"Somerset County, Maryland",25737,263,4,1022,16,0.144,164,0,5,0,35,93,164,35,98,128,5,133,297,55,0,43,2,12,0,31,2,55,45,12,33
24,Maryland/MD,2401400,"Wicomico, Worcester & Somerset Counties--Salisbury City PUMA, Maryland/MD",24045,"Wicomico County, Maryland",102172,1949,48,1908,47,0.57,649,0,22,0,138,368,649,138,390,506,22,528,1177,55,0,43,2,12,0,31,2,55,45,12,33
24,Maryland/MD,2401400,"Wicomico, Worcester & Somerset Counties--Salisbury City PUMA, Maryland/MD",24047,"Worcester County, Maryland",51564,1041,26,2019,50,0.286,325,0,11,0,69,184,325,69,195,253,11,264,589,55,0,43,2,12,0,31,2,55,45,12,33
24,Maryland/MD,2401500,"St. Mary's & Calvert Counties PUMA, Maryland/MD",24009,"Calvert County, Maryland",91082,934,28,1025,31,0.448,89,0,0,16,0,0,105,0,0,0,0,0,105,85,15,0,0,0,0,0,0,100,0,0,0
24,Maryland/MD,2401500,"St. Mary's & Calvert Counties PUMA, Maryland/MD",24037,"St. Mary's County, Maryland",111531,1274,57,1142,51,0.552,110,0,0,19,0,0,129,0,0,0,0,0,129,85,15,0,0,0,0,0,0,100,0,0,0
24,Maryland/MD,2401600,"Charles County--La Plata Town & Waldorf PUMA, Maryland/MD",24017,"Charles County, Maryland",157671,2747,101,1742,64,1,59,0,0,0,0,0,59,0,0,0,0,0,59,100,0,0,0,0,0,0,0,100,0,0,0
25,Massachusetts/MA,2500100,"Berkshire County--Pittsfield City PUMA, Massachusetts/MA",25003,"Berkshire County, Massachusetts",127328,707,49,555,38,1,108,0,0,23,22,86,131,22,86,108,0,108,239,45,10,45,0,9,0,36,0,55,45,9,36
25,Massachusetts/MA,2500200,"Franklin & Hampshire (North) Counties PUMA, Massachusetts/MA",25011,"Franklin County, Massachusetts",70935,406,68,572,96,0.577,220,4,20,31,58,7,251,62,27,65,24,89,340,65,9,19,7,17,1,2,6,74,26,18,8
25,Massachusetts/MA,2500200,"Franklin & Hampshire (North) Counties PUMA, Massachusetts/MA",25015,"Hampshire County, Massachusetts",161159,1214,143,753,89,0.423,161,3,14,22,43,5,183,46,19,48,17,65,248,65,9,19,7,17,1,2,6,74,26,19,8
25,Massachusetts/MA,2500300,"Worcester County (Central)--Worcester City PUMA, Massachusetts/MA",25027,"Worcester County, Massachusetts",822280,14252,1097,1733,133,1,39,0,77,74,15,164,113,15,241,179,77,256,369,11,20,49,21,4,0,44,21,31,69,4,65
25,Massachusetts/MA,2500301,"Worcester County (Northeast)--Leominster, Fitchburg & Gardner Cities PUMA, Massachusetts/MA",25027,"Worcester County, Massachusetts",822280,14252,1097,1733,133,1,159,0,61,36,12,23,195,12,84,35,61,96,291,55,12,12,21,4,0,8,21,67,33,4,29
25,Massachusetts/MA,2500302,"Worcester County (West Central) PUMA, Massachusetts/MA",25027,"Worcester County, Massachusetts",822280,14252,1097,1733,133,1,311,0,0,0,0,0,311,0,0,0,0,0,311,100,0,0,0,0,0,0,0,100,0,0,0
25,Massachusetts/MA,2500303,"Worcester County (East Central) PUMA, Massachusetts/MA",25027,"Worcester County, Massachusetts",822280,14252,1097,1733,133,1,63,86,0,65,10,0,128,96,0,10,86,96,224,28,29,4,38,4,38,0,0,57,43,43,0
25,Massachusetts/MA,2500304,"Worcester County (South) PUMA, Massachusetts/MA",25027,"Worcester County, Massachusetts",822280,14252,1097,1733,133,1,109,0,0,98,31,18,207,31,18,49,0,49,256,43,38,19,0,12,0,7,0,81,19,12,7
25,Massachusetts/MA,2500400,"Worcester & Middlesex Counties (Outside Leominster, Fitchburg & Gardner Cities) PUMA, Massachusetts/MA",25017,"Middlesex County, Massachusetts",1595192,27103,2139,1699,134,0.353,22,0,0,11,0,0,33,0,0,0,0,0,33,67,33,0,0,0,0,0,0,100,0,0,0
25,Massachusetts/MA,2500400,"Worcester & Middlesex Counties (Outside Leominster, Fitchburg & Gardner Cities) PUMA, Massachusetts/MA",25027,"Worcester County, Massachusetts",822280,14252,1097,1733,133,0.647,40,0,0,21,0,0,61,0,0,0,0,0,61,66,34,0,0,0,0,0,0,100,0,0,0
25,Massachusetts/MA,2500501,"Middlesex County (Outside Lowell City) PUMA, Massachusetts/MA",25017,"Middlesex County, Massachusetts",1595192,27103,2139,1699,134,1,13,0,0,0,0,27,13,0,27,27,0,27,40,32,0,68,0,0,0,68,0,32,68,0,68
25,Massachusetts/MA,2500502,"Middlesex County (Far Northeast)--Lowell City PUMA, Massachusetts/MA",25017,"Middlesex County, Massachusetts",1595192,27103,2139,1699,134,1,74,0,28,14,19,168,88,19,196,187,28,215,303,24,5,62,9,6,0,55,9,29,71,6,65
25,Massachusetts/MA,2500503,"Middlesex County--Waltham City, Lexington, Burlington, Bedford & Lincoln Towns PUMA, Massachusetts/MA",25017,"Middlesex County, Massachusetts",1595192,27103,2139,1699,134,1,64,0,0,0,18,7,64,18,7,25,0,25,89,72,0,28,0,20,0,8,0,72,28,20,8
25,Massachusetts/MA,2500504,"Middlesex County (South)--Framingham Town, Marlborough City & Natick Town PUMA, Massachusetts/MA",25017,"Middlesex County, Massachusetts",1595192,27103,2139,1699,134,1,172,0,0,82,44,0,254,44,0,44,0,44,298,58,28,15,0,15,0,0,0,85,15,15,0
25,Massachusetts/MA,2500505,"Middlesex County--Watertown Town City, Arlington, Belmont & Winchester Towns PUMA, Massachusetts/MA",25017,"Middlesex County, Massachusetts",1595192,27103,2139,1699,134,1,27,0,0,0,14,12,27,14,12,26,0,26,53,51,0,49,0,26,0,23,0,51,49,26,23
25,Massachusetts/MA,2500506,"Middlesex County (East)--Cambridge City PUMA, Massachusetts/MA",25017,"Middlesex County, Massachusetts",1595192,27103,2139,1699,134,1,15,0,0,0,19,18,15,19,18,37,0,37,52,29,0,71,0,37,0,35,0,29,71,37,35
25,Massachusetts/MA,2500507,"Middlesex County (East)--Somerville & Everett Cities PUMA, Massachusetts/MA",25017,"Middlesex County, Massachusetts",1595192,27103,2139,1699,134,1,13,20,120,72,97,12,85,117,132,109,140,249,334,4,22,33,42,29,6,4,36,25,75,35,40
25,Massachusetts/MA,2500508,"Middlesex County (East)--Malden & Medford Cities PUMA, Massachusetts/MA",25017,"Middlesex County, Massachusetts",1595192,27103,2139,1699,134,1,41,31,25,0,0,136,41,31,161,136,56,192,233,18,0,58,24,0,13,58,11,18,82,13,69
25,Massachusetts/MA,2500701,"Essex County (Northwest)--Lawrence, Haverhill & Methuen Town Cities PUMA, Massachusetts/MA",25009,"Essex County, Massachusetts",781024,19525,1275,2500,163,1,201,226,473,465,26,0,666,252,473,26,699,725,1391,14,33,2,50,2,16,0,34,48,52,18,34
25,Massachusetts/MA,2500702,"Essex County (Central)--Amesbury Town City PUMA, Massachusetts/MA",25009,"Essex County, Massachusetts",781024,19525,1275,2500,163,1,135,0,0,0,0,0,135,0,0,0,0,0,135,100,0,0,0,0,0,0,0,100,0,0,0
25,Massachusetts/MA,2500703,"Essex County (East)--Salem, Beverly, Gloucester & Newburyport Cities PUMA, Massachusetts/MA",25009,"Essex County, Massachusetts",781024,19525,1275,2500,163,1,362,19,0,14,21,90,376,40,90,111,19,130,506,72,3,22,4,4,4,18,0,74,26,8,18
25,Massachusetts/MA,2500704,"Essex County (South)--Lynn City, Swampscott & Nahant Towns PUMA, Massachusetts/MA",25009,"Essex County, Massachusetts",781024,19525,1275,2500,163,1,167,204,145,25,68,0,192,272,145,68,349,417,609,27,4,11,57,11,33,0,24,32,68,45,24
25,Massachusetts/MA,2501000,"Peabody City, Danvers, Reading, North Reading & Lynnfield Towns PUMA, Massachusetts/MA",25009,"Essex County, Massachusetts",781024,19525,1275,2500,163,0.691,28,13,13,0,32,0,28,45,13,32,26,58,86,33,0,37,30,37,15,0,15,33,67,52,15
25,Massachusetts/MA,2501000,"Peabody City, Danvers, Reading, North Reading & Lynnfield Towns PUMA, Massachusetts/MA",25017,"Middlesex County, Massachusetts",1595192,27103,2139,1699,134,0.309,13,6,6,0,15,0,13,21,6,15,12,27,40,32,0,38,30,38,15,0,15,32,68,52,15
25,Massachusetts/MA,2501300,"Billerica, Andover, Tewksbury & Wilmington Towns PUMA, Massachusetts/MA",25009,"Essex County, Massachusetts",781024,19525,1275,2500,163,0.264,38,0,0,3,4,0,41,4,0,4,0,4,45,84,7,9,0,9,0,0,0,91,9,9,0
25,Massachusetts/MA,2501300,"Billerica, Andover, Tewksbury & Wilmington Towns PUMA, Massachusetts/MA",25017,"Middlesex County, Massachusetts",1595192,27103,2139,1699,134,0.736,107,0,0,10,10,0,117,10,0,10,0,10,127,84,8,8,0,8,0,0,0,92,8,8,0
25,Massachusetts/MA,2501400,"Middlesex (West Central) & Worcester (East) Counties PUMA, Massachusetts/MA",25017,"Middlesex County, Massachusetts",1595192,27103,2139,1699,134,0.959,96,0,77,0,0,0,96,0,77,0,77,77,173,55,0,0,45,0,0,0,45,55,45,0,45
25,Massachusetts/MA,2501400,"Middlesex (West Central) & Worcester (East) Counties PUMA, Massachusetts/MA",25027,"Worcester County, Massachusetts",822280,14252,1097,1733,133,0.041,4,0,3,0,0,0,4,0,3,0,3,3,7,57,0,0,43,0,0,0,43,57,43,0,43
25,Massachusetts/MA,2501600,"Hampden (West & East) & Hampshire (South) Counties--Northampton City PUMA, Massachusetts/MA",25013,"Hampden County, Massachusetts",469116,8117,774,1730,165,0.247,57,0,0,0,1,0,57,1,0,1,0,1,58,98,0,2,0,2,0,0,0,98,2,2,0
25,Massachusetts/MA,2501600,"Hampden (West & East) & Hampshire (South) Counties--Northampton City PUMA, Massachusetts/MA",25015,"Hampshire County, Massachusetts",161159,1214,143,753,89,0.753,173,0,0,0,4,0,173,4,0,4,0,4,177,98,0,2,0,2,0,0,0,98,2,2,0
25,Massachusetts/MA,2501900,"Hampden County (Central)--Springfield City PUMA, Massachusetts/MA",25013,"Hampden County, Massachusetts",469116,8117,774,1730,165,1,75,0,213,388,38,0,463,38,213,38,213,251,714,11,54,5,30,5,0,0,30,65,35,5,30
25,Massachusetts/MA,2501901,"Hampden County (West of Springfield City)--Westfield & Holyoke Cities PUMA, Massachusetts/MA",25013,"Hampden County, Massachusetts",469116,8117,774,1730,165,1,66,0,0,86,0,0,152,0,0,0,0,0,152,43,57,0,0,0,0,0,0,100,0,0,0
25,Massachusetts/MA,2501902,"Hampden County (East of Springfield City)--Chicopee City PUMA, Massachusetts/MA",25013,"Hampden County, Massachusetts",469116,8117,774,1730,165,1,146,0,0,0,40,0,146,40,0,40,0,40,186,78,0,22,0,22,0,0,0,78,22,22,0
25,Massachusetts/MA,2502400,"Middlesex (Far Southwest), Norfolk (Northwest) & Worcester (Far East) Counties PUMA, Massachusetts/MA",25017,"Middlesex County, Massachusetts",1595192,27103,2139,1699,134,0.396,34,0,0,10,0,0,44,0,0,0,0,0,44,77,23,0,0,0,0,0,0,100,0,0,0
25,Massachusetts/MA,2502400,"Middlesex (Far Southwest), Norfolk (Northwest) & Worcester (Far East) Counties PUMA, Massachusetts/MA",25021,"Norfolk County, Massachusetts",698249,10170,1054,1457,151,0.282,24,0,0,7,0,0,31,0,0,0,0,0,31,77,23,0,0,0,0,0,0,100,0,0,0
25,Massachusetts/MA,2502400,"Middlesex (Far Southwest), Norfolk (Northwest) & Worcester (Far East) Counties PUMA, Massachusetts/MA",25027,"Worcester County, Massachusetts",822280,14252,1097,1733,133,0.322,27,0,0,8,0,0,35,0,0,0,0,0,35,77,23,0,0,0,0,0,0,100,0,0,0
25,Massachusetts/MA,2502800,"Woburn, Melrose Cities, Saugus, Wakefield & Stoneham Towns PUMA, Massachusetts/MA",25009,"Essex County, Massachusetts",781024,19525,1275,2500,163,0.191,23,5,0,6,0,0,29,5,0,0,5,5,34,68,18,0,15,0,15,0,0,85,15,15,0
25,Massachusetts/MA,2502800,"Woburn, Melrose Cities, Saugus, Wakefield & Stoneham Towns PUMA, Massachusetts/MA",25017,"Middlesex County, Massachusetts",1595192,27103,2139,1699,134,0.809,96,20,0,27,0,0,123,20,0,0,20,20,143,67,19,0,14,0,14,0,0,86,14,14,0
25,Massachusetts/MA,2503301,"Boston City--Allston, Brighton & Fenway PUMA, Massachusetts/MA",25025,"Suffolk County, Massachusetts",791766,24089,1133,3042,143,1,47,0,0,0,0,12,47,0,12,12,0,12,59,80,0,20,0,0,0,20,0,80,20,0,20
25,Massachusetts/MA,2503302,"Boston City--Back Bay, Beacon Hill, Charlestown, East Boston, Central & South End PUMA, Massachusetts/MA",25025,"Suffolk County, Massachusetts",791766,24089,1133,3042,143,1,22,18,238,26,28,97,48,46,335,125,256,381,429,5,6,29,60,7,4,23,55,11,89,11,78
25,Massachusetts/MA,2503303,"Boston City--Dorchester & South Boston PUMA, Massachusetts/MA",25025,"Suffolk County, Massachusetts",791766,24089,1133,3042,143,1,100,0,0,15,0,0,115,0,0,0,0,0,115,87,13,0,0,0,0,0,0,100,0,0,0
25,Massachusetts/MA,2503304,"Boston City--Mattapan & Roxbury PUMA, Massachusetts/MA",25025,"Suffolk County, Massachusetts",791766,24089,1133,3042,143,1,101,15,56,101,14,78,202,29,134,92,71,163,365,28,28,25,19,4,4,21,15,55,45,8,37
25,Massachusetts/MA,2503305,"Boston City--Hyde Park, Jamaica Plain, Roslindale & West Roxbury PUMA, Massachusetts/MA",25025,"Suffolk County, Massachusetts",791766,24089,1133,3042,143,1,81,0,75,0,61,0,81,61,75,61,75,136,217,37,0,28,35,28,0,0,35,37,63,28,35
25,Massachusetts/MA,2503306,"Suffolk County (North)--Revere, Chelsea & Winthrop Town Cities PUMA, Massachusetts/MA",25025,"Suffolk County, Massachusetts",791766,24089,1133,3042,143,1,39,117,203,61,0,0,100,117,203,0,320,320,420,9,15,0,76,0,28,0,48,24,76,28,48
25,Massachusetts/MA,2503400,"Middlesex (Southeast) & Norfolk (Northeast) Counties--Newton City & Brookline Town PUMA, Massachusetts/MA",25017,"Middlesex County, Massachusetts",1595192,27103,2139,1699,134,0.596,0,0,0,0,13,0,0,13,0,13,0,13,13,0,0,100,0,100,0,0,0,0,100,100,0
25,Massachusetts/MA,2503400,"Middlesex (Southeast) & Norfolk (Northeast) Counties--Newton City & Brookline Town PUMA, Massachusetts/MA",25021,"Norfolk County, Massachusetts",698249,10170,1054,1457,151,0.404,0,0,0,0,9,0,0,9,0,9,0,9,9,0,0,100,0,100,0,0,0,0,100,100,0
25,Massachusetts/MA,2503500,"Norfolk (Northeast) & Middlesex (Southeast) Counties (West of Boston City) PUMA, Massachusetts/MA",25017,"Middlesex County, Massachusetts",1595192,27103,2139,1699,134,0.273,14,0,0,0,0,0,14,0,0,0,0,0,14,100,0,0,0,0,0,0,0,100,0,0,0
25,Massachusetts/MA,2503500,"Norfolk (Northeast) & Middlesex (Southeast) Counties (West of Boston City) PUMA, Massachusetts/MA",25021,"Norfolk County, Massachusetts",698249,10170,1054,1457,151,0.727,36,0,0,0,0,0,36,0,0,0,0,0,36,100,0,0,0,0,0,0,0,100,0,0,0
25,Massachusetts/MA,2503601,"Norfolk County (Southwest)--Greater Franklin Town City PUMA, Massachusetts/MA",25021,"Norfolk County, Massachusetts",698249,10170,1054,1457,151,1,93,0,0,0,0,0,93,0,0,0,0,0,93,100,0,0,0,0,0,0,0,100,0,0,0
25,Massachusetts/MA,2503602,"Norfolk County (Central)--Randolph, Norwood, Dedham, Canton & Holbrook Towns PUMA, Massachusetts/MA",25021,"Norfolk County, Massachusetts",698249,10170,1054,1457,151,1,61,0,26,49,8,28,110,8,54,36,26,62,172,35,28,21,15,5,0,16,15,64,36,5,31
25,Massachusetts/MA,2503603,"Norfolk County (Northeast)--Quincy City & Milton Town PUMA, Massachusetts/MA",25021,"Norfolk County, Massachusetts",698249,10170,1054,1457,151,1,0,0,20,0,12,163,0,12,183,175,20,195,195,0,0,90,10,6,0,84,10,0,100,6,94
25,Massachusetts/MA,2503900,"Weymouth Town, Braintree Town Cities, Hingham, Hull & Cohasset Towns PUMA, Massachusetts/MA",25021,"Norfolk County, Massachusetts",698249,10170,1054,1457,151,0.75,40,0,0,0,0,0,40,0,0,0,0,0,40,100,0,0,0,0,0,0,0,100,0,0,0
25,Massachusetts/MA,2503900,"Weymouth Town, Braintree Town Cities, Hingham, Hull & Cohasset Towns PUMA, Massachusetts/MA",25023,"Plymouth County, Massachusetts",512135,9621,766,1879,150,0.25,14,0,0,0,0,0,14,0,0,0,0,0,14,100,0,0,0,0,0,0,0,100,0,0,0
25,Massachusetts/MA,2504000,"Plymouth & Norfolk Counties--Brockton City, Stoughton & Avon Towns PUMA, Massachusetts/MA",25021,"Norfolk County, Massachusetts",698249,10170,1054,1457,151,0.251,36,0,0,0,27,27,36,27,27,54,0,54,90,40,0,60,0,30,0,30,0,40,60,30,30
25,Massachusetts/MA,2504000,"Plymouth & Norfolk Counties--Brockton City, Stoughton & Avon Towns PUMA, Massachusetts/MA",25023,"Plymouth County, Massachusetts",512135,9621,766,1879,150,0.749,109,0,0,0,81,79,109,81,79,160,0,160,269,41,0,59,0,30,0,29,0,41,59,30,29
25,Massachusetts/MA,2504200,"Attleboro City, North Attleborough, Swansea, Seekonk, Rehoboth & Plainville Towns PUMA, Massachusetts/MA",25005,"Bristol County, Massachusetts",558905,9926,695,1776,124,0.931,41,0,0,15,0,0,56,0,0,0,0,0,56,73,27,0,0,0,0,0,0,100,0,0,0
25,Massachusetts/MA,2504200,"Attleboro City, North Attleborough, Swansea, Seekonk, Rehoboth & Plainville Towns PUMA, Massachusetts/MA",25021,"Norfolk County, Massachusetts",698249,10170,1054,1457,151,0.069,3,0,0,1,0,0,4,0,0,0,0,0,4,75,25,0,0,0,0,0,0,100,0,0,0
25,Massachusetts/MA,2504301,"Bristol (Outside New Bedford City) & Plymouth (South) Counties PUMA, Massachusetts/MA",25005,"Bristol County, Massachusetts",558905,9926,695,1776,124,0.64,120,0,0,0,7,0,120,7,0,7,0,7,127,94,0,6,0,6,0,0,0,94,6,6,0
25,Massachusetts/MA,2504301,"Bristol (Outside New Bedford City) & Plymouth (South) Counties PUMA, Massachusetts/MA",25023,"Plymouth County, Massachusetts",512135,9621,766,1879,150,0.36,68,0,0,0,4,0,68,4,0,4,0,4,72,94,0,6,0,6,0,0,0,94,6,6,0
25,Massachusetts/MA,2504302,"Bristol County (Central)--Fall River City & Somerset Town PUMA, Massachusetts/MA",25005,"Bristol County, Massachusetts",558905,9926,695,1776,124,1,206,0,57,0,81,92,206,81,149,173,57,230,436,47,0,40,13,19,0,21,13,47,53,19,34
25,Massachusetts/MA,2504303,"Bristol County--Taunton City, Mansfield, Norton, Raynam, Dighton & Berkley Towns PUMA, Massachusetts/MA",25005,"Bristol County, Massachusetts",558905,9926,695,1776,124,1,66,0,0,0,0,0,66,0,0,0,0,0,66,100,0,0,0,0,0,0,0,100,0,0,0
25,Massachusetts/MA,2504500,"Bristol County (South)--New Bedford City & Fairhaven Town PUMA, Massachusetts/MA",25005,"Bristol County, Massachusetts",558905,9926,695,1776,124,1,97,48,102,47,36,0,144,84,102,36,150,186,330,29,14,11,45,11,15,0,31,44,56,25,31
25,Massachusetts/MA,2504700,"Barnstable County (West)--Inner Cape Cod Towns & Barnstable Town City PUMA, Massachusetts/MA",25001,"Barnstable County, Massachusetts",213690,1736,174,812,81,1,78,0,0,0,78,0,78,78,0,78,0,78,156,50,0,50,0,50,0,0,0,50,50,50,0
25,Massachusetts/MA,2504800,"Barnstable (East), Dukes & Nantucket Counties--Outer Cape Cod Towns PUMA, Massachusetts/MA",25001,"Barnstable County, Massachusetts",213690,1736,174,812,81,0.749,54,0,0,4,0,72,58,0,72,72,0,72,130,42,3,55,0,0,0,55,0,45,55,0,55
25,Massachusetts/MA,2504800,"Barnstable (East), Dukes & Nantucket Counties--Outer Cape Cod Towns PUMA, Massachusetts/MA",25007,"Dukes County, Massachusetts",17313,63,0,364,0,0.154,11,0,0,1,0,15,12,0,15,15,0,15,27,41,4,56,0,0,0,56,0,44,56,0,56
25,Massachusetts/MA,2504800,"Barnstable (East), Dukes & Nantucket Counties--Outer Cape Cod Towns PUMA, Massachusetts/MA",25019,"Nantucket County, Massachusetts",11101,91,1,820,9,0.098,7,0,0,0,0,9,7,0,9,9,0,9,16,44,0,56,0,0,0,56,0,44,56,0,56
25,Massachusetts/MA,2504901,"Plymouth & Bristol Counties (Outside Brockton City) PUMA, Massachusetts/MA",25005,"Bristol County, Massachusetts",558905,9926,695,1776,124,0.192,19,0,0,0,2,0,19,2,0,2,0,2,21,90,0,10,0,10,0,0,0,90,10,10,0
25,Massachusetts/MA,2504901,"Plymouth & Bristol Counties (Outside Brockton City) PUMA, Massachusetts/MA",25023,"Plymouth County, Massachusetts",512135,9621,766,1879,150,0.808,82,0,0,0,8,0,82,8,0,8,0,8,90,91,0,9,0,9,0,0,0,91,9,9,0
25,Massachusetts/MA,2504902,"Plymouth County (Central) PUMA, Massachusetts/MA",25023,"Plymouth County, Massachusetts",512135,9621,766,1879,150,1,194,0,0,0,0,0,194,0,0,0,0,0,194,100,0,0,0,0,0,0,0,100,0,0,0
25,Massachusetts/MA,2504903,"Plymouth County (East)--Plymouth, Marshfield, Scituate, Duxbury & Kingston Towns PUMA, Massachusetts/MA",25023,"Plymouth County, Massachusetts",512135,9621,766,1879,150,1,255,0,0,0,0,0,255,0,0,0,0,0,255,100,0,0,0,0,0,0,0,100,0,0,0
26,Michigan/MI,2600100,"Western Upper Peninsula PUMA, Michigan/MI",26013,"Baraga County, Michigan",8507,27,0,317,0,0.05,10,0,0,1,0,0,11,0,0,0,0,0,11,91,9,0,0,0,0,0,0,100,0,0,0
26,Michigan/MI,2600100,"Western Upper Peninsula PUMA, Michigan/MI",26043,"Dickinson County, Michigan",25570,128,2,501,8,0.149,31,0,0,2,0,0,33,0,0,0,0,0,33,94,6,0,0,0,0,0,0,100,0,0,0
26,Michigan/MI,2600100,"Western Upper Peninsula PUMA, Michigan/MI",26053,"Gogebic County, Michigan",15414,158,1,1025,6,0.089,18,0,0,1,0,0,19,0,0,0,0,0,19,95,5,0,0,0,0,0,0,100,0,0,0
26,Michigan/MI,2600100,"Western Upper Peninsula PUMA, Michigan/MI",26061,"Houghton County, Michigan",36360,442,1,1216,3,0.213,44,0,0,3,0,0,47,0,0,0,0,0,47,94,6,0,0,0,0,0,0,100,0,0,0
26,Michigan/MI,2600100,"Western Upper Peninsula PUMA, Michigan/MI",26071,"Iron County, Michigan",11212,145,1,1293,9,0.065,13,0,0,1,0,0,14,0,0,0,0,0,14,93,7,0,0,0,0,0,0,100,0,0,0
26,Michigan/MI,2600100,"Western Upper Peninsula PUMA, Michigan/MI",26083,"Keweenaw County, Michigan",2130,9,0,423,0,0.013,3,0,0,0,0,0,3,0,0,0,0,0,3,100,0,0,0,0,0,0,0,100,0,0,0
26,Michigan/MI,2600100,"Western Upper Peninsula PUMA, Michigan/MI",26103,"Marquette County, Michigan",66939,355,12,530,18,0.387,80,0,0,5,0,0,85,0,0,0,0,0,85,94,6,0,0,0,0,0,0,100,0,0,0
26,Michigan/MI,2600100,"Western Upper Peninsula PUMA, Michigan/MI",26131,"Ontonagon County, Michigan",5968,42,0,704,0,0.034,7,0,0,0,0,0,7,0,0,0,0,0,7,100,0,0,0,0,0,0,0,100,0,0,0
26,Michigan/MI,2600200,"Eastern Upper Peninsula PUMA, Michigan/MI",26003,"Alger County, Michigan",9194,17,0,185,0,0.07,22,2,2,0,0,0,22,2,2,0,4,4,26,85,0,0,15,0,8,0,8,85,15,8,8
26,Michigan/MI,2600200,"Eastern Upper Peninsula PUMA, Michigan/MI",26033,"Chippewa County, Michigan",37834,78,0,206,0,0.287,91,7,6,1,0,0,92,7,6,0,13,13,105,87,1,0,12,0,7,0,6,88,12,7,6
26,Michigan/MI,2600200,"Eastern Upper Peninsula PUMA, Michigan/MI",26041,"Delta County, Michigan",36190,377,7,1042,19,0.275,87,7,6,1,0,0,88,7,6,0,13,13,101,86,1,0,13,0,7,0,6,87,13,7,6
26,Michigan/MI,2600200,"Eastern Upper Peninsula PUMA, Michigan/MI",26095,"Luce County, Michigan",6364,238,0,3740,0,0.048,15,1,1,0,0,0,15,1,1,0,2,2,17,88,0,0,12,0,6,0,6,88,12,6,6
26,Michigan/MI,2600200,"Eastern Upper Peninsula PUMA, Michigan/MI",26097,"Mackinac County, Michigan",10817,57,0,527,0,0.082,26,2,2,0,0,0,26,2,2,0,4,4,30,87,0,0,13,0,7,0,7,87,13,7,7
26,Michigan/MI,2600200,"Eastern Upper Peninsula PUMA, Michigan/MI",26109,"Menominee County, Michigan",23234,369,1,1588,4,0.177,56,4,4,1,0,0,57,4,4,0,8,8,65,86,2,0,12,0,6,0,6,88,12,6,6
26,Michigan/MI,2600200,"Eastern Upper Peninsula PUMA, Michigan/MI",26153,"Schoolcraft County, Michigan",8069,25,0,310,0,0.061,19,2,1,0,0,0,19,2,1,0,3,3,22,86,0,0,14,0,9,0,5,86,14,9,5
26,Michigan/MI,2600300,"Northeast Lower Peninsula PUMA, Michigan/MI",26001,"Alcona County, Michigan",10364,42,2,405,19,0.078,31,3,11,0,0,0,31,3,11,0,14,14,45,69,0,0,31,0,7,0,24,69,31,7,24
26,Michigan/MI,2600300,"Northeast Lower Peninsula PUMA, Michigan/MI",26007,"Alpena County, Michigan",28612,148,14,517,49,0.216,87,7,30,0,0,0,87,7,30,0,37,37,124,70,0,0,30,0,6,0,24,70,30,6,24
26,Michigan/MI,2600300,"Northeast Lower Peninsula PUMA, Michigan/MI",26031,"Cheboygan County, Michigan",25458,90,2,354,8,0.191,77,6,26,0,0,0,77,6,26,0,32,32,109,71,0,0,29,0,6,0,24,71,29,6,24
26,Michigan/MI,2600300,"Northeast Lower Peninsula PUMA, Michigan/MI",26039,"Crawford County, Michigan",13836,124,5,896,36,0.103,41,3,14,0,0,0,41,3,14,0,17,17,58,71,0,0,29,0,5,0,24,71,29,5,24
26,Michigan/MI,2600300,"Northeast Lower Peninsula PUMA, Michigan/MI",26119,"Montmorency County, Michigan",9261,14,0,151,0,0.069,28,2,10,0,0,0,28,2,10,0,12,12,40,70,0,0,30,0,5,0,25,70,30,5,25
26,Michigan/MI,2600300,"Northeast Lower Peninsula PUMA, Michigan/MI",26135,"Oscoda County, Michigan",8277,31,1,375,12,0.062,25,2,9,0,0,0,25,2,9,0,11,11,36,69,0,0,31,0,6,0,25,69,31,6,25
26,Michigan/MI,2600300,"Northeast Lower Peninsula PUMA, Michigan/MI",26137,"Otsego County, Michigan",24397,186,11,762,45,0.184,74,6,25,0,0,0,74,6,25,0,31,31,105,70,0,0,30,0,6,0,24,70,30,6,24
26,Michigan/MI,2600300,"Northeast Lower Peninsula PUMA, Michigan/MI",26141,"Presque Isle County, Michigan",12797,26,1,203,8,0.096,38,3,13,0,0,0,38,3,13,0,16,16,54,70,0,0,30,0,6,0,24,70,30,6,24
26,Michigan/MI,2600400,"Northwest Lower Peninsula (East) PUMA, Michigan/MI",26009,"Antrim County, Michigan",23177,70,0,302,0,0.156,155,0,19,13,0,4,168,0,23,4,19,23,191,81,7,2,10,0,0,2,10,88,12,0,12
26,Michigan/MI,2600400,"Northwest Lower Peninsula (East) PUMA, Michigan/MI",26029,"Charlevoix County, Michigan",26219,111,3,423,11,0.177,176,0,21,15,0,4,191,0,25,4,21,25,216,81,7,2,10,0,0,2,10,88,12,0,12
26,Michigan/MI,2600400,"Northwest Lower Peninsula (East) PUMA, Michigan/MI",26047,"Emmet County, Michigan",33039,156,4,472,12,0.224,223,0,27,19,0,5,242,0,32,5,27,32,274,81,7,2,10,0,0,2,10,88,12,0,12
26,Michigan/MI,2600400,"Northwest Lower Peninsula (East) PUMA, Michigan/MI",26079,"Kalkaska County, Michigan",17463,84,4,481,23,0.117,117,0,14,10,0,3,127,0,17,3,14,17,144,81,7,2,10,0,0,2,10,88,12,0,12
26,Michigan/MI,2600400,"Northwest Lower Peninsula (East) PUMA, Michigan/MI",26113,"Missaukee County, Michigan",15006,62,1,413,7,0.102,102,0,12,8,0,2,110,0,14,2,12,14,124,82,6,2,10,0,0,2,10,89,11,0,11
26,Michigan/MI,2600400,"Northwest Lower Peninsula (East) PUMA, Michigan/MI",26165,"Wexford County, Michigan",33111,128,4,387,12,0.224,223,0,27,19,0,5,242,0,32,5,27,32,274,81,7,2,10,0,0,2,10,88,12,0,12
26,Michigan/MI,2600500,"Northwest Lower Peninsula (West) PUMA, Michigan/MI",26019,"Benzie County, Michigan",17552,79,2,450,11,0.113,93,9,4,11,0,6,104,9,10,6,13,19,123,76,9,5,11,0,7,5,3,85,15,7,8
26,Michigan/MI,2600500,"Northwest Lower Peninsula (West) PUMA, Michigan/MI",26055,"Grand Traverse County, Michigan",91746,477,7,520,8,0.591,489,46,23,58,0,34,547,46,57,34,69,103,650,75,9,5,11,0,7,5,4,84,16,7,9
26,Michigan/MI,2600500,"Northwest Lower Peninsula (West) PUMA, Michigan/MI",26089,"Leelanau County, Michigan",21639,112,1,518,5,0.14,116,11,5,14,0,8,130,11,13,8,16,24,154,75,9,5,10,0,7,5,3,84,16,7,8
26,Michigan/MI,2600500,"Northwest Lower Peninsula (West) PUMA, Michigan/MI",26101,"Manistee County, Michigan",24444,88,2,360,8,0.156,129,12,6,15,0,9,144,12,15,9,18,27,171,75,9,5,11,0,7,5,4,84,16,7,9
26,Michigan/MI,2600600,"Newaygo, Mason, Oceana & Lake Counties PUMA, Michigan/MI",26085,"Lake County, Michigan",11763,32,0,272,0,0.101,152,4,31,21,0,10,173,4,41,10,35,45,218,70,10,5,16,0,2,5,14,79,21,2,19
26,Michigan/MI,2600600,"Newaygo, Mason, Oceana & Lake Counties PUMA, Michigan/MI",26105,"Mason County, Michigan",28884,135,0,467,0,0.253,380,11,78,51,0,26,431,11,104,26,89,115,546,70,9,5,16,0,2,5,14,79,21,2,19
26,Michigan/MI,2600600,"Newaygo, Mason, Oceana & Lake Counties PUMA, Michigan/MI",26123,"Newaygo County, Michigan",48142,362,1,752,2,0.419,629,18,129,85,0,42,714,18,171,42,147,189,903,70,9,5,16,0,2,5,14,79,21,2,19
26,Michigan/MI,2600600,"Newaygo, Mason, Oceana & Lake Counties PUMA, Michigan/MI",26127,"Oceana County, Michigan",26417,516,6,1953,23,0.228,342,10,70,46,0,23,388,10,93,23,80,103,491,70,9,5,16,0,2,5,14,79,21,2,19
26,Michigan/MI,2600700,"Muskegon County PUMA, Michigan/MI",26121,"Muskegon County, Michigan",173043,2437,71,1408,41,1,978,0,35,0,0,0,978,0,35,0,35,35,1013,97,0,0,3,0,0,0,3,97,3,0,3
26,Michigan/MI,2600801,"Ottawa County (West) PUMA, Michigan/MI",26139,"Ottawa County, Michigan",284034,3383,66,1191,23,1,615,274,937,316,160,201,931,434,1138,361,1211,1572,2503,25,13,14,48,6,11,8,37,37,63,17,45
26,Michigan/MI,2600802,"Ottawa County (East) PUMA, Michigan/MI",26139,"Ottawa County, Michigan",284034,3383,66,1191,23,1,608,120,104,161,0,0,769,120,104,0,224,224,993,61,16,0,23,0,12,0,10,77,23,12,10
26,Michigan/MI,2600900,"Allegan County PUMA, Michigan/MI",26005,"Allegan County, Michigan",115250,755,7,655,6,1,807,38,320,26,0,0,833,38,320,0,358,358,1191,68,2,0,30,0,3,0,27,70,30,3,27
26,Michigan/MI,2601001,"Kent County (Southwest) PUMA, Michigan/MI",26081,"Kent County, Michigan",643140,9758,175,1517,27,1,994,97,549,18,0,38,1012,97,587,38,646,684,1696,59,1,2,38,0,6,2,32,60,40,6,35
26,Michigan/MI,2601002,"Kent County (Central)--Grand Rapids City Area PUMA, Michigan/MI",26081,"Kent County, Michigan",643140,9758,175,1517,27,1,521,243,864,104,78,380,625,321,1244,458,1107,1565,2190,24,5,21,51,4,11,17,39,29,71,15,57
26,Michigan/MI,2601003,"Kent County (Southeast) PUMA, Michigan/MI",26081,"Kent County, Michigan",643140,9758,175,1517,27,1,336,0,334,129,18,212,465,18,546,230,334,564,1029,33,13,22,32,2,0,21,32,45,55,2,53
26,Michigan/MI,2601004,"Kent County (North) PUMA, Michigan/MI",26081,"Kent County, Michigan",643140,9758,175,1517,27,1,910,58,38,0,0,17,910,58,55,17,96,113,1023,89,0,2,9,0,6,2,4,89,11,6,5
26,Michigan/MI,2601100,"Ionia, Montcalm, Mecosta & Osceola Counties PUMA, Michigan/MI",26067,"Ionia County, Michigan",64176,521,7,812,11,0.332,646,11,28,26,0,0,672,11,28,0,39,39,711,91,4,0,5,0,2,0,4,95,5,2,4
26,Michigan/MI,2601100,"Ionia, Montcalm, Mecosta & Osceola Counties PUMA, Michigan/MI",26107,"Mecosta County, Michigan",43264,205,3,474,7,0.223,434,7,19,17,0,0,451,7,19,0,26,26,477,91,4,0,5,0,1,0,4,95,5,1,4
26,Michigan/MI,2601100,"Ionia, Montcalm, Mecosta & Osceola Counties PUMA, Michigan/MI",26117,"Montcalm County, Michigan",63209,314,5,497,8,0.325,632,10,27,25,0,0,657,10,27,0,37,37,694,91,4,0,5,0,1,0,4,95,5,1,4
26,Michigan/MI,2601100,"Ionia, Montcalm, Mecosta & Osceola Counties PUMA, Michigan/MI",26133,"Osceola County, Michigan",23232,93,0,400,0,0.119,231,4,10,9,0,0,240,4,10,0,14,14,254,91,4,0,6,0,2,0,4,94,6,2,4
26,Michigan/MI,2601200,"Isabella, Gratiot & Clare Counties PUMA, Michigan/MI",26035,"Clare County, Michigan",30616,112,4,366,13,0.213,186,0,5,13,0,0,199,0,5,0,5,5,204,91,6,0,2,0,0,0,2,98,2,0,2
26,Michigan/MI,2601200,"Isabella, Gratiot & Clare Counties PUMA, Michigan/MI",26057,"Gratiot County, Michigan",41067,273,15,665,37,0.288,251,0,7,18,0,0,269,0,7,0,7,7,276,91,7,0,3,0,0,0,3,97,3,0,3
26,Michigan/MI,2601200,"Isabella, Gratiot & Clare Counties PUMA, Michigan/MI",26073,"Isabella County, Michigan",70775,693,13,979,18,0.499,436,0,11,31,0,0,467,0,11,0,11,11,478,91,6,0,2,0,0,0,2,98,2,0,2
26,Michigan/MI,2601300,"Iosco, Gladwin, Roscommon, Ogemaw & Arenac Counties PUMA, Michigan/MI",26011,"Arenac County, Michigan",15165,69,3,455,20,0.137,52,0,1,1,0,1,53,0,2,1,1,2,55,95,2,2,2,0,0,2,2,96,4,0,4
26,Michigan/MI,2601300,"Iosco, Gladwin, Roscommon, Ogemaw & Arenac Counties PUMA, Michigan/MI",26051,"Gladwin County, Michigan",25289,93,2,368,8,0.228,87,0,2,2,0,2,89,0,4,2,2,4,93,94,2,2,2,0,0,2,2,96,4,0,4
26,Michigan/MI,2601300,"Iosco, Gladwin, Roscommon, Ogemaw & Arenac Counties PUMA, Michigan/MI",26069,"Iosco County, Michigan",25247,215,12,852,48,0.23,88,0,2,2,0,2,90,0,4,2,2,4,94,94,2,2,2,0,0,2,2,96,4,0,4
26,Michigan/MI,2601300,"Iosco, Gladwin, Roscommon, Ogemaw & Arenac Counties PUMA, Michigan/MI",26129,"Ogemaw County, Michigan",20928,65,5,311,24,0.19,73,0,2,2,0,1,75,0,3,1,2,3,78,94,3,1,3,0,0,1,3,96,4,0,4
26,Michigan/MI,2601300,"Iosco, Gladwin, Roscommon, Ogemaw & Arenac Counties PUMA, Michigan/MI",26143,"Roscommon County, Michigan",23877,97,4,406,17,0.215,82,0,2,2,0,2,84,0,4,2,2,4,88,93,2,2,2,0,0,2,2,95,5,0,5
26,Michigan/MI,2601400,"Bay & Midland Counties PUMA, Michigan/MI",26017,"Bay County, Michigan",104786,1000,50,954,48,0.557,206,3,18,55,0,0,261,3,18,0,21,21,282,73,20,0,7,0,1,0,6,93,7,1,6
26,Michigan/MI,2601400,"Bay & Midland Counties PUMA, Michigan/MI",26111,"Midland County, Michigan",83389,599,11,718,13,0.443,163,2,14,44,0,0,207,2,14,0,16,16,223,73,20,0,7,0,1,0,6,93,7,1,6
26,Michigan/MI,2601500,"Saginaw County PUMA, Michigan/MI",26145,"Saginaw County, Michigan",192778,2925,139,1517,72,1,697,0,112,174,0,0,871,0,112,0,112,112,983,71,18,0,11,0,0,0,11,89,11,0,11
26,Michigan/MI,2601600,"Tuscola, Sanilac & Huron Counties PUMA, Michigan/MI",26063,"Huron County, Michigan",31543,225,5,713,16,0.249,491,5,25,26,0,0,517,5,25,0,30,30,547,90,5,0,5,0,1,0,5,95,5,1,5
26,Michigan/MI,2601600,"Tuscola, Sanilac & Huron Counties PUMA, Michigan/MI",26151,"Sanilac County, Michigan",41376,146,7,353,17,0.328,647,7,33,35,0,0,682,7,33,0,40,40,722,90,5,0,6,0,1,0,5,94,6,1,5
26,Michigan/MI,2601600,"Tuscola, Sanilac & Huron Counties PUMA, Michigan/MI",26157,"Tuscola County, Michigan",53250,510,31,958,58,0.423,834,9,43,45,0,0,879,9,43,0,52,52,931,90,5,0,6,0,1,0,5,94,6,1,5
26,Michigan/MI,2601701,"Genesee (East) & Lapeer Counties PUMA, Michigan/MI",26049,"Genesee County, Michigan",409361,4497,308,1099,75,0.518,260,0,214,22,0,19,282,0,233,19,214,233,515,50,4,4,42,0,0,4,42,55,45,0,45
26,Michigan/MI,2601701,"Genesee (East) & Lapeer Counties PUMA, Michigan/MI",26087,"Lapeer County, Michigan",88202,913,43,1035,49,0.482,241,0,199,20,0,17,261,0,216,17,199,216,477,51,4,4,42,0,0,4,42,55,45,0,45
26,Michigan/MI,2601702,"Genesee County (Central, Outside Flint City) PUMA, Michigan/MI",26049,"Genesee County, Michigan",409361,4497,308,1099,75,1,106,0,0,0,0,20,106,0,20,20,0,20,126,84,0,16,0,0,0,16,0,84,16,0,16
26,Michigan/MI,2601703,"Genesee County (Central)--Flint City Area PUMA, Michigan/MI",26049,"Genesee County, Michigan",409361,4497,308,1099,75,1,166,32,0,31,0,0,197,32,0,0,32,32,229,72,14,0,14,0,14,0,0,86,14,14,0
26,Michigan/MI,2601704,"Genesee (West) & Shiawassee Counties PUMA, Michigan/MI",26049,"Genesee County, Michigan",409361,4497,308,1099,75,0.619,370,0,2,7,0,0,377,0,2,0,2,2,379,98,2,0,1,0,0,0,1,99,1,0,1
26,Michigan/MI,2601704,"Genesee (West) & Shiawassee Counties PUMA, Michigan/MI",26155,"Shiawassee County, Michigan",68493,510,31,745,45,0.381,227,0,1,4,0,0,231,0,1,0,1,1,232,98,2,0,0,0,0,0,0,100,0,0,0
26,Michigan/MI,2601801,"Ingham County (South & East) PUMA, Michigan/MI",26065,"Ingham County, Michigan",289564,3462,47,1196,16,1,407,25,28,18,135,0,425,160,28,135,53,188,613,66,3,22,9,22,4,0,5,69,31,26,5
26,Michigan/MI,2601802,"Ingham County (Northwest) PUMA, Michigan/MI",26065,"Ingham County, Michigan",289564,3462,47,1196,16,1,101,0,0,0,0,0,101,0,0,0,0,0,101,100,0,0,0,0,0,0,0,100,0,0,0
26,Michigan/MI,2601900,"Eaton & Clinton Counties PUMA, Michigan/MI",26037,"Clinton County, Michigan",77896,669,13,859,17,0.416,262,11,70,36,0,12,298,11,82,12,81,93,391,67,9,3,21,0,3,3,18,76,24,3,21
26,Michigan/MI,2601900,"Eaton & Clinton Counties PUMA, Michigan/MI",26045,"Eaton County, Michigan",109155,647,11,593,10,0.584,368,16,98,51,0,18,419,16,116,18,114,132,551,67,9,3,21,0,3,3,18,76,24,3,21
26,Michigan/MI,2602000,"Calhoun & Barry Counties PUMA, Michigan/MI",26015,"Barry County, Michigan",60057,292,4,486,7,0.308,338,18,11,10,9,23,348,27,34,32,29,61,409,83,2,8,7,2,4,6,3,85,15,7,8
26,Michigan/MI,2602000,"Calhoun & Barry Counties PUMA, Michigan/MI",26025,"Calhoun County, Michigan",134473,1332,45,991,33,0.692,760,41,26,22,21,52,782,62,78,73,67,140,922,82,2,8,7,2,4,6,3,85,15,7,8
26,Michigan/MI,2602101,"Kalamazoo County (Outer) PUMA, Michigan/MI",26077,"Kalamazoo County, Michigan",261573,2833,93,1083,36,1,378,0,81,99,0,0,477,0,81,0,81,81,558,68,18,0,15,0,0,0,15,85,15,0,15
26,Michigan/MI,2602102,"Kalamazoo County (Central)--Kalamazoo & Portage Cities Area PUMA, Michigan/MI",26077,"Kalamazoo County, Michigan",261573,2833,93,1083,36,1,396,0,25,132,0,0,528,0,25,0,25,25,553,72,24,0,5,0,0,0,5,95,5,0,5
26,Michigan/MI,2602200,"St. Joseph & Branch Counties PUMA, Michigan/MI",26023,"Branch County, Michigan",43584,1425,28,3270,64,0.416,270,39,70,52,0,0,322,39,70,0,109,109,431,63,12,0,25,0,9,0,16,75,25,9,16
26,Michigan/MI,2602200,"St. Joseph & Branch Counties PUMA, Michigan/MI",26149,"St. Joseph County, Michigan",60897,763,11,1253,18,0.584,379,55,99,74,0,0,453,55,99,0,154,154,607,62,12,0,25,0,9,0,16,75,25,9,16
26,Michigan/MI,2602300,"Van Buren & Cass Counties PUMA, Michigan/MI",26027,"Cass County, Michigan",51460,572,16,1112,31,0.407,356,11,267,33,7,15,389,18,282,22,278,300,689,52,5,3,40,1,2,2,39,56,44,3,41
26,Michigan/MI,2602300,"Van Buren & Cass Counties PUMA, Michigan/MI",26159,"Van Buren County, Michigan",75272,753,17,1000,23,0.593,519,17,388,48,9,21,567,26,409,30,405,435,1002,52,5,3,40,1,2,2,39,57,43,3,41
26,Michigan/MI,2602400,"Berrien County PUMA, Michigan/MI",26021,"Berrien County, Michigan",154807,1935,74,1250,48,1,288,43,377,70,26,12,358,69,389,38,420,458,816,35,9,5,51,3,5,1,46,44,56,8,48
26,Michigan/MI,2602500,"Lenawee & Hillsdale Counties PUMA, Michigan/MI",26059,"Hillsdale County, Michigan",45830,344,27,751,59,0.317,316,3,68,15,0,0,331,3,68,0,71,71,402,79,4,0,18,0,1,0,17,82,18,1,17
26,Michigan/MI,2602500,"Lenawee & Hillsdale Counties PUMA, Michigan/MI",26091,"Lenawee County, Michigan",98474,1524,22,1548,22,0.683,681,5,147,31,0,0,712,5,147,0,152,152,864,79,4,0,18,0,1,0,17,82,18,1,17
26,Michigan/MI,2602600,"Jackson County PUMA, Michigan/MI",26075,"Jackson County, Michigan",158913,2806,66,1766,42,1,422,0,0,32,0,0,454,0,0,0,0,0,454,93,7,0,0,0,0,0,0,100,0,0,0
26,Michigan/MI,2602701,"Washtenaw County (West, Northeast & Southeast) PUMA, Michigan/MI",26161,"Washtenaw County, Michigan",365961,4050,125,1107,34,1,169,0,0,0,0,0,169,0,0,0,0,0,169,100,0,0,0,0,0,0,0,100,0,0,0
26,Michigan/MI,2602702,"Washtenaw County (East Central)--Ann Arbor City Area PUMA, Michigan/MI",26161,"Washtenaw County, Michigan",365961,4050,125,1107,34,1,69,0,6,0,19,19,69,19,25,38,6,44,113,61,0,34,5,17,0,17,5,61,39,17,22
26,Michigan/MI,2602703,"Washtenaw County (East Central, Outside Ann Arbor City) PUMA, Michigan/MI",26161,"Washtenaw County, Michigan",365961,4050,125,1107,34,1,197,0,0,31,0,51,228,0,51,51,0,51,279,71,11,18,0,0,0,18,0,82,18,0,18
26,Michigan/MI,2602800,"Livingston County PUMA, Michigan/MI",26093,"Livingston County, Michigan",188482,1419,31,753,16,1,182,0,13,2,17,0,184,17,13,17,13,30,214,85,1,8,6,8,0,0,6,86,14,8,6
26,Michigan/MI,2602901,"Oakland County (West) PUMA, Michigan/MI",26125,"Oakland County, Michigan",1250843,20442,1196,1634,96,1,19,0,0,0,0,0,19,0,0,0,0,0,19,100,0,0,0,0,0,0,0,100,0,0,0
26,Michigan/MI,2602902,"Oakland County (Northeast) PUMA, Michigan/MI",26125,"Oakland County, Michigan",1250843,20442,1196,1634,96,1,155,0,27,0,0,0,155,0,27,0,27,27,182,85,0,0,15,0,0,0,15,85,15,0,15
26,Michigan/MI,2602903,"Oakland County (East Central)--Troy & Rochester Area PUMA, Michigan/MI",26125,"Oakland County, Michigan",1250843,20442,1196,1634,96,1,23,0,33,0,0,0,23,0,33,0,33,33,56,41,0,0,59,0,0,0,59,41,59,0,59
26,Michigan/MI,2602904,"Oakland County (Central) PUMA, Michigan/MI",26125,"Oakland County, Michigan",1250843,20442,1196,1634,96,1,47,0,0,21,0,0,68,0,0,0,0,0,68,69,31,0,0,0,0,0,0,100,0,0,0
26,Michigan/MI,2602905,"Oakland County (Southwest) PUMA, Michigan/MI",26125,"Oakland County, Michigan",1250843,20442,1196,1634,96,1,31,0,0,0,0,0,31,0,0,0,0,0,31,100,0,0,0,0,0,0,0,100,0,0,0
26,Michigan/MI,2602907,"Oakland County (South Central)--Farmington & Southfield Area PUMA, Michigan/MI",26125,"Oakland County, Michigan",1250843,20442,1196,1634,96,1,16,12,0,84,0,32,100,12,32,32,12,44,144,11,58,22,8,0,8,22,0,69,31,8,22
26,Michigan/MI,2602908,"Oakland County (Southeast) PUMA, Michigan/MI",26125,"Oakland County, Michigan",1250843,20442,1196,1634,96,1,242,0,0,0,0,0,242,0,0,0,0,0,242,100,0,0,0,0,0,0,0,100,0,0,0
26,Michigan/MI,2603001,"Macomb County (North) PUMA, Michigan/MI",26099,"Macomb County, Michigan",868704,14644,1025,1686,118,1,147,0,6,0,0,0,147,0,6,0,6,6,153,96,0,0,4,0,0,0,4,96,4,0,4
26,Michigan/MI,2603002,"Macomb County (Central) PUMA, Michigan/MI",26099,"Macomb County, Michigan",868704,14644,1025,1686,118,1,21,0,3,0,31,0,21,31,3,31,3,34,55,38,0,56,5,56,0,0,5,38,62,56,5
26,Michigan/MI,2603003,"Macomb County (Southwest)--Sterling Heights City PUMA, Michigan/MI",26099,"Macomb County, Michigan",868704,14644,1025,1686,118,1,86,0,24,0,149,0,86,149,24,149,24,173,259,33,0,58,9,58,0,0,9,33,67,58,9
26,Michigan/MI,2603004,"Macomb County (Southeast)--Mount Clemens & Fraser Area PUMA, Michigan/MI",26099,"Macomb County, Michigan",868704,14644,1025,1686,118,1,117,0,12,31,0,29,148,0,41,29,12,41,189,62,16,15,6,0,0,15,6,78,22,0,22
26,Michigan/MI,2603005,"Macomb County (Southeast)--St. Clair Shores, Roseville & Eastpointe Area PUMA, Michigan/MI",26099,"Macomb County, Michigan",868704,14644,1025,1686,118,1,209,0,22,0,0,0,209,0,22,0,22,22,231,90,0,0,10,0,0,0,10,90,10,0,10
26,Michigan/MI,2603006,"Macomb County (Southwest)--Warren & Center Line Cities PUMA, Michigan/MI",26099,"Macomb County, Michigan",868704,14644,1025,1686,118,1,142,0,3,9,0,83,151,0,86,83,3,86,237,60,4,35,1,0,0,35,1,64,36,0,36
26,Michigan/MI,2603100,"St. Clair County PUMA, Michigan/MI",26147,"St. Clair County, Michigan",159566,1001,56,627,35,1,400,47,40,47,0,0,447,47,40,0,87,87,534,75,9,0,16,0,9,0,7,84,16,9,7
26,Michigan/MI,2603201,"Wayne County (Northwest) PUMA, Michigan/MI",26163,"Wayne County, Michigan",1761382,34928,2975,1983,169,1,137,0,0,17,44,0,154,44,0,44,0,44,198,69,9,22,0,22,0,0,0,78,22,22,0
26,Michigan/MI,2603202,"Wayne County (North Central)--Livonia City & Redford Charter Township PUMA, Michigan/MI",26163,"Wayne County, Michigan",1761382,34928,2975,1983,169,1,38,0,0,0,32,0,38,32,0,32,0,32,70,54,0,46,0,46,0,0,0,54,46,46,0
26,Michigan/MI,2603203,"Wayne County (Central)--Dearborn & Dearborn Heights Cities PUMA, Michigan/MI",26163,"Wayne County, Michigan",1761382,34928,2975,1983,169,1,142,58,0,0,16,0,142,74,0,16,58,74,216,66,0,7,27,7,27,0,0,66,34,34,0
26,Michigan/MI,2603204,"Wayne County (Central)--Westland, Garden City, Inkster & Wayne Cities PUMA, Michigan/MI",26163,"Wayne County, Michigan",1761382,34928,2975,1983,169,1,126,0,0,0,0,0,126,0,0,0,0,0,126,100,0,0,0,0,0,0,0,100,0,0,0
26,Michigan/MI,2603205,"Wayne County (Southwest) PUMA, Michigan/MI",26163,"Wayne County, Michigan",1761382,34928,2975,1983,169,1,230,0,61,28,0,0,258,0,61,0,61,61,319,72,9,0,19,0,0,0,19,81,19,0,19
26,Michigan/MI,2603206,"Wayne County (Southeast)--Downriver Area (South) PUMA, Michigan/MI",26163,"Wayne County, Michigan",1761382,34928,2975,1983,169,1,115,0,0,17,0,0,132,0,0,0,0,0,132,87,13,0,0,0,0,0,0,100,0,0,0
26,Michigan/MI,2603207,"Wayne County (Southeast)--Downriver Area (North) PUMA, Michigan/MI",26163,"Wayne County, Michigan",1761382,34928,2975,1983,169,1,159,66,107,81,0,0,240,66,107,0,173,173,413,38,20,0,42,0,16,0,26,58,42,16,26
26,Michigan/MI,2603208,"Detroit City (Northwest) PUMA, Michigan/MI",26163,"Wayne County, Michigan",1761382,34928,2975,1983,169,1,223,0,69,25,0,0,248,0,69,0,69,69,317,70,8,0,22,0,0,0,22,78,22,0,22
26,Michigan/MI,2603209,"Detroit City (North Central) PUMA, Michigan/MI",26163,"Wayne County, Michigan",1761382,34928,2975,1983,169,1,520,0,35,0,0,0,520,0,35,0,35,35,555,94,0,0,6,0,0,0,6,94,6,0,6
26,Michigan/MI,2603210,"Detroit City (Northeast) PUMA, Michigan/MI",26163,"Wayne County, Michigan",1761382,34928,2975,1983,169,1,225,0,0,0,0,0,225,0,0,0,0,0,225,100,0,0,0,0,0,0,0,100,0,0,0
26,Michigan/MI,2603211,"Detroit City (South Central & Southeast) PUMA, Michigan/MI",26163,"Wayne County, Michigan",1761382,34928,2975,1983,169,1,62,0,19,37,0,0,99,0,19,0,19,19,118,53,31,0,16,0,0,0,16,84,16,0,16
26,Michigan/MI,2603212,"Detroit City (Southwest) PUMA, Michigan/MI",26163,"Wayne County, Michigan",1761382,34928,2975,1983,169,1,12,28,503,255,0,0,267,28,503,0,531,531,798,2,32,0,67,0,4,0,63,33,67,4,63
26,Michigan/MI,2603213,"Wayne County (Northeast)--I-94 Corridor PUMA, Michigan/MI",26163,"Wayne County, Michigan",1761382,34928,2975,1983,169,1,50,0,0,0,0,41,50,0,41,41,0,41,91,55,0,45,0,0,0,45,0,55,45,0,45
26,Michigan/MI,2603300,"Monroe County PUMA, Michigan/MI",26115,"Monroe County, Michigan",149699,1506,28,1006,19,1,330,47,66,5,0,14,335,47,80,14,113,127,462,71,1,3,24,0,10,3,14,73,27,10,17
27,Minnesota/MN,2700100,"Clay, Polk, Roseau, Pennington, Marshall, Norman, Kittson & Red Lake Counties PUMA, Minnesota/MN",27027,"Clay County, Minnesota",62801,1371,40,2183,64,0.423,783,3,16,48,0,3,831,3,19,3,19,22,853,92,6,0,2,0,0,0,2,97,3,0,2
27,Minnesota/MN,2700100,"Clay, Polk, Roseau, Pennington, Marshall, Norman, Kittson & Red Lake Counties PUMA, Minnesota/MN",27069,"Kittson County, Minnesota",4337,12,0,277,0,0.029,54,0,1,3,0,0,57,0,1,0,1,1,58,93,5,0,2,0,0,0,2,98,2,0,2
27,Minnesota/MN,2700100,"Clay, Polk, Roseau, Pennington, Marshall, Norman, Kittson & Red Lake Counties PUMA, Minnesota/MN",27089,"Marshall County, Minnesota",9392,51,1,543,11,0.063,117,0,2,7,0,0,124,0,2,0,2,2,126,93,6,0,2,0,0,0,2,98,2,0,2
27,Minnesota/MN,2700100,"Clay, Polk, Roseau, Pennington, Marshall, Norman, Kittson & Red Lake Counties PUMA, Minnesota/MN",27107,"Norman County, Minnesota",6559,54,0,823,0,0.044,81,0,2,5,0,0,86,0,2,0,2,2,88,92,6,0,2,0,0,0,2,98,2,0,2
27,Minnesota/MN,2700100,"Clay, Polk, Roseau, Pennington, Marshall, Norman, Kittson & Red Lake Counties PUMA, Minnesota/MN",27113,"Pennington County, Minnesota",14184,117,1,825,7,0.096,178,1,4,11,0,1,189,1,5,1,5,6,195,91,6,1,3,0,1,1,2,97,3,1,3
27,Minnesota/MN,2700100,"Clay, Polk, Roseau, Pennington, Marshall, Norman, Kittson & Red Lake Counties PUMA, Minnesota/MN",27119,"Polk County, Minnesota",31591,305,4,965,13,0.213,394,1,8,24,0,1,418,1,9,1,9,10,428,92,6,0,2,0,0,0,2,98,2,0,2
27,Minnesota/MN,2700100,"Clay, Polk, Roseau, Pennington, Marshall, Norman, Kittson & Red Lake Counties PUMA, Minnesota/MN",27125,"Red Lake County, Minnesota",4008,44,1,1098,25,0.027,50,0,1,3,0,0,53,0,1,0,1,1,54,93,6,0,2,0,0,0,2,98,2,0,2
27,Minnesota/MN,2700100,"Clay, Polk, Roseau, Pennington, Marshall, Norman, Kittson & Red Lake Counties PUMA, Minnesota/MN",27135,"Roseau County, Minnesota",15462,118,0,763,0,0.105,194,1,4,12,0,1,206,1,5,1,5,6,212,92,6,0,2,0,0,0,2,97,3,0,2
27,Minnesota/MN,2700200,"Beltrami, Becker, Hubbard, Clearwater, Mahnomen & Lake of the Woods Counties PUMA, Minnesota/MN",27005,"Becker County, Minnesota",33773,272,2,805,6,0.284,362,0,28,15,0,22,377,0,50,22,28,50,427,85,4,5,7,0,0,5,7,88,12,0,12
27,Minnesota/MN,2700200,"Beltrami, Becker, Hubbard, Clearwater, Mahnomen & Lake of the Woods Counties PUMA, Minnesota/MN",27007,"Beltrami County, Minnesota",46117,413,5,896,11,0.389,495,0,38,21,0,31,516,0,69,31,38,69,585,85,4,5,6,0,0,5,6,88,12,0,12
27,Minnesota/MN,2700200,"Beltrami, Becker, Hubbard, Clearwater, Mahnomen & Lake of the Woods Counties PUMA, Minnesota/MN",27029,"Clearwater County, Minnesota",8812,27,0,306,0,0.074,94,0,7,4,0,6,98,0,13,6,7,13,111,85,4,5,6,0,0,5,6,88,12,0,12
27,Minnesota/MN,2700200,"Beltrami, Becker, Hubbard, Clearwater, Mahnomen & Lake of the Woods Counties PUMA, Minnesota/MN",27057,"Hubbard County, Minnesota",20862,97,1,465,5,0.175,223,0,17,9,0,14,232,0,31,14,17,31,263,85,3,5,6,0,0,5,6,88,12,0,12
27,Minnesota/MN,2700200,"Beltrami, Becker, Hubbard, Clearwater, Mahnomen & Lake of the Woods Counties PUMA, Minnesota/MN",27077,"Lake of the Woods County, Minnesota",3809,21,1,551,26,0.032,41,0,3,2,0,3,43,0,6,3,3,6,49,84,4,6,6,0,0,6,6,88,12,0,12
27,Minnesota/MN,2700200,"Beltrami, Becker, Hubbard, Clearwater, Mahnomen & Lake of the Woods Counties PUMA, Minnesota/MN",27087,"Mahnomen County, Minnesota",5506,46,1,835,18,0.046,59,0,5,2,0,4,61,0,9,4,5,9,70,84,3,6,7,0,0,6,7,87,13,0,13
27,Minnesota/MN,2700300,"Itasca, Carlton (South), Cass & Aitkin Counties--Grand Rapids City PUMA, Minnesota/MN",27001,"Aitkin County, Minnesota",15834,76,1,480,6,0.127,35,0,2,1,0,0,36,0,2,0,2,2,38,92,3,0,5,0,0,0,5,95,5,0,5
27,Minnesota/MN,2700300,"Itasca, Carlton (South), Cass & Aitkin Counties--Grand Rapids City PUMA, Minnesota/MN",27017,"Carlton County, Minnesota",35540,263,1,740,3,0.266,73,1,4,3,0,0,76,1,4,0,5,5,81,90,4,0,6,0,1,0,5,94,6,1,5
27,Minnesota/MN,2700300,"Itasca, Carlton (South), Cass & Aitkin Counties--Grand Rapids City PUMA, Minnesota/MN",27021,"Cass County, Minnesota",29022,165,4,569,14,0.237,65,0,4,2,0,0,67,0,4,0,4,4,71,92,3,0,6,0,0,0,6,94,6,0,6
27,Minnesota/MN,2700300,"Itasca, Carlton (South), Cass & Aitkin Counties--Grand Rapids City PUMA, Minnesota/MN",27061,"Itasca County, Minnesota",45203,313,14,692,31,0.37,101,1,6,4,0,0,105,1,6,0,7,7,112,90,4,0,6,0,1,0,5,94,6,1,5
27,Minnesota/MN,2700400,"St. Louis (North), Koochiching, Lake & Cook Counties--Hibbing & Cloquet Cities PUMA, Minnesota/MN",27017,"Carlton County, Minnesota",35540,263,1,740,3,0.024,5,0,0,0,0,0,5,0,0,0,0,0,5,100,0,0,0,0,0,0,0,100,0,0,0
27,Minnesota/MN,2700400,"St. Louis (North), Koochiching, Lake & Cook Counties--Hibbing & Cloquet Cities PUMA, Minnesota/MN",27031,"Cook County, Minnesota",5311,6,0,113,0,0.04,8,0,0,1,0,0,9,0,0,0,0,0,9,89,11,0,0,0,0,0,0,100,0,0,0
27,Minnesota/MN,2700400,"St. Louis (North), Koochiching, Lake & Cook Counties--Hibbing & Cloquet Cities PUMA, Minnesota/MN",27071,"Koochiching County, Minnesota",12644,121,3,957,24,0.097,19,0,0,2,0,0,21,0,0,0,0,0,21,90,10,0,0,0,0,0,0,100,0,0,0
27,Minnesota/MN,2700400,"St. Louis (North), Koochiching, Lake & Cook Counties--Hibbing & Cloquet Cities PUMA, Minnesota/MN",27075,"Lake County, Minnesota",10569,58,0,549,0,0.081,16,0,0,1,0,0,17,0,0,0,0,0,17,94,6,0,0,0,0,0,0,100,0,0,0
27,Minnesota/MN,2700400,"St. Louis (North), Koochiching, Lake & Cook Counties--Hibbing & Cloquet Cities PUMA, Minnesota/MN",27137,"St. Louis County, Minnesota",200080,1555,39,777,19,0.757,147,0,0,14,0,2,161,0,2,2,0,2,163,90,9,1,0,0,0,1,0,99,1,0,1
27,Minnesota/MN,2700500,"St. Louis County (Southeast)--Duluth, Hermantown & Proctor Cities PUMA, Minnesota/MN",27137,"St. Louis County, Minnesota",200080,1555,39,777,19,1,73,0,0,1,0,0,74,0,0,0,0,0,74,99,1,0,0,0,0,0,0,100,0,0,0
27,Minnesota/MN,2700600,"Chisago, Isanti, Pine, Mille Lacs & Kanabec Counties PUMA, Minnesota/MN",27025,"Chisago County, Minnesota",54727,484,1,884,2,0.333,237,0,11,24,3,0,261,3,11,3,11,14,275,86,9,1,4,1,0,0,4,95,5,1,4
27,Minnesota/MN,2700600,"Chisago, Isanti, Pine, Mille Lacs & Kanabec Counties PUMA, Minnesota/MN",27059,"Isanti County, Minnesota",38974,289,0,742,0,0.237,169,0,8,17,2,0,186,2,8,2,8,10,196,86,9,1,4,1,0,0,4,95,5,1,4
27,Minnesota/MN,2700600,"Chisago, Isanti, Pine, Mille Lacs & Kanabec Counties PUMA, Minnesota/MN",27065,"Kanabec County, Minnesota",16004,119,8,744,50,0.096,68,0,3,7,1,0,75,1,3,1,3,4,79,86,9,1,4,1,0,0,4,95,5,1,4
27,Minnesota/MN,2700600,"Chisago, Isanti, Pine, Mille Lacs & Kanabec Counties PUMA, Minnesota/MN",27095,"Mille Lacs County, Minnesota",25728,158,3,614,12,0.157,112,0,5,11,1,0,123,1,5,1,5,6,129,87,9,1,4,1,0,0,4,95,5,1,4
27,Minnesota/MN,2700600,"Chisago, Isanti, Pine, Mille Lacs & Kanabec Counties PUMA, Minnesota/MN",27115,"Pine County, Minnesota",29129,319,0,1095,0,0.176,125,0,6,13,2,0,138,2,6,2,6,8,146,86,9,1,4,1,0,0,4,95,5,1,4
27,Minnesota/MN,2700700,"Crow Wing, Morrison, Todd & Wadena Counties PUMA, Minnesota/MN",27035,"Crow Wing County, Minnesota",63855,494,18,774,28,0.474,940,0,113,3,4,0,943,4,113,4,113,117,1060,89,0,0,11,0,0,0,11,89,11,0,11
27,Minnesota/MN,2700700,"Crow Wing, Morrison, Todd & Wadena Counties PUMA, Minnesota/MN",27097,"Morrison County, Minnesota",32949,233,1,707,3,0.244,484,0,58,2,2,0,486,2,58,2,58,60,546,89,0,0,11,0,0,0,11,89,11,0,11
27,Minnesota/MN,2700700,"Crow Wing, Morrison, Todd & Wadena Counties PUMA, Minnesota/MN",27153,"Todd County, Minnesota",24440,488,2,1997,8,0.18,357,0,43,1,2,0,358,2,43,2,43,45,403,89,0,0,11,0,0,0,11,89,11,0,11
27,Minnesota/MN,2700700,"Crow Wing, Morrison, Todd & Wadena Counties PUMA, Minnesota/MN",27159,"Wadena County, Minnesota",13646,68,0,498,0,0.102,202,0,24,1,1,0,203,1,24,1,24,25,228,89,0,0,11,0,0,0,11,89,11,0,11
27,Minnesota/MN,2700800,"West Central Minnesota PUMA, Minnesota/MN",27011,"Big Stone County, Minnesota",5016,81,0,1615,0,0.034,76,3,14,2,2,4,78,5,18,6,17,23,101,75,2,6,17,2,3,4,14,77,23,5,18
27,Minnesota/MN,2700800,"West Central Minnesota PUMA, Minnesota/MN",27041,"Douglas County, Minnesota",37203,297,2,798,5,0.256,570,22,102,14,17,30,584,39,132,47,124,171,755,75,2,6,16,2,3,4,14,77,23,5,17
27,Minnesota/MN,2700800,"West Central Minnesota PUMA, Minnesota/MN",27051,"Grant County, Minnesota",5938,61,4,1027,67,0.041,91,4,16,2,3,5,93,7,21,8,20,28,121,75,2,7,17,2,3,4,13,77,23,6,17
27,Minnesota/MN,2700800,"West Central Minnesota PUMA, Minnesota/MN",27111,"Otter Tail County, Minnesota",57992,430,4,741,7,0.397,884,34,159,21,27,47,905,61,206,74,193,267,1172,75,2,6,16,2,3,4,14,77,23,5,18
27,Minnesota/MN,2700800,"West Central Minnesota PUMA, Minnesota/MN",27121,"Pope County, Minnesota",10980,92,0,838,0,0.075,167,6,30,4,5,9,171,11,39,14,36,50,221,76,2,6,16,2,3,4,14,77,23,5,18
27,Minnesota/MN,2700800,"West Central Minnesota PUMA, Minnesota/MN",27149,"Stevens County, Minnesota",9784,97,1,991,10,0.066,147,6,26,4,4,8,151,10,34,12,32,44,195,75,2,6,16,2,3,4,13,77,23,5,17
27,Minnesota/MN,2700800,"West Central Minnesota PUMA, Minnesota/MN",27151,"Swift County, Minnesota",9411,137,1,1456,11,0.064,142,6,26,3,4,8,145,10,34,12,32,44,189,75,2,6,17,2,3,4,14,77,23,5,18
27,Minnesota/MN,2700800,"West Central Minnesota PUMA, Minnesota/MN",27155,"Traverse County, Minnesota",3337,29,0,869,0,0.023,51,2,9,1,2,3,52,4,12,5,11,16,68,75,1,7,16,3,3,4,13,76,24,6,18
27,Minnesota/MN,2700800,"West Central Minnesota PUMA, Minnesota/MN",27167,"Wilkin County, Minnesota",6343,63,3,993,47,0.043,96,4,17,2,3,5,98,7,22,8,21,29,127,76,2,6,17,2,3,4,13,77,23,6,17
27,Minnesota/MN,2700900,"Stearns County--St. Cloud City PUMA, Minnesota/MN",27145,"Stearns County, Minnesota",156819,3950,24,2519,15,1,1631,105,344,131,0,134,1762,105,478,134,449,583,2345,70,6,6,19,0,4,6,15,75,25,4,20
27,Minnesota/MN,2701000,"Sherburne & Benton Counties PUMA, Minnesota/MN",27009,"Benton County, Minnesota",39779,536,3,1347,8,0.3,176,0,0,0,0,0,176,0,0,0,0,0,176,100,0,0,0,0,0,0,0,100,0,0,0
27,Minnesota/MN,2701000,"Sherburne & Benton Counties PUMA, Minnesota/MN",27141,"Sherburne County, Minnesota",93231,1137,14,1220,15,0.7,412,0,0,0,0,0,412,0,0,0,0,0,412,100,0,0,0,0,0,0,0,100,0,0,0
27,Minnesota/MN,2701101,"Anoka County (Northwest)--Andover, Ramsey, Anoka & East Bethel Cities PUMA, Minnesota/MN",27003,"Anoka County, Minnesota",347431,6006,133,1729,38,1,239,0,0,76,0,0,315,0,0,0,0,0,315,76,24,0,0,0,0,0,0,100,0,0,0
27,Minnesota/MN,2701102,"Anoka County (Southwest)--Coon Rapids, Fridley & Columbia Heights Cities PUMA, Minnesota/MN",27003,"Anoka County, Minnesota",347431,6006,133,1729,38,1,254,15,18,0,23,123,254,38,141,146,33,179,433,59,0,34,8,5,3,28,4,59,41,9,33
27,Minnesota/MN,2701103,"Anoka County (East)--Blaine, Lino Lakes & Ham Lake Cities PUMA, Minnesota/MN",27003,"Anoka County, Minnesota",347431,6006,133,1729,38,1,246,0,0,25,146,113,271,146,113,259,0,259,530,46,5,49,0,28,0,21,0,51,49,28,21
27,Minnesota/MN,2701201,"Washington County (North)--Oakdale, Forest Lake, Stillwater & Hugo Cities PUMA, Minnesota/MN",27163,"Washington County, Minnesota",253317,3735,55,1474,22,1,309,0,55,0,0,0,309,0,55,0,55,55,364,85,0,0,15,0,0,0,15,85,15,0,15
27,Minnesota/MN,2701202,"Washington County (South)--Woodbury & Cottage Grove Cities PUMA, Minnesota/MN",27163,"Washington County, Minnesota",253317,3735,55,1474,22,1,204,0,19,0,0,46,204,0,65,46,19,65,269,76,0,17,7,0,0,17,7,76,24,0,24
27,Minnesota/MN,2701301,"Ramsey County (North)--Shoreview, White Bear Lake & New Brighton Cities PUMA, Minnesota/MN",27123,"Ramsey County, Minnesota",541493,10775,319,1990,59,1,187,0,88,0,56,0,187,56,88,56,88,144,331,56,0,17,27,17,0,0,27,56,44,17,27
27,Minnesota/MN,2701302,"Ramsey County (Central & Far Southeast)--Maplewood, Roseville & North St. Paul Cities PUMA, Minnesota/MN",27123,"Ramsey County, Minnesota",541493,10775,319,1990,59,1,186,0,105,0,23,0,186,23,105,23,105,128,314,59,0,7,33,7,0,0,33,59,41,7,33
27,Minnesota/MN,2701303,"Ramsey County (Southeast)--St. Paul City (East) PUMA, Minnesota/MN",27123,"Ramsey County, Minnesota",541493,10775,319,1990,59,1,157,53,10,39,99,318,196,152,328,417,63,480,676,23,6,62,9,15,8,47,1,29,71,22,49
27,Minnesota/MN,2701304,"Ramsey County (Southwest)--St. Paul City (West) PUMA, Minnesota/MN",27123,"Ramsey County, Minnesota",541493,10775,319,1990,59,1,33,11,33,0,51,427,33,62,460,478,44,522,555,6,0,86,8,9,2,77,6,6,94,11,83
27,Minnesota/MN,2701401,"Hennepin County (West)--Champlin, Rogers Cities & Lake Minnetonka PUMA, Minnesota/MN",27053,"Hennepin County, Minnesota",1235478,26706,928,2162,75,1,187,0,0,0,0,0,187,0,0,0,0,0,187,100,0,0,0,0,0,0,0,100,0,0,0
27,Minnesota/MN,2701402,"Hennepin County--Plymouth, Maple Grove (West) & Medicine Lake Cities PUMA, Minnesota/MN",27053,"Hennepin County, Minnesota",1235478,26706,928,2162,75,1,303,0,0,52,0,0,355,0,0,0,0,0,355,85,15,0,0,0,0,0,0,100,0,0,0
27,Minnesota/MN,2701403,"Hennepin County--Brooklyn Park, Maple Grove (East) & Osseo Cities PUMA, Minnesota/MN",27053,"Hennepin County, Minnesota",1235478,26706,928,2162,75,1,199,0,42,0,0,51,199,0,93,51,42,93,292,68,0,17,14,0,0,17,14,68,32,0,32
27,Minnesota/MN,2701404,"Hennepin County--Brooklyn Center, Golden Valley, New Hope & Robbinsdale Cities PUMA, Minnesota/MN",27053,"Hennepin County, Minnesota",1235478,26706,928,2162,75,1,101,0,107,145,28,53,246,28,160,81,107,188,434,23,33,19,25,6,0,12,25,57,43,6,37
27,Minnesota/MN,2701405,"Hennepin County--Minneapolis (North) & St. Anthony Cities PUMA, Minnesota/MN",27053,"Hennepin County, Minnesota",1235478,26706,928,2162,75,1,191,0,40,44,161,49,235,161,89,210,40,250,485,39,9,43,8,33,0,10,8,48,52,33,18
27,Minnesota/MN,2701406,"Hennepin County--Minneapolis City (Southeast) PUMA, Minnesota/MN",27053,"Hennepin County, Minnesota",1235478,26706,928,2162,75,1,324,0,257,0,86,49,324,86,306,135,257,392,716,45,0,19,36,12,0,7,36,45,55,12,43
27,Minnesota/MN,2701407,"Hennepin County--Minneapolis City (Southwest) PUMA, Minnesota/MN",27053,"Hennepin County, Minnesota",1235478,26706,928,2162,75,1,213,0,31,0,0,0,213,0,31,0,31,31,244,87,0,0,13,0,0,0,13,87,13,0,13
27,Minnesota/MN,2701408,"Hennepin County--Edina, St. Louis Park & Hopkins Cities PUMA, Minnesota/MN",27053,"Hennepin County, Minnesota",1235478,26706,928,2162,75,1,84,41,0,0,0,0,84,41,0,0,41,41,125,67,0,0,33,0,33,0,0,67,33,33,0
27,Minnesota/MN,2701409,"Hennepin County--Eden Prairie & Minnetonka Cities PUMA, Minnesota/MN",27053,"Hennepin County, Minnesota",1235478,26706,928,2162,75,1,41,0,31,0,58,0,41,58,31,58,31,89,130,32,0,45,24,45,0,0,24,32,68,45,24
27,Minnesota/MN,2701410,"Hennepin County--Bloomington & Richfield Cities PUMA, Minnesota/MN",27053,"Hennepin County, Minnesota",1235478,26706,928,2162,75,1,21,12,80,0,0,0,21,12,80,0,92,92,113,19,0,0,81,0,11,0,71,19,81,11,71
27,Minnesota/MN,2701501,"Dakota County (North)--Eagan, Inver Grove Heights & South St. Paul Cities PUMA, Minnesota/MN",27037,"Dakota County, Minnesota",418201,7428,125,1776,30,1,318,0,0,12,30,20,330,30,20,50,0,50,380,84,3,13,0,8,0,5,0,87,13,8,5
27,Minnesota/MN,2701502,"Dakota County (South)--Lakeville, Hastings, Rosemount & Farmington Cities PUMA, Minnesota/MN",27037,"Dakota County, Minnesota",418201,7428,125,1776,30,1,845,0,19,43,414,57,888,414,76,471,19,490,1378,61,3,34,1,30,0,4,1,64,36,30,6
27,Minnesota/MN,2701503,"Dakota County (West)--Burnsville & Apple Valley Cities PUMA, Minnesota/MN",27037,"Dakota County, Minnesota",418201,7428,125,1776,30,1,161,0,51,0,0,5,161,0,56,5,51,56,217,74,0,2,24,0,0,2,24,74,26,0,26
27,Minnesota/MN,2701600,"Scott County (East)--Shakopee, Savage & Prior Lake Cities PUMA, Minnesota/MN",27139,"Scott County, Minnesota",143372,2532,33,1766,23,1,392,0,3,80,0,70,472,0,73,70,3,73,545,72,15,13,1,0,0,13,1,87,13,0,13
27,Minnesota/MN,2701700,"Carver & Scott (West) Counties PUMA, Minnesota/MN",27019,"Carver County, Minnesota",100416,1396,7,1390,7,0.863,194,0,36,0,17,0,194,17,36,17,36,53,247,79,0,7,15,7,0,0,15,79,21,7,15
27,Minnesota/MN,2701700,"Carver & Scott (West) Counties PUMA, Minnesota/MN",27139,"Scott County, Minnesota",143372,2532,33,1766,23,0.137,31,0,6,0,3,0,31,3,6,3,6,9,40,78,0,8,15,8,0,0,15,78,22,8,15
27,Minnesota/MN,2701800,"Wright County PUMA, Minnesota/MN",27171,"Wright County, Minnesota",132745,1603,7,1208,5,1,709,0,96,61,60,14,770,60,110,74,96,170,940,75,6,8,10,6,0,1,10,82,18,6,12
27,Minnesota/MN,2701900,"Kandiyohi, McLeod, Meeker, Renville & Sibley Counties PUMA, Minnesota/MN",27067,"Kandiyohi County, Minnesota",42658,982,2,2302,5,0.325,625,22,223,53,29,57,678,51,280,86,245,331,1009,62,5,9,24,3,2,6,22,67,33,5,28
27,Minnesota/MN,2701900,"Kandiyohi, McLeod, Meeker, Renville & Sibley Counties PUMA, Minnesota/MN",27085,"McLeod County, Minnesota",35825,478,2,1334,6,0.274,527,18,188,45,24,48,572,42,236,72,206,278,850,62,5,8,24,3,2,6,22,67,33,5,28
27,Minnesota/MN,2701900,"Kandiyohi, McLeod, Meeker, Renville & Sibley Counties PUMA, Minnesota/MN",27093,"Meeker County, Minnesota",23079,198,2,858,9,0.177,341,12,121,29,16,31,370,28,152,47,133,180,550,62,5,9,24,3,2,6,22,67,33,5,28
27,Minnesota/MN,2701900,"Kandiyohi, McLeod, Meeker, Renville & Sibley Counties PUMA, Minnesota/MN",27129,"Renville County, Minnesota",14721,147,8,999,54,0.112,215,8,77,18,10,20,233,18,97,30,85,115,348,62,5,9,24,3,2,6,22,67,33,5,28
27,Minnesota/MN,2701900,"Kandiyohi, McLeod, Meeker, Renville & Sibley Counties PUMA, Minnesota/MN",27143,"Sibley County, Minnesota",14912,191,3,1281,20,0.113,217,8,77,18,10,20,235,18,97,30,85,115,350,62,5,9,24,3,2,6,22,67,33,5,28
27,Minnesota/MN,2702000,"Brown, Lyon, Redwood, Chippewa, Yellow Medicine, Lac qui Parle & Lincoln Counties PUMA, Minnesota/MN",27015,"Brown County, Minnesota",25211,184,2,730,8,0.251,522,13,24,19,4,22,541,17,46,26,37,63,604,86,3,4,6,1,2,4,4,90,10,3,8
27,Minnesota/MN,2702000,"Brown, Lyon, Redwood, Chippewa, Yellow Medicine, Lac qui Parle & Lincoln Counties PUMA, Minnesota/MN",27023,"Chippewa County, Minnesota",12010,208,1,1732,8,0.12,249,6,11,9,2,11,258,8,22,13,17,30,288,86,3,5,6,1,2,4,4,90,10,3,8
27,Minnesota/MN,2702000,"Brown, Lyon, Redwood, Chippewa, Yellow Medicine, Lac qui Parle & Lincoln Counties PUMA, Minnesota/MN",27073,"Lac qui Parle County, Minnesota",6773,53,1,783,15,0.067,139,3,6,5,1,6,144,4,12,7,9,16,160,87,3,4,6,1,2,4,4,90,10,2,8
27,Minnesota/MN,2702000,"Brown, Lyon, Redwood, Chippewa, Yellow Medicine, Lac qui Parle & Lincoln Counties PUMA, Minnesota/MN",27081,"Lincoln County, Minnesota",5707,111,0,1945,0,0.057,119,3,5,4,1,5,123,4,10,6,8,14,137,87,3,4,6,1,2,4,4,90,10,3,7
27,Minnesota/MN,2702000,"Brown, Lyon, Redwood, Chippewa, Yellow Medicine, Lac qui Parle & Lincoln Counties PUMA, Minnesota/MN",27083,"Lyon County, Minnesota",25839,678,4,2624,15,0.255,530,13,24,19,4,22,549,17,46,26,37,63,612,87,3,4,6,1,2,4,4,90,10,3,8
27,Minnesota/MN,2702000,"Brown, Lyon, Redwood, Chippewa, Yellow Medicine, Lac qui Parle & Lincoln Counties PUMA, Minnesota/MN",27127,"Redwood County, Minnesota",15331,158,1,1031,7,0.151,314,8,14,11,3,13,325,11,27,16,22,38,363,87,3,4,6,1,2,4,4,90,10,3,7
27,Minnesota/MN,2702000,"Brown, Lyon, Redwood, Chippewa, Yellow Medicine, Lac qui Parle & Lincoln Counties PUMA, Minnesota/MN",27173,"Yellow Medicine County, Minnesota",9868,176,2,1784,20,0.099,206,5,9,7,2,9,213,7,18,11,14,25,238,87,3,5,6,1,2,4,4,89,11,3,8
27,Minnesota/MN,2702100,"Southwest Minnesota PUMA, Minnesota/MN",27033,"Cottonwood County, Minnesota",11372,224,0,1970,0,0.1,269,21,122,18,43,43,287,64,165,86,143,229,516,52,3,17,28,8,4,8,24,56,44,12,32
27,Minnesota/MN,2702100,"Southwest Minnesota PUMA, Minnesota/MN",27043,"Faribault County, Minnesota",13896,141,0,1015,0,0.121,325,26,147,22,52,52,347,78,199,104,173,277,624,52,4,17,28,8,4,8,24,56,44,12,32
27,Minnesota/MN,2702100,"Southwest Minnesota PUMA, Minnesota/MN",27063,"Jackson County, Minnesota",10047,145,1,1443,10,0.086,231,18,105,16,37,37,247,55,142,74,123,197,444,52,4,17,28,8,4,8,24,56,44,12,32
27,Minnesota/MN,2702100,"Southwest Minnesota PUMA, Minnesota/MN",27091,"Martin County, Minnesota",19964,394,10,1974,50,0.172,463,36,209,31,74,74,494,110,283,148,245,393,887,52,3,17,28,8,4,8,24,56,44,12,32
27,Minnesota/MN,2702100,"Southwest Minnesota PUMA, Minnesota/MN",27101,"Murray County, Minnesota",8353,163,2,1951,24,0.072,194,15,88,13,31,31,207,46,119,62,103,165,372,52,3,17,28,8,4,8,24,56,44,12,32
27,Minnesota/MN,2702100,"Southwest Minnesota PUMA, Minnesota/MN",27105,"Nobles County, Minnesota",21839,1961,16,8979,73,0.19,511,40,231,34,82,82,545,122,313,164,271,435,980,52,3,17,28,8,4,8,24,56,44,12,32
27,Minnesota/MN,2702100,"Southwest Minnesota PUMA, Minnesota/MN",27117,"Pipestone County, Minnesota",9185,220,10,2395,109,0.08,215,17,97,14,34,34,229,51,131,68,114,182,411,52,3,17,28,8,4,8,24,56,44,12,32
27,Minnesota/MN,2702100,"Southwest Minnesota PUMA, Minnesota/MN",27133,"Rock County, Minnesota",9413,166,0,1764,0,0.083,223,18,101,15,36,36,238,54,137,72,119,191,429,52,3,17,28,8,4,8,24,55,45,13,32
27,Minnesota/MN,2702100,"Southwest Minnesota PUMA, Minnesota/MN",27165,"Watonwan County, Minnesota",10973,520,4,4739,36,0.095,256,20,116,17,41,41,273,61,157,82,136,218,491,52,3,17,28,8,4,8,24,56,44,12,32
27,Minnesota/MN,2702200,"Blue Earth, Nicollet & Waseca Counties--Mankato City PUMA, Minnesota/MN",27013,"Blue Earth County, Minnesota",66322,1676,6,2527,9,0.559,607,0,104,41,78,1,648,78,105,79,104,183,831,73,5,10,13,9,0,0,13,78,22,9,13
27,Minnesota/MN,2702200,"Blue Earth, Nicollet & Waseca Counties--Mankato City PUMA, Minnesota/MN",27103,"Nicollet County, Minnesota",33783,529,16,1566,47,0.282,306,0,52,21,39,1,327,39,53,40,52,92,419,73,5,10,12,9,0,0,12,78,22,9,13
27,Minnesota/MN,2702200,"Blue Earth, Nicollet & Waseca Counties--Mankato City PUMA, Minnesota/MN",27161,"Waseca County, Minnesota",18809,614,8,3264,43,0.159,173,0,30,12,22,0,185,22,30,22,30,52,237,73,5,9,13,9,0,0,13,78,22,9,13
27,Minnesota/MN,2702300,"Rice, Goodhue & Le Sueur Counties PUMA, Minnesota/MN",27049,"Goodhue County, Minnesota",46217,360,9,779,19,0.334,640,18,100,29,34,52,669,52,152,86,118,204,873,73,3,10,14,4,2,6,11,77,23,6,17
27,Minnesota/MN,2702300,"Rice, Goodhue & Le Sueur Counties PUMA, Minnesota/MN",27079,"Le Sueur County, Minnesota",27983,460,4,1644,14,0.197,377,10,59,17,20,31,394,30,90,51,69,120,514,73,3,10,13,4,2,6,11,77,23,6,18
27,Minnesota/MN,2702300,"Rice, Goodhue & Le Sueur Counties PUMA, Minnesota/MN",27131,"Rice County, Minnesota",65765,1328,8,2019,12,0.469,899,25,141,40,47,73,939,72,214,120,166,286,1225,73,3,10,14,4,2,6,12,77,23,6,17
27,Minnesota/MN,2702400,"Mower, Steele, Freeborn & Dodge Counties PUMA, Minnesota/MN",27039,"Dodge County, Minnesota",20582,232,0,1127,0,0.162,347,102,114,24,11,70,371,113,184,81,216,297,668,52,4,12,32,2,15,10,17,56,44,17,28
27,Minnesota/MN,2702400,"Mower, Steele, Freeborn & Dodge Counties PUMA, Minnesota/MN",27047,"Freeborn County, Minnesota",30526,540,4,1769,13,0.24,515,150,168,36,16,104,551,166,272,120,318,438,989,52,4,12,32,2,15,11,17,56,44,17,28
27,Minnesota/MN,2702400,"Mower, Steele, Freeborn & Dodge Counties PUMA, Minnesota/MN",27099,"Mower County, Minnesota",39602,1322,5,3338,13,0.309,663,194,217,46,21,134,709,215,351,155,411,566,1275,52,4,12,32,2,15,11,17,56,44,17,28
27,Minnesota/MN,2702400,"Mower, Steele, Freeborn & Dodge Counties PUMA, Minnesota/MN",27147,"Steele County, Minnesota",36676,540,2,1472,5,0.29,622,182,204,43,19,126,665,201,330,145,386,531,1196,52,4,12,32,2,15,11,17,56,44,17,28
27,Minnesota/MN,2702500,"Olmsted County--Rochester City PUMA, Minnesota/MN",27109,"Olmsted County, Minnesota",153065,2388,28,1560,18,1,759,29,29,70,93,47,829,122,76,140,58,198,1027,74,7,14,6,9,3,5,3,81,19,12,7
27,Minnesota/MN,2702600,"Winona, Wabasha, Fillmore & Houston Counties--Winona City PUMA, Minnesota/MN",27045,"Fillmore County, Minnesota",20888,116,0,555,0,0.187,345,10,58,11,0,0,356,10,58,0,68,68,424,81,3,0,16,0,2,0,14,84,16,2,14
27,Minnesota/MN,2702600,"Winona, Wabasha, Fillmore & Houston Counties--Winona City PUMA, Minnesota/MN",27055,"Houston County, Minnesota",18663,125,0,670,0,0.168,310,9,52,10,0,0,320,9,52,0,61,61,381,81,3,0,16,0,2,0,14,84,16,2,14
27,Minnesota/MN,2702600,"Winona, Wabasha, Fillmore & Houston Counties--Winona City PUMA, Minnesota/MN",27157,"Wabasha County, Minnesota",21500,188,0,874,0,0.19,351,10,59,11,0,0,362,10,59,0,69,69,431,81,3,0,16,0,2,0,14,84,16,2,14
27,Minnesota/MN,2702600,"Winona, Wabasha, Fillmore & Houston Counties--Winona City PUMA, Minnesota/MN",27169,"Winona County, Minnesota",50847,870,18,1711,35,0.455,840,25,142,26,0,0,866,25,142,0,167,167,1033,81,3,0,16,0,2,0,14,84,16,2,14
28,Mississippi/MS,2800100,"North Delta Region--DeSoto County--Southaven City PUMA, Mississippi/MS",28033,"DeSoto County, Mississippi",176132,5565,59,3160,33,1,325,0,43,29,0,0,354,0,43,0,43,43,397,82,7,0,11,0,0,0,11,89,11,0,11
28,Mississippi/MS,2800200,"Northeast Region--Marshall, Alcorn, Prentiss, Tippah, Tishomingo & Benton Counties PUMA, Mississippi/MS",28003,"Alcorn County, Mississippi",37180,803,11,2160,30,0.252,139,6,1,2,0,0,141,6,1,0,7,7,148,94,1,0,5,0,4,0,1,95,5,4,1
28,Mississippi/MS,2800200,"Northeast Region--Marshall, Alcorn, Prentiss, Tippah, Tishomingo & Benton Counties PUMA, Mississippi/MS",28009,"Benton County, Mississippi",8253,226,3,2738,36,0.056,31,1,0,0,0,0,31,1,0,0,1,1,32,97,0,0,3,0,3,0,0,97,3,3,0
28,Mississippi/MS,2800200,"Northeast Region--Marshall, Alcorn, Prentiss, Tippah, Tishomingo & Benton Counties PUMA, Mississippi/MS",28093,"Marshall County, Mississippi",35787,1095,17,3060,48,0.241,133,6,1,2,0,0,135,6,1,0,7,7,142,94,1,0,5,0,4,0,1,95,5,4,1
28,Mississippi/MS,2800200,"Northeast Region--Marshall, Alcorn, Prentiss, Tippah, Tishomingo & Benton Counties PUMA, Mississippi/MS",28117,"Prentiss County, Mississippi",25360,855,17,3371,67,0.17,94,4,1,1,0,0,95,4,1,0,5,5,100,94,1,0,5,0,4,0,1,95,5,4,1
28,Mississippi/MS,2800200,"Northeast Region--Marshall, Alcorn, Prentiss, Tippah, Tishomingo & Benton Counties PUMA, Mississippi/MS",28139,"Tippah County, Mississippi",21990,669,17,3042,77,0.15,82,3,1,1,0,0,83,3,1,0,4,4,87,94,1,0,5,0,3,0,1,95,5,3,1
28,Mississippi/MS,2800200,"Northeast Region--Marshall, Alcorn, Prentiss, Tippah, Tishomingo & Benton Counties PUMA, Mississippi/MS",28141,"Tishomingo County, Mississippi",19478,682,38,3501,195,0.131,72,3,1,1,0,0,73,3,1,0,4,4,77,94,1,0,5,0,4,0,1,95,5,4,1
28,Mississippi/MS,2800300,"North Delta Region--Panola, Tate, Coahoma, Tallahatchie, Tunica & Quitman Counties PUMA, Mississippi/MS",28027,"Coahoma County, Mississippi",23802,1155,28,4853,118,0.202,221,0,5,0,2,0,221,2,5,2,5,7,228,97,0,1,2,1,0,0,2,97,3,1,2
28,Mississippi/MS,2800300,"North Delta Region--Panola, Tate, Coahoma, Tallahatchie, Tunica & Quitman Counties PUMA, Mississippi/MS",28107,"Panola County, Mississippi",34243,1471,29,4296,85,0.289,316,0,7,0,3,0,316,3,7,3,7,10,326,97,0,1,2,1,0,0,2,97,3,1,2
28,Mississippi/MS,2800300,"North Delta Region--Panola, Tate, Coahoma, Tallahatchie, Tunica & Quitman Counties PUMA, Mississippi/MS",28119,"Quitman County, Mississippi",7372,373,5,5060,68,0.062,68,0,2,0,1,0,68,1,2,1,2,3,71,96,0,1,3,1,0,0,3,96,4,1,3
28,Mississippi/MS,2800300,"North Delta Region--Panola, Tate, Coahoma, Tallahatchie, Tunica & Quitman Counties PUMA, Mississippi/MS",28135,"Tallahatchie County, Mississippi",14361,770,21,5362,146,0.122,134,0,3,0,1,0,134,1,3,1,3,4,138,97,0,1,2,1,0,0,2,97,3,1,2
28,Mississippi/MS,2800300,"North Delta Region--Panola, Tate, Coahoma, Tallahatchie, Tunica & Quitman Counties PUMA, Mississippi/MS",28137,"Tate County, Mississippi",28493,987,37,3464,130,0.239,262,0,6,0,2,0,262,2,6,2,6,8,270,97,0,1,2,1,0,0,2,97,3,1,2
28,Mississippi/MS,2800300,"North Delta Region--Panola, Tate, Coahoma, Tallahatchie, Tunica & Quitman Counties PUMA, Mississippi/MS",28143,"Tunica County, Mississippi",10170,486,15,4779,147,0.087,95,0,2,0,1,0,95,1,2,1,2,3,98,97,0,1,2,1,0,0,2,97,3,1,2
28,Mississippi/MS,2800400,"Three Rivers Region--Lafayette, Monroe, Itawamba, Chickasaw & Calhoun Counties PUMA, Mississippi/MS",28013,"Calhoun County, Mississippi",14571,515,12,3534,82,0.101,64,3,6,0,0,0,64,3,6,0,9,9,73,88,0,0,12,0,4,0,8,88,12,4,8
28,Mississippi/MS,2800400,"Three Rivers Region--Lafayette, Monroe, Itawamba, Chickasaw & Calhoun Counties PUMA, Mississippi/MS",28017,"Chickasaw County, Mississippi",17279,679,24,3930,139,0.119,75,4,7,0,0,0,75,4,7,0,11,11,86,87,0,0,13,0,5,0,8,87,13,5,8
28,Mississippi/MS,2800400,"Three Rivers Region--Lafayette, Monroe, Itawamba, Chickasaw & Calhoun Counties PUMA, Mississippi/MS",28057,"Itawamba County, Mississippi",23480,815,21,3471,89,0.162,103,5,10,0,0,0,103,5,10,0,15,15,118,87,0,0,13,0,4,0,8,87,13,4,8
28,Mississippi/MS,2800400,"Three Rivers Region--Lafayette, Monroe, Itawamba, Chickasaw & Calhoun Counties PUMA, Mississippi/MS",28071,"Lafayette County, Mississippi",53459,2173,39,4065,73,0.371,235,12,23,0,1,0,235,13,23,1,35,36,271,87,0,0,13,0,4,0,8,87,13,5,8
28,Mississippi/MS,2800400,"Three Rivers Region--Lafayette, Monroe, Itawamba, Chickasaw & Calhoun Counties PUMA, Mississippi/MS",28095,"Monroe County, Mississippi",35840,1228,68,3426,190,0.247,157,8,16,0,1,0,157,9,16,1,24,25,182,86,0,1,13,1,4,0,9,86,14,5,9
28,Mississippi/MS,2800500,"Three Rivers Region--Lee, Pontotoc & Union Counties--Tupelo City PUMA, Mississippi/MS",28081,"Lee County, Mississippi",84915,2714,68,3196,80,0.588,146,0,32,35,0,0,181,0,32,0,32,32,213,69,16,0,15,0,0,0,15,85,15,0,15
28,Mississippi/MS,2800500,"Three Rivers Region--Lee, Pontotoc & Union Counties--Tupelo City PUMA, Mississippi/MS",28115,"Pontotoc County, Mississippi",31315,1266,16,4043,51,0.217,54,0,12,13,0,0,67,0,12,0,12,12,79,68,16,0,15,0,0,0,15,85,15,0,15
28,Mississippi/MS,2800500,"Three Rivers Region--Lee, Pontotoc & Union Counties--Tupelo City PUMA, Mississippi/MS",28145,"Union County, Mississippi",28356,997,24,3516,85,0.195,49,0,11,12,0,0,61,0,11,0,11,11,72,68,17,0,15,0,0,0,15,85,15,0,15
28,Mississippi/MS,2800600,"Golden Triangle Region--Starkville, Columbus & West Point Cities PUMA, Mississippi/MS",28019,"Choctaw County, Mississippi",8321,185,6,2223,72,0.047,46,0,0,0,0,0,46,0,0,0,0,0,46,100,0,0,0,0,0,0,0,100,0,0,0
28,Mississippi/MS,2800600,"Golden Triangle Region--Starkville, Columbus & West Point Cities PUMA, Mississippi/MS",28025,"Clay County, Mississippi",19808,592,18,2989,91,0.112,109,0,0,0,0,0,109,0,0,0,0,0,109,100,0,0,0,0,0,0,0,100,0,0,0
28,Mississippi/MS,2800600,"Golden Triangle Region--Starkville, Columbus & West Point Cities PUMA, Mississippi/MS",28087,"Lowndes County, Mississippi",59437,1569,58,2640,98,0.338,329,0,0,1,0,0,330,0,0,0,0,0,330,100,0,0,0,0,0,0,0,100,0,0,0
28,Mississippi/MS,2800600,"Golden Triangle Region--Starkville, Columbus & West Point Cities PUMA, Mississippi/MS",28103,"Noxubee County, Mississippi",10828,548,16,5061,148,0.063,61,0,0,0,0,0,61,0,0,0,0,0,61,100,0,0,0,0,0,0,0,100,0,0,0
28,Mississippi/MS,2800600,"Golden Triangle Region--Starkville, Columbus & West Point Cities PUMA, Mississippi/MS",28105,"Oktibbeha County, Mississippi",49481,1778,50,3593,101,0.282,275,0,0,1,0,0,276,0,0,0,0,0,276,100,0,0,0,0,0,0,0,100,0,0,0
28,Mississippi/MS,2800600,"Golden Triangle Region--Starkville, Columbus & West Point Cities PUMA, Mississippi/MS",28155,"Webster County, Mississippi",9828,338,13,3439,132,0.055,54,0,0,0,0,0,54,0,0,0,0,0,54,100,0,0,0,0,0,0,0,100,0,0,0
28,Mississippi/MS,2800600,"Golden Triangle Region--Starkville, Columbus & West Point Cities PUMA, Mississippi/MS",28159,"Winston County, Mississippi",18358,738,19,4020,103,0.103,100,0,0,0,0,0,100,0,0,0,0,0,100,100,0,0,0,0,0,0,0,100,0,0,0
28,Mississippi/MS,2800700,"North Central Region PUMA, Mississippi/MS",28007,"Attala County, Mississippi",18581,659,25,3547,135,0.157,164,0,14,0,0,0,164,0,14,0,14,14,178,92,0,0,8,0,0,0,8,92,8,0,8
28,Mississippi/MS,2800700,"North Central Region PUMA, Mississippi/MS",28015,"Carroll County, Mississippi",10129,316,12,3120,118,0.085,89,0,8,0,0,0,89,0,8,0,8,8,97,92,0,0,8,0,0,0,8,92,8,0,8
28,Mississippi/MS,2800700,"North Central Region PUMA, Mississippi/MS",28043,"Grenada County, Mississippi",21278,1083,36,5090,169,0.176,184,0,16,0,0,0,184,0,16,0,16,16,200,92,0,0,8,0,0,0,8,92,8,0,8
28,Mississippi/MS,2800700,"North Central Region PUMA, Mississippi/MS",28051,"Holmes County, Mississippi",18075,1096,59,6064,326,0.149,156,0,13,0,0,0,156,0,13,0,13,13,169,92,0,0,8,0,0,0,8,92,8,0,8
28,Mississippi/MS,2800700,"North Central Region PUMA, Mississippi/MS",28083,"Leflore County, Mississippi",29804,1404,81,4711,272,0.247,258,0,22,0,0,0,258,0,22,0,22,22,280,92,0,0,8,0,0,0,8,92,8,0,8
28,Mississippi/MS,2800700,"North Central Region PUMA, Mississippi/MS",28097,"Montgomery County, Mississippi",10198,461,20,4520,196,0.084,88,0,7,0,0,0,88,0,7,0,7,7,95,93,0,0,7,0,0,0,7,93,7,0,7
28,Mississippi/MS,2800700,"North Central Region PUMA, Mississippi/MS",28161,"Yalobusha County, Mississippi",12421,433,14,3486,113,0.103,108,0,9,0,0,0,108,0,9,0,9,9,117,92,0,0,8,0,0,0,8,92,8,0,8
28,Mississippi/MS,2800800,"South Delta Region PUMA, Mississippi/MS",28011,"Bolivar County, Mississippi",32592,1840,66,5646,203,0.271,316,0,9,11,0,0,327,0,9,0,9,9,336,94,3,0,3,0,0,0,3,97,3,0,3
28,Mississippi/MS,2800800,"South Delta Region PUMA, Mississippi/MS",28053,"Humphreys County, Mississippi",8539,377,15,4415,176,0.071,83,0,2,3,0,0,86,0,2,0,2,2,88,94,3,0,2,0,0,0,2,98,2,0,2
28,Mississippi/MS,2800800,"South Delta Region PUMA, Mississippi/MS",28055,"Issaquena County, Mississippi",1328,104,3,7831,226,0.011,13,0,0,0,0,0,13,0,0,0,0,0,13,100,0,0,0,0,0,0,0,100,0,0,0
28,Mississippi/MS,2800800,"South Delta Region PUMA, Mississippi/MS",28125,"Sharkey County, Mississippi",4511,266,13,5897,288,0.038,44,0,1,2,0,0,46,0,1,0,1,1,47,94,4,0,2,0,0,0,2,98,2,0,2
28,Mississippi/MS,2800800,"South Delta Region PUMA, Mississippi/MS",28133,"Sunflower County, Mississippi",26532,1465,46,5522,173,0.219,255,0,7,9,0,0,264,0,7,0,7,7,271,94,3,0,3,0,0,0,3,97,3,0,3
28,Mississippi/MS,2800800,"South Delta Region PUMA, Mississippi/MS",28151,"Washington County, Mississippi",47086,2238,72,4753,153,0.391,456,0,13,16,0,0,472,0,13,0,13,13,485,94,3,0,3,0,0,0,3,97,3,0,3
28,Mississippi/MS,2800900,"Central Region--Madison & Yazoo Counties PUMA, Mississippi/MS",28089,"Madison County, Mississippi",103498,3297,88,3186,85,0.75,532,0,52,0,0,0,532,0,52,0,52,52,584,91,0,0,9,0,0,0,9,91,9,0,9
28,Mississippi/MS,2800900,"Central Region--Madison & Yazoo Counties PUMA, Mississippi/MS",28163,"Yazoo County, Mississippi",27974,1059,30,3786,107,0.25,177,0,17,0,0,0,177,0,17,0,17,17,194,91,0,0,9,0,0,0,9,91,9,0,9
28,Mississippi/MS,2801000,"Central Region--Jackson (West & South) & Clinton (South & East) Cities PUMA, Mississippi/MS",28049,"Hinds County, Mississippi",241774,7110,159,2941,66,0.791,143,0,0,4,0,0,147,0,0,0,0,0,147,97,3,0,0,0,0,0,0,100,0,0,0
28,Mississippi/MS,2801000,"Central Region--Jackson (West & South) & Clinton (South & East) Cities PUMA, Mississippi/MS",28089,"Madison County, Mississippi",103498,3297,88,3186,85,0.209,38,0,0,1,0,0,39,0,0,0,0,0,39,97,3,0,0,0,0,0,0,100,0,0,0
28,Mississippi/MS,2801100,"Central Region--Jackson City (East & Central) PUMA, Mississippi/MS",28049,"Hinds County, Mississippi",241774,7110,159,2941,66,1,405,0,0,0,0,0,405,0,0,0,0,0,405,100,0,0,0,0,0,0,0,100,0,0,0
28,Mississippi/MS,2801200,"Central Region--Hinds (West), Warren & Copiah Counties--Vicksburg City PUMA, Mississippi/MS",28029,"Copiah County, Mississippi",28721,1184,33,4122,115,0.279,193,0,0,7,0,0,200,0,0,0,0,0,200,96,4,0,0,0,0,0,0,100,0,0,0
28,Mississippi/MS,2801200,"Central Region--Hinds (West), Warren & Copiah Counties--Vicksburg City PUMA, Mississippi/MS",28049,"Hinds County, Mississippi",241774,7110,159,2941,66,0.26,180,0,0,7,0,0,187,0,0,0,0,0,187,96,4,0,0,0,0,0,0,100,0,0,0
28,Mississippi/MS,2801200,"Central Region--Hinds (West), Warren & Copiah Counties--Vicksburg City PUMA, Mississippi/MS",28149,"Warren County, Mississippi",47075,1405,50,2985,106,0.461,319,0,0,12,0,0,331,0,0,0,0,0,331,96,4,0,0,0,0,0,0,100,0,0,0
28,Mississippi/MS,2801300,"Central Region--Rankin & Simpson Counties PUMA, Mississippi/MS",28121,"Rankin County, Mississippi",151240,3293,77,2177,51,0.848,639,0,0,0,5,0,639,5,0,5,0,5,644,99,0,1,0,1,0,0,0,99,1,1,0
28,Mississippi/MS,2801300,"Central Region--Rankin & Simpson Counties PUMA, Mississippi/MS",28127,"Simpson County, Mississippi",27073,1033,46,3816,170,0.152,114,0,0,0,1,0,114,1,0,1,0,1,115,99,0,1,0,1,0,0,0,99,1,1,0
28,Mississippi/MS,2801400,"East Central Region--Neshoba, Scott, Leake, Jasper, Smith & Kemper Counties PUMA, Mississippi/MS",28061,"Jasper County, Mississippi",16529,573,15,3467,91,0.135,425,14,54,7,0,0,432,14,54,0,68,68,500,85,1,0,14,0,3,0,11,86,14,3,11
28,Mississippi/MS,2801400,"East Central Region--Neshoba, Scott, Leake, Jasper, Smith & Kemper Counties PUMA, Mississippi/MS",28069,"Kemper County, Mississippi",10107,289,15,2859,148,0.081,255,8,32,4,0,0,259,8,32,0,40,40,299,85,1,0,13,0,3,0,11,87,13,3,11
28,Mississippi/MS,2801400,"East Central Region--Neshoba, Scott, Leake, Jasper, Smith & Kemper Counties PUMA, Mississippi/MS",28079,"Leake County, Mississippi",22870,953,38,4167,166,0.184,579,19,73,10,0,0,589,19,73,0,92,92,681,85,1,0,14,0,3,0,11,86,14,3,11
28,Mississippi/MS,2801400,"East Central Region--Neshoba, Scott, Leake, Jasper, Smith & Kemper Counties PUMA, Mississippi/MS",28099,"Neshoba County, Mississippi",29376,1566,104,5331,354,0.24,755,24,95,12,0,0,767,24,95,0,119,119,886,85,1,0,13,0,3,0,11,87,13,3,11
28,Mississippi/MS,2801400,"East Central Region--Neshoba, Scott, Leake, Jasper, Smith & Kemper Counties PUMA, Mississippi/MS",28123,"Scott County, Mississippi",28415,1174,27,4132,95,0.23,724,23,91,12,0,0,736,23,91,0,114,114,850,85,1,0,13,0,3,0,11,87,13,3,11
28,Mississippi/MS,2801400,"East Central Region--Neshoba, Scott, Leake, Jasper, Smith & Kemper Counties PUMA, Mississippi/MS",28129,"Smith County, Mississippi",16063,532,15,3312,93,0.13,409,13,52,7,0,0,416,13,52,0,65,65,481,85,1,0,14,0,3,0,11,86,14,3,11
28,Mississippi/MS,2801500,"East Central Region--Lauderdale, Newton & Clarke Counties--Meridian City PUMA, Mississippi/MS",28023,"Clarke County, Mississippi",15928,587,46,3685,289,0.138,105,0,1,0,0,0,105,0,1,0,1,1,106,99,0,0,1,0,0,0,1,99,1,0,1
28,Mississippi/MS,2801500,"East Central Region--Lauderdale, Newton & Clarke Counties--Meridian City PUMA, Mississippi/MS",28075,"Lauderdale County, Mississippi",77323,2049,125,2650,162,0.675,512,0,7,0,0,0,512,0,7,0,7,7,519,99,0,0,1,0,0,0,1,99,1,0,1
28,Mississippi/MS,2801500,"East Central Region--Lauderdale, Newton & Clarke Counties--Meridian City PUMA, Mississippi/MS",28101,"Newton County, Mississippi",21524,770,24,3577,112,0.187,142,0,2,0,0,0,142,0,2,0,2,2,144,99,0,0,1,0,0,0,1,99,1,0,1
28,Mississippi/MS,2801600,"Southwest Region PUMA, Mississippi/MS",28001,"Adams County, Mississippi",31547,938,37,2973,117,0.175,227,0,0,0,0,0,227,0,0,0,0,0,227,100,0,0,0,0,0,0,0,100,0,0,0
28,Mississippi/MS,2801600,"Southwest Region PUMA, Mississippi/MS",28005,"Amite County, Mississippi",12468,329,10,2639,80,0.07,91,0,0,0,0,0,91,0,0,0,0,0,91,100,0,0,0,0,0,0,0,100,0,0,0
28,Mississippi/MS,2801600,"Southwest Region PUMA, Mississippi/MS",28021,"Claiborne County, Mississippi",9120,463,16,5077,175,0.051,66,0,0,0,0,0,66,0,0,0,0,0,66,100,0,0,0,0,0,0,0,100,0,0,0
28,Mississippi/MS,2801600,"Southwest Region PUMA, Mississippi/MS",28037,"Franklin County, Mississippi",7757,192,3,2475,39,0.044,57,0,0,0,0,0,57,0,0,0,0,0,57,100,0,0,0,0,0,0,0,100,0,0,0
28,Mississippi/MS,2801600,"Southwest Region PUMA, Mississippi/MS",28063,"Jefferson County, Mississippi",7346,243,9,3308,123,0.041,53,0,0,0,0,0,53,0,0,0,0,0,53,100,0,0,0,0,0,0,0,100,0,0,0
28,Mississippi/MS,2801600,"Southwest Region PUMA, Mississippi/MS",28077,"Lawrence County, Mississippi",12630,433,13,3428,103,0.071,92,0,0,0,0,0,92,0,0,0,0,0,92,100,0,0,0,0,0,0,0,100,0,0,0
28,Mississippi/MS,2801600,"Southwest Region PUMA, Mississippi/MS",28085,"Lincoln County, Mississippi",34432,1090,53,3166,154,0.193,250,0,0,0,0,0,250,0,0,0,0,0,250,100,0,0,0,0,0,0,0,100,0,0,0
28,Mississippi/MS,2801600,"Southwest Region PUMA, Mississippi/MS",28113,"Pike County, Mississippi",39737,1234,51,3105,128,0.222,287,0,0,0,0,0,287,0,0,0,0,0,287,100,0,0,0,0,0,0,0,100,0,0,0
28,Mississippi/MS,2801600,"Southwest Region PUMA, Mississippi/MS",28147,"Walthall County, Mississippi",14601,600,26,4109,178,0.082,106,0,0,0,0,0,106,0,0,0,0,0,106,100,0,0,0,0,0,0,0,100,0,0,0
28,Mississippi/MS,2801600,"Southwest Region PUMA, Mississippi/MS",28157,"Wilkinson County, Mississippi",8990,305,18,3393,200,0.051,66,0,0,0,0,0,66,0,0,0,0,0,66,100,0,0,0,0,0,0,0,100,0,0,0
28,Mississippi/MS,2801700,"South Region--Jones, Wayne, Covington, Greene & Jefferson Davis Counties PUMA, Mississippi/MS",28031,"Covington County, Mississippi",19091,820,22,4295,115,0.147,193,5,21,4,0,0,197,5,21,0,26,26,223,87,2,0,12,0,2,0,9,88,12,2,9
28,Mississippi/MS,2801700,"South Region--Jones, Wayne, Covington, Greene & Jefferson Davis Counties PUMA, Mississippi/MS",28041,"Greene County, Mississippi",13714,375,17,2734,124,0.101,133,4,14,2,0,0,135,4,14,0,18,18,153,87,1,0,12,0,3,0,9,88,12,3,9
28,Mississippi/MS,2801700,"South Region--Jones, Wayne, Covington, Greene & Jefferson Davis Counties PUMA, Mississippi/MS",28065,"Jefferson Davis County, Mississippi",11495,341,11,2967,96,0.086,113,3,12,2,0,0,115,3,12,0,15,15,130,87,2,0,12,0,2,0,9,88,12,2,9
28,Mississippi/MS,2801700,"South Region--Jones, Wayne, Covington, Greene & Jefferson Davis Counties PUMA, Mississippi/MS",28067,"Jones County, Mississippi",68454,2475,79,3616,115,0.512,672,19,72,12,0,0,684,19,72,0,91,91,775,87,2,0,12,0,2,0,9,88,12,2,9
28,Mississippi/MS,2801700,"South Region--Jones, Wayne, Covington, Greene & Jefferson Davis Counties PUMA, Mississippi/MS",28153,"Wayne County, Mississippi",20422,900,21,4407,103,0.154,202,6,22,4,0,0,206,6,22,0,28,28,234,86,2,0,12,0,3,0,9,88,12,3,9
28,Mississippi/MS,2801800,"South Region--Forrest, Lamar, Marion & Perry Counties--Hattiesburg City PUMA, Mississippi/MS",28035,"Forrest County, Mississippi",75517,2478,72,3281,95,0.436,593,0,17,6,0,0,599,0,17,0,17,17,616,96,1,0,3,0,0,0,3,97,3,0,3
28,Mississippi/MS,2801800,"South Region--Forrest, Lamar, Marion & Perry Counties--Hattiesburg City PUMA, Mississippi/MS",28073,"Lamar County, Mississippi",61223,1700,35,2777,57,0.349,475,0,13,5,0,0,480,0,13,0,13,13,493,96,1,0,3,0,0,0,3,97,3,0,3
28,Mississippi/MS,2801800,"South Region--Forrest, Lamar, Marion & Perry Counties--Hattiesburg City PUMA, Mississippi/MS",28091,"Marion County, Mississippi",25202,859,35,3408,139,0.145,197,0,6,2,0,0,199,0,6,0,6,6,205,96,1,0,3,0,0,0,3,97,3,0,3
28,Mississippi/MS,2801800,"South Region--Forrest, Lamar, Marion & Perry Counties--Hattiesburg City PUMA, Mississippi/MS",28111,"Perry County, Mississippi",12028,423,19,3517,158,0.07,95,0,3,1,0,0,96,0,3,0,3,3,99,96,1,0,3,0,0,0,3,97,3,0,3
28,Mississippi/MS,2801900,"South Region--Pearl River, Hancock, George & Stone Counties PUMA, Mississippi/MS",28039,"George County, Mississippi",23710,771,13,3252,55,0.165,44,0,0,11,0,0,55,0,0,0,0,0,55,80,20,0,0,0,0,0,0,100,0,0,0
28,Mississippi/MS,2801900,"South Region--Pearl River, Hancock, George & Stone Counties PUMA, Mississippi/MS",28045,"Hancock County, Mississippi",46653,582,22,1248,47,0.325,87,0,0,21,0,0,108,0,0,0,0,0,108,81,19,0,0,0,0,0,0,100,0,0,0
28,Mississippi/MS,2801900,"South Region--Pearl River, Hancock, George & Stone Counties PUMA, Mississippi/MS",28109,"Pearl River County, Mississippi",55149,883,53,1601,96,0.385,104,0,0,25,0,0,129,0,0,0,0,0,129,81,19,0,0,0,0,0,0,100,0,0,0
28,Mississippi/MS,2801900,"South Region--Pearl River, Hancock, George & Stone Counties PUMA, Mississippi/MS",28131,"Stone County, Mississippi",18375,371,12,2019,65,0.125,34,0,0,8,0,0,42,0,0,0,0,0,42,81,19,0,0,0,0,0,0,100,0,0,0
28,Mississippi/MS,2802000,"South Region--Harrison County--Gulfport & Biloxi Cities PUMA, Mississippi/MS",28047,"Harrison County, Mississippi",202626,3853,74,1902,37,1,251,0,0,22,0,20,273,0,20,20,0,20,293,86,8,7,0,0,0,7,0,93,7,0,7
28,Mississippi/MS,2802100,"South Region--Jackson County PUMA, Mississippi/MS",28059,"Jackson County, Mississippi",142014,3486,70,2455,49,1,30,0,0,0,0,0,30,0,0,0,0,0,30,100,0,0,0,0,0,0,0,100,0,0,0
29,Missouri/MO,2900100,"Northwest Missouri PUMA, Missouri/MO",29005,"Atchison County, Missouri",5270,51,0,968,0,0.048,109,5,6,5,5,0,114,10,6,5,11,16,130,84,4,4,8,4,4,0,5,88,12,8,5
29,Missouri/MO,2900100,"Northwest Missouri PUMA, Missouri/MO",29061,"Daviess County, Missouri",8302,112,1,1349,12,0.074,168,8,10,8,7,1,176,15,11,8,18,26,202,83,4,4,9,3,4,0,5,87,13,7,5
29,Missouri/MO,2900100,"Northwest Missouri PUMA, Missouri/MO",29075,"Gentry County, Missouri",6665,118,9,1770,135,0.06,136,7,8,7,6,0,143,13,8,6,15,21,164,83,4,4,9,4,4,0,5,87,13,8,5
29,Missouri/MO,2900100,"Northwest Missouri PUMA, Missouri/MO",29079,"Grundy County, Missouri",10039,183,3,1823,30,0.092,209,10,12,10,9,1,219,19,13,10,22,32,251,83,4,4,9,4,4,0,5,87,13,8,5
29,Missouri/MO,2900100,"Northwest Missouri PUMA, Missouri/MO",29081,"Harrison County, Missouri",8554,107,1,1251,12,0.078,177,9,10,9,8,1,186,17,11,9,19,28,214,83,4,4,9,4,4,0,5,87,13,8,5
29,Missouri/MO,2900100,"Northwest Missouri PUMA, Missouri/MO",29087,"Holt County, Missouri",4456,75,1,1683,22,0.04,91,5,5,5,4,0,96,9,5,4,10,14,110,83,5,4,9,4,5,0,5,87,13,8,5
29,Missouri/MO,2900100,"Northwest Missouri PUMA, Missouri/MO",29115,"Linn County, Missouri",12186,84,1,689,8,0.11,250,13,15,12,11,1,262,24,16,12,28,40,302,83,4,4,9,4,4,0,5,87,13,8,5
29,Missouri/MO,2900100,"Northwest Missouri PUMA, Missouri/MO",29117,"Livingston County, Missouri",15076,396,1,2627,7,0.138,314,16,18,16,14,1,330,30,19,15,34,49,379,83,4,4,9,4,4,0,5,87,13,8,5
29,Missouri/MO,2900100,"Northwest Missouri PUMA, Missouri/MO",29129,"Mercer County, Missouri",3664,28,0,764,0,0.034,77,4,5,4,3,0,81,7,5,3,9,12,93,83,4,3,10,3,4,0,5,87,13,8,5
29,Missouri/MO,2900100,"Northwest Missouri PUMA, Missouri/MO",29147,"Nodaway County, Missouri",22547,632,6,2803,27,0.206,468,23,27,23,21,1,491,44,28,22,50,72,563,83,4,4,9,4,4,0,5,87,13,8,5
29,Missouri/MO,2900100,"Northwest Missouri PUMA, Missouri/MO",29171,"Putnam County, Missouri",4815,33,1,685,21,0.044,100,5,6,5,4,0,105,9,6,4,11,15,120,83,4,3,9,3,4,0,5,88,12,8,5
29,Missouri/MO,2900100,"Northwest Missouri PUMA, Missouri/MO",29211,"Sullivan County, Missouri",6317,190,0,3008,0,0.057,130,6,8,6,6,0,136,12,8,6,14,20,156,83,4,4,9,4,4,0,5,87,13,8,5
29,Missouri/MO,2900100,"Northwest Missouri PUMA, Missouri/MO",29227,"Worth County, Missouri",2040,20,0,980,0,0.018,41,2,2,2,2,0,43,4,2,2,4,6,49,84,4,4,8,4,4,0,4,88,12,8,4
29,Missouri/MO,2900200,"Buchanan, Andrew & DeKalb Counties PUMA, Missouri/MO",29003,"Andrew County, Missouri",17403,244,2,1402,11,0.146,256,25,121,12,9,66,268,34,187,75,146,221,489,52,2,15,30,2,5,13,25,55,45,7,38
29,Missouri/MO,2900200,"Buchanan, Andrew & DeKalb Counties PUMA, Missouri/MO",29021,"Buchanan County, Missouri",89076,1919,16,2154,18,0.748,1312,130,618,64,48,337,1376,178,955,385,748,1133,2509,52,3,15,30,2,5,13,25,55,45,7,38
29,Missouri/MO,2900200,"Buchanan, Andrew & DeKalb Counties PUMA, Missouri/MO",29063,"DeKalb County, Missouri",12564,131,2,1043,16,0.106,186,18,88,9,7,48,195,25,136,55,106,161,356,52,3,15,30,2,5,13,25,55,45,7,38
29,Missouri/MO,2900300,"Northeast Missouri PUMA, Missouri/MO",29001,"Adair County, Missouri",25325,350,0,1382,0,0.204,559,1,10,11,0,22,570,1,32,22,11,33,603,93,2,4,2,0,0,4,2,95,5,0,5
29,Missouri/MO,2900300,"Northeast Missouri PUMA, Missouri/MO",29045,"Clark County, Missouri",6800,64,0,941,0,0.054,148,0,3,3,0,6,151,0,9,6,3,9,160,92,2,4,2,0,0,4,2,94,6,0,6
29,Missouri/MO,2900300,"Northeast Missouri PUMA, Missouri/MO",29103,"Knox County, Missouri",3951,50,1,1266,25,0.032,88,0,2,2,0,3,90,0,5,3,2,5,95,93,2,3,2,0,0,3,2,95,5,0,5
29,Missouri/MO,2900300,"Northeast Missouri PUMA, Missouri/MO",29111,"Lewis County, Missouri",10027,87,2,868,20,0.081,222,0,4,4,0,9,226,0,13,9,4,13,239,93,2,4,2,0,0,4,2,95,5,0,5
29,Missouri/MO,2900300,"Northeast Missouri PUMA, Missouri/MO",29121,"Macon County, Missouri",15254,150,0,983,0,0.122,334,1,6,6,0,13,340,1,19,13,7,20,360,93,2,4,2,0,0,4,2,94,6,0,5
29,Missouri/MO,2900300,"Northeast Missouri PUMA, Missouri/MO",29127,"Marion County, Missouri",28672,651,14,2271,49,0.232,636,1,11,12,0,25,648,1,36,25,12,37,685,93,2,4,2,0,0,4,2,95,5,0,5
29,Missouri/MO,2900300,"Northeast Missouri PUMA, Missouri/MO",29137,"Monroe County, Missouri",8654,89,1,1028,12,0.069,189,0,3,4,0,7,193,0,10,7,3,10,203,93,2,3,1,0,0,3,1,95,5,0,5
29,Missouri/MO,2900300,"Northeast Missouri PUMA, Missouri/MO",29173,"Ralls County, Missouri",10217,148,0,1449,0,0.082,225,0,4,4,0,9,229,0,13,9,4,13,242,93,2,4,2,0,0,4,2,95,5,0,5
29,Missouri/MO,2900300,"Northeast Missouri PUMA, Missouri/MO",29197,"Schuyler County, Missouri",4502,22,0,489,0,0.035,96,0,2,2,0,4,98,0,6,4,2,6,104,92,2,4,2,0,0,4,2,94,6,0,6
29,Missouri/MO,2900300,"Northeast Missouri PUMA, Missouri/MO",29199,"Scotland County, Missouri",4898,31,1,633,20,0.04,110,0,2,2,0,4,112,0,6,4,2,6,118,93,2,3,2,0,0,3,2,95,5,0,5
29,Missouri/MO,2900300,"Northeast Missouri PUMA, Missouri/MO",29205,"Shelby County, Missouri",6061,67,1,1105,16,0.049,134,0,2,3,0,5,137,0,7,5,2,7,144,93,2,3,1,0,0,3,1,95,5,0,5
29,Missouri/MO,2900400,"Lincoln, Warren, Audrain, Pike & Montgomery Counties PUMA, Missouri/MO",29007,"Audrain County, Missouri",25735,420,2,1632,8,0.179,265,0,8,31,15,0,296,15,8,15,8,23,319,83,10,5,3,5,0,0,3,93,7,5,3
29,Missouri/MO,2900400,"Lincoln, Warren, Audrain, Pike & Montgomery Counties PUMA, Missouri/MO",29113,"Lincoln County, Missouri",55563,748,3,1346,5,0.381,564,0,16,67,32,0,631,32,16,32,16,48,679,83,10,5,2,5,0,0,2,93,7,5,2
29,Missouri/MO,2900400,"Lincoln, Warren, Audrain, Pike & Montgomery Counties PUMA, Missouri/MO",29139,"Montgomery County, Missouri",11545,83,1,719,9,0.08,118,0,3,14,7,0,132,7,3,7,3,10,142,83,10,5,2,5,0,0,2,93,7,5,2
29,Missouri/MO,2900400,"Lincoln, Warren, Audrain, Pike & Montgomery Counties PUMA, Missouri/MO",29163,"Pike County, Missouri",18489,239,4,1293,22,0.127,188,0,5,22,11,0,210,11,5,11,5,16,226,83,10,5,2,5,0,0,2,93,7,5,2
29,Missouri/MO,2900400,"Lincoln, Warren, Audrain, Pike & Montgomery Counties PUMA, Missouri/MO",29219,"Warren County, Missouri",33908,494,1,1457,3,0.233,345,0,10,41,20,0,386,20,10,20,10,30,416,83,10,5,2,5,0,0,2,93,7,5,2
29,Missouri/MO,2900500,"Cole, Callaway, Moniteau & Osage Counties PUMA, Missouri/MO",29027,"Callaway County, Missouri",44840,638,2,1423,4,0.298,307,0,0,41,5,0,348,5,0,5,0,5,353,87,12,1,0,1,0,0,0,99,1,1,0
29,Missouri/MO,2900500,"Cole, Callaway, Moniteau & Osage Counties PUMA, Missouri/MO",29051,"Cole County, Missouri",76740,1509,14,1966,18,0.506,521,0,0,70,9,0,591,9,0,9,0,9,600,87,12,2,0,2,0,0,0,98,2,2,0
29,Missouri/MO,2900500,"Cole, Callaway, Moniteau & Osage Counties PUMA, Missouri/MO",29135,"Moniteau County, Missouri",15958,307,4,1924,25,0.106,109,0,0,15,2,0,124,2,0,2,0,2,126,87,12,2,0,2,0,0,0,98,2,2,0
29,Missouri/MO,2900500,"Cole, Callaway, Moniteau & Osage Counties PUMA, Missouri/MO",29151,"Osage County, Missouri",13619,150,2,1101,15,0.09,93,0,0,13,2,0,106,2,0,2,0,2,108,86,12,2,0,2,0,0,0,98,2,2,0
29,Missouri/MO,2900600,"Boone County PUMA, Missouri/MO",29019,"Boone County, Missouri",176515,4628,9,2622,5,1,646,0,85,0,74,0,646,74,85,74,85,159,805,80,0,9,11,9,0,0,11,80,20,9,11
29,Missouri/MO,2900700,"Pettis, Randolph, Saline, Cooper, Howard, Carroll & Chariton Counties PUMA, Missouri/MO",29033,"Carroll County, Missouri",8843,132,1,1493,11,0.066,113,15,31,1,4,6,114,19,37,10,46,56,170,66,1,6,27,2,9,4,18,67,33,11,22
29,Missouri/MO,2900700,"Pettis, Randolph, Saline, Cooper, Howard, Carroll & Chariton Counties PUMA, Missouri/MO",29041,"Chariton County, Missouri",7546,47,0,623,0,0.056,96,13,26,1,3,5,97,16,31,8,39,47,144,67,1,6,27,2,9,3,18,67,33,11,22
29,Missouri/MO,2900700,"Pettis, Randolph, Saline, Cooper, Howard, Carroll & Chariton Counties PUMA, Missouri/MO",29053,"Cooper County, Missouri",17622,419,2,2378,11,0.132,226,30,62,1,8,12,227,38,74,20,92,112,339,67,0,6,27,2,9,4,18,67,33,11,22
29,Missouri/MO,2900700,"Pettis, Randolph, Saline, Cooper, Howard, Carroll & Chariton Counties PUMA, Missouri/MO",29089,"Howard County, Missouri",10113,172,2,1701,20,0.075,128,17,35,1,5,7,129,22,42,12,52,64,193,66,1,6,27,3,9,4,18,67,33,11,22
29,Missouri/MO,2900700,"Pettis, Randolph, Saline, Cooper, Howard, Carroll & Chariton Counties PUMA, Missouri/MO",29159,"Pettis County, Missouri",42371,1100,18,2596,42,0.314,537,70,147,3,19,29,540,89,176,48,217,265,805,67,0,6,27,2,9,4,18,67,33,11,22
29,Missouri/MO,2900700,"Pettis, Randolph, Saline, Cooper, Howard, Carroll & Chariton Counties PUMA, Missouri/MO",29175,"Randolph County, Missouri",24945,244,3,978,12,0.186,318,42,87,2,11,17,320,53,104,28,129,157,477,67,0,6,27,2,9,4,18,67,33,11,22
29,Missouri/MO,2900700,"Pettis, Randolph, Saline, Cooper, Howard, Carroll & Chariton Counties PUMA, Missouri/MO",29195,"Saline County, Missouri",23102,711,9,3078,39,0.171,293,38,80,2,10,16,295,48,96,26,118,144,439,67,0,6,27,2,9,4,18,67,33,11,22
29,Missouri/MO,2900800,"Johnson, Lafayette, Ray, Clinton & Caldwell Counties PUMA, Missouri/MO",29025,"Caldwell County, Missouri",9049,89,1,984,11,0.065,81,0,3,0,0,0,81,0,3,0,3,3,84,96,0,0,4,0,0,0,4,96,4,0,4
29,Missouri/MO,2900800,"Johnson, Lafayette, Ray, Clinton & Caldwell Counties PUMA, Missouri/MO",29049,"Clinton County, Missouri",20475,231,0,1128,0,0.148,184,0,7,0,0,0,184,0,7,0,7,7,191,96,0,0,4,0,0,0,4,96,4,0,4
29,Missouri/MO,2900800,"Johnson, Lafayette, Ray, Clinton & Caldwell Counties PUMA, Missouri/MO",29101,"Johnson County, Missouri",53689,1081,4,2013,7,0.388,482,0,17,0,0,0,482,0,17,0,17,17,499,97,0,0,3,0,0,0,3,97,3,0,3
29,Missouri/MO,2900800,"Johnson, Lafayette, Ray, Clinton & Caldwell Counties PUMA, Missouri/MO",29107,"Lafayette County, Missouri",32589,497,2,1525,6,0.235,292,0,11,0,0,0,292,0,11,0,11,11,303,96,0,0,4,0,0,0,4,96,4,0,4
29,Missouri/MO,2900800,"Johnson, Lafayette, Ray, Clinton & Caldwell Counties PUMA, Missouri/MO",29177,"Ray County, Missouri",22825,168,0,736,0,0.164,204,0,7,0,0,0,204,0,7,0,7,7,211,97,0,0,3,0,0,0,3,97,3,0,3
29,Missouri/MO,2900901,"Clay County (Northeast) PUMA, Missouri/MO",29047,"Clay County, Missouri",239164,1799,41,752,17,1,312,0,13,25,0,0,337,0,13,0,13,13,350,89,7,0,4,0,0,0,4,96,4,0,4
29,Missouri/MO,2900902,"Kansas City (North Central), Gladstone City & North Kansas City PUMA, Missouri/MO",29047,"Clay County, Missouri",239164,1799,41,752,17,1,164,0,0,36,36,0,200,36,0,36,0,36,236,69,15,15,0,15,0,0,0,85,15,15,0
29,Missouri/MO,2900903,"Platte County PUMA, Missouri/MO",29047,"Clay County, Missouri",239164,1799,41,752,17,0.11,21,0,0,0,0,0,21,0,0,0,0,0,21,100,0,0,0,0,0,0,0,100,0,0,0
29,Missouri/MO,2900903,"Platte County PUMA, Missouri/MO",29165,"Platte County, Missouri",98824,728,12,737,12,0.89,170,0,0,0,0,0,170,0,0,0,0,0,170,100,0,0,0,0,0,0,0,100,0,0,0
29,Missouri/MO,2901001,"Jackson County--Kansas City (Central) PUMA, Missouri/MO",29095,"Jackson County, Missouri",692003,7400,99,1069,14,1,331,58,141,142,57,0,473,115,141,57,199,256,729,45,19,8,27,8,8,0,19,65,35,16,19
29,Missouri/MO,2901002,"Jackson County (North Central) PUMA, Missouri/MO",29095,"Jackson County, Missouri",692003,7400,99,1069,14,1,309,0,23,0,0,0,309,0,23,0,23,23,332,93,0,0,7,0,0,0,7,93,7,0,7
29,Missouri/MO,2901003,"Jackson County (East) PUMA, Missouri/MO",29095,"Jackson County, Missouri",692003,7400,99,1069,14,1,163,0,162,0,0,0,163,0,162,0,162,162,325,50,0,0,50,0,0,0,50,50,50,0,50
29,Missouri/MO,2901004,"Jackson County (South Central) PUMA, Missouri/MO",29095,"Jackson County, Missouri",692003,7400,99,1069,14,1,183,0,77,0,0,0,183,0,77,0,77,77,260,70,0,0,30,0,0,0,30,70,30,0,30
29,Missouri/MO,2901005,"Jackson County--Kansas City (South) PUMA, Missouri/MO",29095,"Jackson County, Missouri",692003,7400,99,1069,14,1,423,0,119,88,34,0,511,34,119,34,119,153,664,64,13,5,18,5,0,0,18,77,23,5,18
29,Missouri/MO,2901100,"Cass & Bates Counties PUMA, Missouri/MO",29013,"Bates County, Missouri",16374,113,2,690,12,0.138,86,1,7,9,0,0,95,1,7,0,8,8,103,83,9,0,8,0,1,0,7,92,8,1,7
29,Missouri/MO,2901100,"Cass & Bates Counties PUMA, Missouri/MO",29037,"Cass County, Missouri",102678,1571,22,1530,21,0.862,539,8,45,58,0,0,597,8,45,0,53,53,650,83,9,0,8,0,1,0,7,92,8,1,7
29,Missouri/MO,2901200,"Lawrence, Henry, Vernon, Cedar, Barton, St. Clair & Dade Counties PUMA, Missouri/MO",29011,"Barton County, Missouri",11850,180,0,1519,0,0.096,167,1,12,6,0,0,173,1,12,0,13,13,186,90,3,0,7,0,1,0,6,93,7,1,6
29,Missouri/MO,2901200,"Lawrence, Henry, Vernon, Cedar, Barton, St. Clair & Dade Counties PUMA, Missouri/MO",29039,"Cedar County, Missouri",13938,103,0,739,0,0.113,196,1,14,7,0,0,203,1,14,0,15,15,218,90,3,0,7,0,0,0,6,93,7,0,6
29,Missouri/MO,2901200,"Lawrence, Henry, Vernon, Cedar, Barton, St. Clair & Dade Counties PUMA, Missouri/MO",29057,"Dade County, Missouri",7590,61,0,804,0,0.062,108,1,8,4,0,0,112,1,8,0,9,9,121,89,3,0,7,0,1,0,7,93,7,1,7
29,Missouri/MO,2901200,"Lawrence, Henry, Vernon, Cedar, Barton, St. Clair & Dade Counties PUMA, Missouri/MO",29083,"Henry County, Missouri",21765,191,4,878,18,0.175,304,2,22,11,0,0,315,2,22,0,24,24,339,90,3,0,7,0,1,0,6,93,7,1,6
29,Missouri/MO,2901200,"Lawrence, Henry, Vernon, Cedar, Barton, St. Clair & Dade Counties PUMA, Missouri/MO",29109,"Lawrence County, Missouri",38133,611,2,1602,5,0.311,540,4,39,19,0,0,559,4,39,0,43,43,602,90,3,0,7,0,1,0,6,93,7,1,6
29,Missouri/MO,2901200,"Lawrence, Henry, Vernon, Cedar, Barton, St. Clair & Dade Counties PUMA, Missouri/MO",29185,"St. Clair County, Missouri",9383,66,0,703,0,0.075,130,1,9,5,0,0,135,1,9,0,10,10,145,90,3,0,7,0,1,0,6,93,7,1,6
29,Missouri/MO,2901200,"Lawrence, Henry, Vernon, Cedar, Barton, St. Clair & Dade Counties PUMA, Missouri/MO",29217,"Vernon County, Missouri",20691,169,1,817,5,0.168,292,2,21,10,0,0,302,2,21,0,23,23,325,90,3,0,7,0,1,0,6,93,7,1,6
29,Missouri/MO,2901300,"Laclede, Polk, Benton, Dallas & Hickory Counties PUMA, Missouri/MO",29015,"Benton County, Missouri",18989,304,3,1601,16,0.169,129,0,0,0,0,0,129,0,0,0,0,0,129,100,0,0,0,0,0,0,0,100,0,0,0
29,Missouri/MO,2901300,"Laclede, Polk, Benton, Dallas & Hickory Counties PUMA, Missouri/MO",29059,"Dallas County, Missouri",16499,190,1,1152,6,0.148,113,0,0,0,0,0,113,0,0,0,0,0,113,100,0,0,0,0,0,0,0,100,0,0,0
29,Missouri/MO,2901300,"Laclede, Polk, Benton, Dallas & Hickory Counties PUMA, Missouri/MO",29085,"Hickory County, Missouri",9368,90,2,961,21,0.083,63,0,0,0,0,0,63,0,0,0,0,0,63,100,0,0,0,0,0,0,0,100,0,0,0
29,Missouri/MO,2901300,"Laclede, Polk, Benton, Dallas & Hickory Counties PUMA, Missouri/MO",29105,"Laclede County, Missouri",35507,604,4,1701,11,0.319,243,0,0,0,0,0,243,0,0,0,0,0,243,100,0,0,0,0,0,0,0,100,0,0,0
29,Missouri/MO,2901300,"Laclede, Polk, Benton, Dallas & Hickory Counties PUMA, Missouri/MO",29167,"Polk County, Missouri",31549,688,4,2181,13,0.281,214,0,0,0,0,0,214,0,0,0,0,0,214,100,0,0,0,0,0,0,0,100,0,0,0
29,Missouri/MO,2901400,"Pulaski, Camden, Miller & Morgan Counties PUMA, Missouri/MO",29029,"Camden County, Missouri",45096,939,11,2082,24,0.312,177,16,3,3,6,0,180,22,3,6,19,25,205,86,1,3,9,3,8,0,1,88,12,11,1
29,Missouri/MO,2901400,"Pulaski, Camden, Miller & Morgan Counties PUMA, Missouri/MO",29131,"Miller County, Missouri",25049,488,1,1948,4,0.177,100,9,2,2,3,0,102,12,2,3,11,14,116,86,2,3,9,3,8,0,2,88,12,10,2
29,Missouri/MO,2901400,"Pulaski, Camden, Miller & Morgan Counties PUMA, Missouri/MO",29141,"Morgan County, Missouri",20137,332,1,1649,5,0.142,81,7,1,1,3,0,82,10,1,3,8,11,93,87,1,3,9,3,8,0,1,88,12,11,1
29,Missouri/MO,2901400,"Pulaski, Camden, Miller & Morgan Counties PUMA, Missouri/MO",29169,"Pulaski County, Missouri",52591,648,5,1232,10,0.369,209,19,3,3,7,0,212,26,3,7,22,29,241,87,1,3,9,3,8,0,1,88,12,11,1
29,Missouri/MO,2901500,"Phelps, Crawford, Dent, Gasconade & Maries Counties PUMA, Missouri/MO",29055,"Crawford County, Missouri",24280,391,4,1610,16,0.225,123,1,0,0,0,0,123,1,0,0,1,1,124,99,0,0,1,0,1,0,0,99,1,1,0
29,Missouri/MO,2901500,"Phelps, Crawford, Dent, Gasconade & Maries Counties PUMA, Missouri/MO",29065,"Dent County, Missouri",15504,142,1,916,6,0.143,78,1,0,0,0,0,78,1,0,0,1,1,79,99,0,0,1,0,1,0,0,99,1,1,0
29,Missouri/MO,2901500,"Phelps, Crawford, Dent, Gasconade & Maries Counties PUMA, Missouri/MO",29073,"Gasconade County, Missouri",14746,160,18,1085,122,0.137,75,1,0,0,0,0,75,1,0,0,1,1,76,99,0,0,1,0,1,0,0,99,1,1,0
29,Missouri/MO,2901500,"Phelps, Crawford, Dent, Gasconade & Maries Counties PUMA, Missouri/MO",29125,"Maries County, Missouri",8884,81,0,912,0,0.082,45,0,0,0,0,0,45,0,0,0,0,0,45,100,0,0,0,0,0,0,0,100,0,0,0
29,Missouri/MO,2901500,"Phelps, Crawford, Dent, Gasconade & Maries Counties PUMA, Missouri/MO",29161,"Phelps County, Missouri",44789,466,8,1040,18,0.413,226,2,0,0,0,0,226,2,0,0,2,2,228,99,0,0,1,0,1,0,0,99,1,1,0
29,Missouri/MO,2901600,"Franklin County PUMA, Missouri/MO",29071,"Franklin County, Missouri",102781,1681,29,1636,28,1,743,0,0,53,0,0,796,0,0,0,0,0,796,93,7,0,0,0,0,0,0,100,0,0,0
29,Missouri/MO,2901701,"St. Charles County (South) PUMA, Missouri/MO",29183,"St. Charles County, Missouri",389985,7620,128,1954,33,1,97,0,0,0,0,0,97,0,0,0,0,0,97,100,0,0,0,0,0,0,0,100,0,0,0
29,Missouri/MO,2901702,"St. Charles County (Northwest) PUMA, Missouri/MO",29183,"St. Charles County, Missouri",389985,7620,128,1954,33,1,220,0,0,31,0,0,251,0,0,0,0,0,251,88,12,0,0,0,0,0,0,100,0,0,0
29,Missouri/MO,2901703,"St. Charles County (Northeast) PUMA, Missouri/MO",29183,"St. Charles County, Missouri",389985,7620,128,1954,33,1,296,0,25,0,29,48,296,29,73,77,25,102,398,74,0,19,6,7,0,12,6,74,26,7,18
29,Missouri/MO,2901801,"St. Louis County (Northeast) PUMA, Missouri/MO",29189,"St. Louis County, Missouri",998684,23688,796,2372,80,1,286,0,0,0,0,0,286,0,0,0,0,0,286,100,0,0,0,0,0,0,0,100,0,0,0
29,Missouri/MO,2901802,"St. Louis County (Northwest) PUMA, Missouri/MO",29189,"St. Louis County, Missouri",998684,23688,796,2372,80,1,276,0,108,0,30,43,276,30,151,73,108,181,457,60,0,16,24,7,0,9,24,60,40,7,33
29,Missouri/MO,2901803,"St. Louis County (Inner Ring North) PUMA, Missouri/MO",29189,"St. Louis County, Missouri",998684,23688,796,2372,80,1,151,33,119,4,0,0,155,33,119,0,152,152,307,49,1,0,50,0,11,0,39,50,50,11,39
29,Missouri/MO,2901804,"St. Louis County (West) PUMA, Missouri/MO",29189,"St. Louis County, Missouri",998684,23688,796,2372,80,1,142,0,0,0,38,0,142,38,0,38,0,38,180,79,0,21,0,21,0,0,0,79,21,21,0
29,Missouri/MO,2901806,"St. Louis County (Central West) PUMA, Missouri/MO",29189,"St. Louis County, Missouri",998684,23688,796,2372,80,1,24,0,0,0,0,0,24,0,0,0,0,0,24,100,0,0,0,0,0,0,0,100,0,0,0
29,Missouri/MO,2901807,"St. Louis County (Inner Ring South) PUMA, Missouri/MO",29189,"St. Louis County, Missouri",998684,23688,796,2372,80,1,218,0,46,23,57,36,241,57,82,93,46,139,380,57,6,24,12,15,0,9,12,63,37,15,22
29,Missouri/MO,2901808,"St. Louis County (South) PUMA, Missouri/MO",29189,"St. Louis County, Missouri",998684,23688,796,2372,80,1,158,0,0,5,48,80,163,48,80,128,0,128,291,54,2,44,0,16,0,27,0,56,44,16,27
29,Missouri/MO,2901901,"St. Louis City (North) PUMA, Missouri/MO",29510,"St. Louis city, Missouri",311273,7003,207,2250,67,1,305,0,4,0,0,0,305,0,4,0,4,4,309,99,0,0,1,0,0,0,1,99,1,0,1
29,Missouri/MO,2901902,"St. Louis City (South) PUMA, Missouri/MO",29510,"St. Louis city, Missouri",311273,7003,207,2250,67,1,699,0,73,122,66,73,821,66,146,139,73,212,1033,68,12,13,7,6,0,7,7,79,21,6,14
29,Missouri/MO,2902001,"Jefferson County (North) PUMA, Missouri/MO",29099,"Jefferson County, Missouri",223302,4302,61,1927,27,1,245,0,0,0,0,0,245,0,0,0,0,0,245,100,0,0,0,0,0,0,0,100,0,0,0
29,Missouri/MO,2902002,"Jefferson County (South) PUMA, Missouri/MO",29099,"Jefferson County, Missouri",223302,4302,61,1927,27,1,110,0,0,0,0,0,110,0,0,0,0,0,110,100,0,0,0,0,0,0,0,100,0,0,0
29,Missouri/MO,2902100,"St. Francois, Washington, Perry & Ste. Genevieve Counties PUMA, Missouri/MO",29157,"Perry County, Missouri",19146,616,7,3217,37,0.15,147,0,0,0,0,0,147,0,0,0,0,0,147,100,0,0,0,0,0,0,0,100,0,0,0
29,Missouri/MO,2902100,"St. Francois, Washington, Perry & Ste. Genevieve Counties PUMA, Missouri/MO",29186,"Ste. Genevieve County, Missouri",17871,192,1,1074,6,0.14,137,0,0,0,0,0,137,0,0,0,0,0,137,100,0,0,0,0,0,0,0,100,0,0,0
29,Missouri/MO,2902100,"St. Francois, Washington, Perry & Ste. Genevieve Counties PUMA, Missouri/MO",29187,"St. Francois County, Missouri",66342,2164,9,3262,14,0.517,507,0,0,1,0,0,508,0,0,0,0,0,508,100,0,0,0,0,0,0,0,100,0,0,0
29,Missouri/MO,2902100,"St. Francois, Washington, Perry & Ste. Genevieve Counties PUMA, Missouri/MO",29221,"Washington County, Missouri",24931,384,10,1540,40,0.193,189,0,0,0,0,0,189,0,0,0,0,0,189,100,0,0,0,0,0,0,0,100,0,0,0
29,Missouri/MO,2902200,"Cape Girardeau, Scott & Bollinger Counties PUMA, Missouri/MO",29017,"Bollinger County, Missouri",12281,344,1,2801,8,0.093,87,0,1,7,0,0,94,0,1,0,1,1,95,92,7,0,1,0,0,0,1,99,1,0,1
29,Missouri/MO,2902200,"Cape Girardeau, Scott & Bollinger Counties PUMA, Missouri/MO",29031,"Cape Girardeau County, Missouri",78324,1801,26,2299,33,0.608,569,0,4,47,0,0,616,0,4,0,4,4,620,92,8,0,1,0,0,0,1,99,1,0,1
29,Missouri/MO,2902200,"Cape Girardeau, Scott & Bollinger Counties PUMA, Missouri/MO",29201,"Scott County, Missouri",38729,851,17,2197,44,0.299,280,0,2,23,0,0,303,0,2,0,2,2,305,92,8,0,1,0,0,0,1,99,1,0,1
29,Missouri/MO,2902300,"Dunklin, Stoddard, New Madrid, Pemiscot & Mississippi Counties PUMA, Missouri/MO",29069,"Dunklin County, Missouri",30428,779,7,2560,23,0.28,541,0,37,19,0,0,560,0,37,0,37,37,597,91,3,0,6,0,0,0,6,94,6,0,6
29,Missouri/MO,2902300,"Dunklin, Stoddard, New Madrid, Pemiscot & Mississippi Counties PUMA, Missouri/MO",29133,"Mississippi County, Missouri",13748,294,3,2138,22,0.127,245,0,17,9,0,0,254,0,17,0,17,17,271,90,3,0,6,0,0,0,6,94,6,0,6
29,Missouri/MO,2902300,"Dunklin, Stoddard, New Madrid, Pemiscot & Mississippi Counties PUMA, Missouri/MO",29143,"New Madrid County, Missouri",17811,524,16,2942,90,0.164,317,0,22,11,0,0,328,0,22,0,22,22,350,91,3,0,6,0,0,0,6,94,6,0,6
29,Missouri/MO,2902300,"Dunklin, Stoddard, New Madrid, Pemiscot & Mississippi Counties PUMA, Missouri/MO",29155,"Pemiscot County, Missouri",17031,512,9,3006,53,0.157,303,0,21,11,0,0,314,0,21,0,21,21,335,90,3,0,6,0,0,0,6,94,6,0,6
29,Missouri/MO,2902300,"Dunklin, Stoddard, New Madrid, Pemiscot & Mississippi Counties PUMA, Missouri/MO",29207,"Stoddard County, Missouri",29512,490,12,1660,41,0.272,525,0,36,18,0,0,543,0,36,0,36,36,579,91,3,0,6,0,0,0,6,94,6,0,6
29,Missouri/MO,2902400,"Butler, Ripley, Wayne, Madison, Iron, Reynolds & Carter Counties PUMA, Missouri/MO",29023,"Butler County, Missouri",42733,640,6,1498,14,0.408,392,0,0,0,2,0,392,2,0,2,0,2,394,99,0,1,0,1,0,0,0,99,1,1,0
29,Missouri/MO,2902400,"Butler, Ripley, Wayne, Madison, Iron, Reynolds & Carter Counties PUMA, Missouri/MO",29035,"Carter County, Missouri",6197,100,1,1614,16,0.059,57,0,0,0,0,0,57,0,0,0,0,0,57,100,0,0,0,0,0,0,0,100,0,0,0
29,Missouri/MO,2902400,"Butler, Ripley, Wayne, Madison, Iron, Reynolds & Carter Counties PUMA, Missouri/MO",29093,"Iron County, Missouri",10221,55,0,538,0,0.096,92,0,0,0,0,0,92,0,0,0,0,0,92,100,0,0,0,0,0,0,0,100,0,0,0
29,Missouri/MO,2902400,"Butler, Ripley, Wayne, Madison, Iron, Reynolds & Carter Counties PUMA, Missouri/MO",29123,"Madison County, Missouri",12205,296,0,2425,0,0.119,114,0,0,0,0,0,114,0,0,0,0,0,114,100,0,0,0,0,0,0,0,100,0,0,0
29,Missouri/MO,2902400,"Butler, Ripley, Wayne, Madison, Iron, Reynolds & Carter Counties PUMA, Missouri/MO",29179,"Reynolds County, Missouri",6315,38,0,602,0,0.062,60,0,0,0,0,0,60,0,0,0,0,0,60,100,0,0,0,0,0,0,0,100,0,0,0
29,Missouri/MO,2902400,"Butler, Ripley, Wayne, Madison, Iron, Reynolds & Carter Counties PUMA, Missouri/MO",29181,"Ripley County, Missouri",13693,161,0,1176,0,0.132,127,0,0,0,1,0,127,1,0,1,0,1,128,99,0,1,0,1,0,0,0,99,1,1,0
29,Missouri/MO,2902400,"Butler, Ripley, Wayne, Madison, Iron, Reynolds & Carter Counties PUMA, Missouri/MO",29223,"Wayne County, Missouri",13308,212,0,1593,0,0.125,120,0,0,0,0,0,120,0,0,0,0,0,120,100,0,0,0,0,0,0,0,100,0,0,0
29,Missouri/MO,2902500,"Howell, Texas, Wright, Douglas, Oregon, Ozark & Shannon Counties PUMA, Missouri/MO",29067,"Douglas County, Missouri",13374,188,3,1406,22,0.106,145,0,0,0,0,0,145,0,0,0,0,0,145,100,0,0,0,0,0,0,0,100,0,0,0
29,Missouri/MO,2902500,"Howell, Texas, Wright, Douglas, Oregon, Ozark & Shannon Counties PUMA, Missouri/MO",29091,"Howell County, Missouri",40102,602,3,1501,7,0.32,437,0,0,0,0,0,437,0,0,0,0,0,437,100,0,0,0,0,0,0,0,100,0,0,0
29,Missouri/MO,2902500,"Howell, Texas, Wright, Douglas, Oregon, Ozark & Shannon Counties PUMA, Missouri/MO",29149,"Oregon County, Missouri",10699,116,0,1084,0,0.086,117,0,0,0,0,0,117,0,0,0,0,0,117,100,0,0,0,0,0,0,0,100,0,0,0
29,Missouri/MO,2902500,"Howell, Texas, Wright, Douglas, Oregon, Ozark & Shannon Counties PUMA, Missouri/MO",29153,"Ozark County, Missouri",9236,124,0,1343,0,0.073,100,0,0,0,0,0,100,0,0,0,0,0,100,100,0,0,0,0,0,0,0,100,0,0,0
29,Missouri/MO,2902500,"Howell, Texas, Wright, Douglas, Oregon, Ozark & Shannon Counties PUMA, Missouri/MO",29203,"Shannon County, Missouri",8246,94,1,1140,12,0.065,89,0,0,0,0,0,89,0,0,0,0,0,89,100,0,0,0,0,0,0,0,100,0,0,0
29,Missouri/MO,2902500,"Howell, Texas, Wright, Douglas, Oregon, Ozark & Shannon Counties PUMA, Missouri/MO",29215,"Texas County, Missouri",25671,312,2,1215,8,0.205,280,0,0,0,0,0,280,0,0,0,0,0,280,100,0,0,0,0,0,0,0,100,0,0,0
29,Missouri/MO,2902500,"Howell, Texas, Wright, Douglas, Oregon, Ozark & Shannon Counties PUMA, Missouri/MO",29229,"Wright County, Missouri",18293,305,0,1667,0,0.145,198,0,0,0,0,0,198,0,0,0,0,0,198,100,0,0,0,0,0,0,0,100,0,0,0
29,Missouri/MO,2902601,"Christian, Greene (Outside Springfield City) & Webster Counties PUMA, Missouri/MO",29043,"Christian County, Missouri",84275,1490,5,1768,6,0.518,415,0,20,0,0,0,415,0,20,0,20,20,435,95,0,0,5,0,0,0,5,95,5,0,5
29,Missouri/MO,2902601,"Christian, Greene (Outside Springfield City) & Webster Counties PUMA, Missouri/MO",29077,"Greene County, Missouri",288429,6394,70,2217,24,0.248,199,0,10,0,0,0,199,0,10,0,10,10,209,95,0,0,5,0,0,0,5,95,5,0,5
29,Missouri/MO,2902601,"Christian, Greene (Outside Springfield City) & Webster Counties PUMA, Missouri/MO",29225,"Webster County, Missouri",38082,620,3,1628,8,0.234,187,0,9,0,0,0,187,0,9,0,9,9,196,95,0,0,5,0,0,0,5,95,5,0,5
29,Missouri/MO,2902602,"Greene County--Springfield City (North) PUMA, Missouri/MO",29077,"Greene County, Missouri",288429,6394,70,2217,24,1,386,0,0,0,0,55,386,0,55,55,0,55,441,88,0,12,0,0,0,12,0,88,12,0,12
29,Missouri/MO,2902603,"Greene County--Springfield City (South) PUMA, Missouri/MO",29077,"Greene County, Missouri",288429,6394,70,2217,24,1,476,0,0,48,67,0,524,67,0,67,0,67,591,81,8,11,0,11,0,0,0,89,11,11,0
29,Missouri/MO,2902700,"Taney, Barry, Stone & McDonald Counties PUMA, Missouri/MO",29009,"Barry County, Missouri",35493,473,6,1333,17,0.248,507,33,178,130,9,81,637,42,259,90,211,301,938,54,14,10,22,1,4,9,19,68,32,4,28
29,Missouri/MO,2902700,"Taney, Barry, Stone & McDonald Counties PUMA, Missouri/MO",29119,"McDonald County, Missouri",22827,1141,12,4998,53,0.157,321,21,113,82,5,51,403,26,164,56,134,190,593,54,14,9,23,1,4,9,19,68,32,4,28
29,Missouri/MO,2902700,"Taney, Barry, Stone & McDonald Counties PUMA, Missouri/MO",29209,"Stone County, Missouri",31527,447,4,1418,13,0.215,440,29,154,113,8,70,553,37,224,78,183,261,814,54,14,10,22,1,4,9,19,68,32,5,28
29,Missouri/MO,2902700,"Taney, Barry, Stone & McDonald Counties PUMA, Missouri/MO",29213,"Taney County, Missouri",54720,1184,31,2164,57,0.38,777,51,273,199,13,124,976,64,397,137,324,461,1437,54,14,10,23,1,4,9,19,68,32,4,28
29,Missouri/MO,2902800,"Jasper & Newton Counties PUMA, Missouri/MO",29097,"Jasper County, Missouri",119238,2306,29,1934,24,0.67,2086,195,261,174,25,46,2260,220,307,71,456,527,2787,75,6,3,16,1,7,2,9,81,19,8,11
29,Missouri/MO,2902800,"Jasper & Newton Counties PUMA, Missouri/MO",29145,"Newton County, Missouri",58202,1454,14,2498,24,0.33,1027,96,128,86,13,23,1113,109,151,36,224,260,1373,75,6,3,16,1,7,2,9,81,19,8,11
30,Montana/MT,3000100,"Northwest Montana--Kalispell City PUMA, Montana/MT",30029,"Flathead County, Montana",98082,956,16,975,16,0.749,416,0,43,0,0,0,416,0,43,0,43,43,459,91,0,0,9,0,0,0,9,91,9,0,9
30,Montana/MT,3000100,"Northwest Montana--Kalispell City PUMA, Montana/MT",30035,"Glacier County, Montana",13699,250,1,1825,7,0.105,58,0,6,0,0,0,58,0,6,0,6,6,64,91,0,0,9,0,0,0,9,91,9,0,9
30,Montana/MT,3000100,"Northwest Montana--Kalispell City PUMA, Montana/MT",30053,"Lincoln County, Montana",19358,109,3,563,15,0.147,82,0,9,0,0,0,82,0,9,0,9,9,91,90,0,0,10,0,0,0,10,90,10,0,10
30,Montana/MT,3000200,"West Montana--Missoula City PUMA, Montana/MT",30047,"Lake County, Montana",29774,274,1,920,3,0.146,102,0,0,1,0,0,103,0,0,0,0,0,103,99,1,0,0,0,0,0,0,100,0,0,0
30,Montana/MT,3000200,"West Montana--Missoula City PUMA, Montana/MT",30061,"Mineral County, Montana",4211,2,0,47,0,0.021,15,0,0,0,0,0,15,0,0,0,0,0,15,100,0,0,0,0,0,0,0,100,0,0,0
30,Montana/MT,3000200,"West Montana--Missoula City PUMA, Montana/MT",30063,"Missoula County, Montana",115983,750,3,647,3,0.57,400,0,0,5,0,2,405,0,2,2,0,2,407,98,1,0,0,0,0,0,0,100,0,0,0
30,Montana/MT,3000200,"West Montana--Missoula City PUMA, Montana/MT",30081,"Ravalli County, Montana",41902,135,2,322,5,0.207,145,0,0,2,0,1,147,0,1,1,0,1,148,98,1,1,0,0,0,1,0,99,1,0,1
30,Montana/MT,3000200,"West Montana--Missoula City PUMA, Montana/MT",30089,"Sanders County, Montana",11521,46,1,399,9,0.057,40,0,0,0,0,0,40,0,0,0,0,0,40,100,0,0,0,0,0,0,0,100,0,0,0
30,Montana/MT,3000300,"Southwest Montana--Butte-Silver Bow & Helena City PUMA, Montana/MT",30001,"Beaverhead County, Montana",9393,85,1,905,11,0.06,39,2,12,1,0,0,40,2,12,0,14,14,54,72,2,0,26,0,4,0,22,74,26,4,22
30,Montana/MT,3000300,"Southwest Montana--Butte-Silver Bow & Helena City PUMA, Montana/MT",30007,"Broadwater County, Montana",5834,17,0,291,0,0.037,24,1,8,1,0,0,25,1,8,0,9,9,34,71,3,0,26,0,3,0,24,74,26,3,24
30,Montana/MT,3000300,"Southwest Montana--Butte-Silver Bow & Helena City PUMA, Montana/MT",30023,"Deer Lodge County, Montana",9100,114,0,1253,0,0.058,38,2,12,1,0,0,39,2,12,0,14,14,53,72,2,0,26,0,4,0,23,74,26,4,23
30,Montana/MT,3000300,"Southwest Montana--Butte-Silver Bow & Helena City PUMA, Montana/MT",30039,"Granite County, Montana",3269,22,0,673,0,0.022,14,1,5,0,0,0,14,1,5,0,6,6,20,70,0,0,30,0,5,0,25,70,30,5,25
30,Montana/MT,3000300,"Southwest Montana--Butte-Silver Bow & Helena City PUMA, Montana/MT",30043,"Jefferson County, Montana",11778,74,0,628,0,0.076,49,3,16,1,0,0,50,3,16,0,19,19,69,71,1,0,28,0,4,0,23,72,28,4,23
30,Montana/MT,3000300,"Southwest Montana--Butte-Silver Bow & Helena City PUMA, Montana/MT",30049,"Lewis and Clark County, Montana",67077,248,3,370,4,0.431,280,17,88,6,0,0,286,17,88,0,105,105,391,72,2,0,27,0,4,0,23,73,27,4,23
30,Montana/MT,3000300,"Southwest Montana--Butte-Silver Bow & Helena City PUMA, Montana/MT",30057,"Madison County, Montana",8218,100,1,1217,12,0.051,33,2,10,1,0,0,34,2,10,0,12,12,46,72,2,0,26,0,4,0,22,74,26,4,22
30,Montana/MT,3000300,"Southwest Montana--Butte-Silver Bow & Helena City PUMA, Montana/MT",30077,"Powell County, Montana",6861,12,0,175,0,0.044,29,2,9,1,0,0,30,2,9,0,11,11,41,71,2,0,27,0,5,0,22,73,27,5,22
30,Montana/MT,3000300,"Southwest Montana--Butte-Silver Bow & Helena City PUMA, Montana/MT",30093,"Silver Bow County, Montana",34814,249,0,715,0,0.221,144,9,45,3,0,0,147,9,45,0,54,54,201,72,1,0,27,0,4,0,22,73,27,4,22
30,Montana/MT,3000400,"North Central Montana--Great Falls City PUMA, Montana/MT",30005,"Blaine County, Montana",6727,21,0,312,0,0.045,90,0,2,4,0,2,94,0,4,2,2,4,98,92,4,2,2,0,0,2,2,96,4,0,4
30,Montana/MT,3000400,"North Central Montana--Great Falls City PUMA, Montana/MT",30013,"Cascade County, Montana",81746,658,5,805,6,0.553,1104,0,25,45,3,26,1149,3,51,29,25,54,1203,92,4,2,2,0,0,2,2,96,4,0,4
30,Montana/MT,3000400,"North Central Montana--Great Falls City PUMA, Montana/MT",30015,"Chouteau County, Montana",5789,28,0,484,0,0.039,78,0,2,3,0,2,81,0,4,2,2,4,85,92,4,2,2,0,0,2,2,95,5,0,5
30,Montana/MT,3000400,"North Central Montana--Great Falls City PUMA, Montana/MT",30027,"Fergus County, Montana",11273,64,1,568,9,0.077,154,0,4,6,0,4,160,0,8,4,4,8,168,92,4,2,2,0,0,2,2,95,5,0,5
30,Montana/MT,3000400,"North Central Montana--Great Falls City PUMA, Montana/MT",30041,"Hill County, Montana",16439,147,3,894,18,0.112,224,0,5,9,1,5,233,1,10,6,5,11,244,92,4,2,2,0,0,2,2,95,5,0,4
30,Montana/MT,3000400,"North Central Montana--Great Falls City PUMA, Montana/MT",30045,"Judith Basin County, Montana",1951,6,0,308,0,0.013,26,0,1,1,0,1,27,0,2,1,1,2,29,90,3,3,3,0,0,3,3,93,7,0,7
30,Montana/MT,3000400,"North Central Montana--Great Falls City PUMA, Montana/MT",30051,"Liberty County, Montana",2280,18,0,789,0,0.016,32,0,1,1,0,1,33,0,2,1,1,2,35,91,3,3,3,0,0,3,3,94,6,0,6
30,Montana/MT,3000400,"North Central Montana--Great Falls City PUMA, Montana/MT",30059,"Meagher County, Montana",1968,25,2,1270,102,0.012,24,0,1,1,0,1,25,0,2,1,1,2,27,89,4,4,4,0,0,4,4,93,7,0,7
30,Montana/MT,3000400,"North Central Montana--Great Falls City PUMA, Montana/MT",30073,"Pondera County, Montana",6044,24,0,397,0,0.041,82,0,2,3,0,2,85,0,4,2,2,4,89,92,3,2,2,0,0,2,2,96,4,0,4
30,Montana/MT,3000400,"North Central Montana--Great Falls City PUMA, Montana/MT",30099,"Teton County, Montana",6080,21,0,345,0,0.041,82,0,2,3,0,2,85,0,4,2,2,4,89,92,3,2,2,0,0,2,2,96,4,0,4
30,Montana/MT,3000400,"North Central Montana--Great Falls City PUMA, Montana/MT",30101,"Toole County, Montana",4976,76,6,1527,121,0.034,68,0,2,3,0,2,71,0,4,2,2,4,75,91,4,3,3,0,0,3,3,95,5,0,5
30,Montana/MT,3000400,"North Central Montana--Great Falls City PUMA, Montana/MT",30107,"Wheatland County, Montana",2149,16,1,745,47,0.014,28,0,1,1,0,1,29,0,2,1,1,2,31,90,3,3,3,0,0,3,3,94,6,0,6
30,Montana/MT,3000400,"North Central Montana--Great Falls City PUMA, Montana/MT",30069,"Petroleum County, Montana",432,NA,NA,NA,NA,0.003,6,0,0,0,0,0,6,0,0,0,0,0,6,100,0,0,0,0,0,0,0,100,0,0,0
30,Montana/MT,3000500,"South Central Montana--Bozeman City PUMA, Montana/MT",30009,"Carbon County, Montana",10546,115,0,1090,0,0.073,95,8,0,1,3,0,96,11,0,3,8,11,107,89,1,3,7,3,7,0,0,90,10,10,0
30,Montana/MT,3000500,"South Central Montana--Bozeman City PUMA, Montana/MT",30031,"Gallatin County, Montana",104729,1361,4,1300,4,0.725,941,75,4,5,30,0,946,105,4,30,79,109,1055,89,0,3,7,3,7,0,0,90,10,10,0
30,Montana/MT,3000500,"South Central Montana--Bozeman City PUMA, Montana/MT",30067,"Park County, Montana",16246,95,0,585,0,0.112,145,12,1,1,5,0,146,17,1,5,13,18,164,88,1,3,8,3,7,0,1,89,11,10,1
30,Montana/MT,3000500,"South Central Montana--Bozeman City PUMA, Montana/MT",30095,"Stillwater County, Montana",9410,62,2,659,21,0.065,84,7,0,0,3,0,84,10,0,3,7,10,94,89,0,3,7,3,7,0,0,89,11,11,0
30,Montana/MT,3000500,"South Central Montana--Bozeman City PUMA, Montana/MT",30097,"Sweet Grass County, Montana",3653,43,1,1177,27,0.025,32,3,0,0,1,0,32,4,0,1,3,4,36,89,0,3,8,3,8,0,0,89,11,11,0
30,Montana/MT,3000600,"East Montana (Outside Billings City) PUMA, Montana/MT",30003,"Big Horn County, Montana",13376,881,22,6586,164,0.09,197,0,2,5,0,1,202,0,3,1,2,3,205,96,2,0,1,0,0,0,1,99,1,0,1
30,Montana/MT,3000600,"East Montana (Outside Billings City) PUMA, Montana/MT",30011,"Carter County, Montana",1318,3,0,228,0,0.008,17,0,0,0,0,0,17,0,0,0,0,0,17,100,0,0,0,0,0,0,0,100,0,0,0
30,Montana/MT,3000600,"East Montana (Outside Billings City) PUMA, Montana/MT",30017,"Custer County, Montana",11845,112,2,946,17,0.08,175,0,2,4,0,1,179,0,3,1,2,3,182,96,2,1,1,0,0,1,1,98,2,0,2
30,Montana/MT,3000600,"East Montana (Outside Billings City) PUMA, Montana/MT",30019,"Daniels County, Montana",1753,5,0,285,0,0.012,26,0,0,1,0,0,27,0,0,0,0,0,27,96,4,0,0,0,0,0,0,100,0,0,0
30,Montana/MT,3000600,"East Montana (Outside Billings City) PUMA, Montana/MT",30021,"Dawson County, Montana",9191,77,1,838,11,0.063,138,0,1,3,0,1,141,0,2,1,1,2,143,97,2,1,1,0,0,1,1,99,1,0,1
30,Montana/MT,3000600,"East Montana (Outside Billings City) PUMA, Montana/MT",30025,"Fallon County, Montana",2838,5,0,176,0,0.021,46,0,0,1,0,0,47,0,0,0,0,0,47,98,2,0,0,0,0,0,0,100,0,0,0
30,Montana/MT,3000600,"East Montana (Outside Billings City) PUMA, Montana/MT",30033,"Garfield County, Montana",1141,17,0,1490,0,0.009,20,0,0,0,0,0,20,0,0,0,0,0,20,100,0,0,0,0,0,0,0,100,0,0,0
30,Montana/MT,3000600,"East Montana (Outside Billings City) PUMA, Montana/MT",30037,"Golden Valley County, Montana",724,4,0,552,0,0.006,13,0,0,0,0,0,13,0,0,0,0,0,13,100,0,0,0,0,0,0,0,100,0,0,0
30,Montana/MT,3000600,"East Montana (Outside Billings City) PUMA, Montana/MT",30055,"McCone County, Montana",1630,19,0,1166,0,0.011,24,0,0,1,0,0,25,0,0,0,0,0,25,96,4,0,0,0,0,0,0,100,0,0,0
30,Montana/MT,3000600,"East Montana (Outside Billings City) PUMA, Montana/MT",30065,"Musselshell County, Montana",4807,35,1,728,21,0.031,68,0,1,2,0,0,70,0,1,0,1,1,71,96,3,0,1,0,0,0,1,99,1,0,1
30,Montana/MT,3000600,"East Montana (Outside Billings City) PUMA, Montana/MT",30071,"Phillips County, Montana",4124,121,0,2934,0,0.028,61,0,1,2,0,0,63,0,1,0,1,1,64,95,3,0,2,0,0,0,2,98,2,0,2
30,Montana/MT,3000600,"East Montana (Outside Billings City) PUMA, Montana/MT",30075,"Powder River County, Montana",1619,8,0,494,0,0.012,26,0,0,1,0,0,27,0,0,0,0,0,27,96,4,0,0,0,0,0,0,100,0,0,0
30,Montana/MT,3000600,"East Montana (Outside Billings City) PUMA, Montana/MT",30079,"Prairie County, Montana",1342,1,0,75,0,0.008,17,0,0,0,0,0,17,0,0,0,0,0,17,100,0,0,0,0,0,0,0,100,0,0,0
30,Montana/MT,3000600,"East Montana (Outside Billings City) PUMA, Montana/MT",30083,"Richland County, Montana",11360,78,2,687,18,0.077,168,0,2,4,0,1,172,0,3,1,2,3,175,96,2,1,1,0,0,1,1,98,2,0,2
30,Montana/MT,3000600,"East Montana (Outside Billings City) PUMA, Montana/MT",30085,"Roosevelt County, Montana",11228,287,4,2556,36,0.076,166,0,2,4,0,1,170,0,3,1,2,3,173,96,2,1,1,0,0,1,1,98,2,0,2
30,Montana/MT,3000600,"East Montana (Outside Billings City) PUMA, Montana/MT",30087,"Rosebud County, Montana",9250,630,18,6811,195,0.062,135,0,1,3,0,1,138,0,2,1,1,2,140,96,2,1,1,0,0,1,1,99,1,0,1
30,Montana/MT,3000600,"East Montana (Outside Billings City) PUMA, Montana/MT",30091,"Sheridan County, Montana",3574,13,0,364,0,0.025,55,0,1,1,0,0,56,0,1,0,1,1,57,96,2,0,2,0,0,0,2,98,2,0,2
30,Montana/MT,3000600,"East Montana (Outside Billings City) PUMA, Montana/MT",30103,"Treasure County, Montana",777,3,0,386,0,0.005,11,0,0,0,0,0,11,0,0,0,0,0,11,100,0,0,0,0,0,0,0,100,0,0,0
30,Montana/MT,3000600,"East Montana (Outside Billings City) PUMA, Montana/MT",30105,"Valley County, Montana",7532,79,0,1049,0,0.051,111,0,1,3,0,1,114,0,2,1,1,2,116,96,3,1,1,0,0,1,1,98,2,0,2
30,Montana/MT,3000600,"East Montana (Outside Billings City) PUMA, Montana/MT",30109,"Wibaux County, Montana",1175,9,0,766,0,0.007,15,0,0,0,0,0,15,0,0,0,0,0,15,100,0,0,0,0,0,0,0,100,0,0,0
30,Montana/MT,3000600,"East Montana (Outside Billings City) PUMA, Montana/MT",30111,"Yellowstone County, Montana",157816,3046,63,1930,40,0.32,699,1,7,17,1,5,716,2,12,6,8,14,730,96,2,1,1,0,0,1,1,98,2,0,2
30,Montana/MT,3000700,"Billings City PUMA, Montana/MT",30111,"Yellowstone County, Montana",157816,3046,63,1930,40,1,229,0,0,27,0,0,256,0,0,0,0,0,256,89,11,0,0,0,0,0,0,100,0,0,0
31,Nebraska/NE,3100100,"North Central & Northwest Nebraska PUMA, Nebraska/NE",31007,"Banner County, Nebraska",696,2,0,287,0,0.007,16,0,0,1,0,0,17,0,0,0,0,0,17,94,6,0,0,0,0,0,0,100,0,0,0
31,Nebraska/NE,3100100,"North Central & Northwest Nebraska PUMA, Nebraska/NE",31013,"Box Butte County, Nebraska",11089,76,1,685,9,0.102,233,2,3,20,0,3,253,2,6,3,5,8,261,89,8,1,2,0,1,1,1,97,3,1,2
31,Nebraska/NE,3100100,"North Central & Northwest Nebraska PUMA, Nebraska/NE",31015,"Boyd County, Nebraska",2042,21,0,1028,0,0.018,41,0,0,4,0,1,45,0,1,1,0,1,46,89,9,2,0,0,0,2,0,98,2,0,2
31,Nebraska/NE,3100100,"North Central & Northwest Nebraska PUMA, Nebraska/NE",31017,"Brown County, Nebraska",2988,33,0,1104,0,0.027,62,1,1,5,0,1,67,1,2,1,2,3,70,89,7,1,3,0,1,1,1,96,4,1,3
31,Nebraska/NE,3100100,"North Central & Northwest Nebraska PUMA, Nebraska/NE",31031,"Cherry County, Nebraska",5790,47,4,812,69,0.053,121,1,1,10,0,2,131,1,3,2,2,4,135,90,7,1,1,0,1,1,1,97,3,1,2
31,Nebraska/NE,3100100,"North Central & Northwest Nebraska PUMA, Nebraska/NE",31033,"Cheyenne County, Nebraska",9852,36,0,365,0,0.092,210,2,2,18,0,3,228,2,5,3,4,7,235,89,8,1,2,0,1,1,1,97,3,1,2
31,Nebraska/NE,3100100,"North Central & Northwest Nebraska PUMA, Nebraska/NE",31045,"Dawes County, Nebraska",8896,121,0,1360,0,0.082,188,2,2,16,0,2,204,2,4,2,4,6,210,90,8,1,2,0,1,1,1,97,3,1,2
31,Nebraska/NE,3100100,"North Central & Northwest Nebraska PUMA, Nebraska/NE",31049,"Deuel County, Nebraska",1894,4,0,211,0,0.017,39,0,0,3,0,1,42,0,1,1,0,1,43,91,7,2,0,0,0,2,0,98,2,0,2
31,Nebraska/NE,3100100,"North Central & Northwest Nebraska PUMA, Nebraska/NE",31069,"Garden County, Nebraska",1860,10,0,538,0,0.018,41,0,0,4,0,1,45,0,1,1,0,1,46,89,9,2,0,0,0,2,0,98,2,0,2
31,Nebraska/NE,3100100,"North Central & Northwest Nebraska PUMA, Nebraska/NE",31089,"Holt County, Nebraska",10245,70,1,683,10,0.094,215,2,2,18,0,3,233,2,5,3,4,7,240,90,8,1,2,0,1,1,1,97,3,1,2
31,Nebraska/NE,3100100,"North Central & Northwest Nebraska PUMA, Nebraska/NE",31103,"Keya Paha County, Nebraska",792,5,0,631,0,0.007,16,0,0,1,0,0,17,0,0,0,0,0,17,94,6,0,0,0,0,0,0,100,0,0,0
31,Nebraska/NE,3100100,"North Central & Northwest Nebraska PUMA, Nebraska/NE",31105,"Kimball County, Nebraska",3667,15,0,409,0,0.034,78,1,1,7,0,1,85,1,2,1,2,3,88,89,8,1,2,0,1,1,1,97,3,1,2
31,Nebraska/NE,3100100,"North Central & Northwest Nebraska PUMA, Nebraska/NE",31123,"Morrill County, Nebraska",4841,78,0,1611,0,0.044,101,1,1,9,0,1,110,1,2,1,2,3,113,89,8,1,2,0,1,1,1,97,3,1,2
31,Nebraska/NE,3100100,"North Central & Northwest Nebraska PUMA, Nebraska/NE",31149,"Rock County, Nebraska",1350,42,1,3111,74,0.013,30,0,0,3,0,0,33,0,0,0,0,0,33,91,9,0,0,0,0,0,0,100,0,0,0
31,Nebraska/NE,3100100,"North Central & Northwest Nebraska PUMA, Nebraska/NE",31157,"Scotts Bluff County, Nebraska",36255,411,8,1134,22,0.333,762,7,9,65,0,10,827,7,19,10,16,26,853,89,8,1,2,0,1,1,1,97,3,1,2
31,Nebraska/NE,3100100,"North Central & Northwest Nebraska PUMA, Nebraska/NE",31161,"Sheridan County, Nebraska",5234,48,0,917,0,0.048,110,1,1,9,0,1,119,1,2,1,2,3,122,90,7,1,2,0,1,1,1,98,2,1,2
31,Nebraska/NE,3100100,"North Central & Northwest Nebraska PUMA, Nebraska/NE",31165,"Sioux County, Nebraska",1266,7,0,553,0,0.011,25,0,0,2,0,0,27,0,0,0,0,0,27,93,7,0,0,0,0,0,0,100,0,0,0
31,Nebraska/NE,3100200,"Northeast Nebraska PUMA, Nebraska/NE",31003,"Antelope County, Nebraska",6372,67,1,1051,16,0.035,117,54,90,20,6,6,137,60,96,12,144,156,293,40,7,4,49,2,18,2,31,47,53,20,33
31,Nebraska/NE,3100200,"Northeast Nebraska PUMA, Nebraska/NE",31011,"Boone County, Nebraska",5313,78,0,1468,0,0.029,97,45,75,16,5,5,113,50,80,10,120,130,243,40,7,4,49,2,19,2,31,47,53,21,33
31,Nebraska/NE,3100200,"Northeast Nebraska PUMA, Nebraska/NE",31021,"Burt County, Nebraska",6528,75,0,1149,0,0.036,120,55,93,20,6,6,140,61,99,12,148,160,300,40,7,4,49,2,18,2,31,47,53,20,33
31,Nebraska/NE,3100200,"Northeast Nebraska PUMA, Nebraska/NE",31027,"Cedar County, Nebraska",8523,80,0,939,0,0.048,160,74,123,27,8,8,187,82,131,16,197,213,400,40,7,4,49,2,18,2,31,47,53,20,33
31,Nebraska/NE,3100200,"Northeast Nebraska PUMA, Nebraska/NE",31037,"Colfax County, Nebraska",10760,771,5,7165,46,0.057,190,87,146,32,9,9,222,96,155,18,233,251,473,40,7,4,49,2,18,2,31,47,53,20,33
31,Nebraska/NE,3100200,"Northeast Nebraska PUMA, Nebraska/NE",31039,"Cuming County, Nebraska",8991,135,0,1502,0,0.049,163,75,126,28,8,8,191,83,134,16,201,217,408,40,7,4,49,2,18,2,31,47,53,20,33
31,Nebraska/NE,3100200,"Northeast Nebraska PUMA, Nebraska/NE",31043,"Dakota County, Nebraska",20317,2192,44,10789,217,0.112,373,172,288,63,18,18,436,190,306,36,460,496,932,40,7,4,49,2,18,2,31,47,53,20,33
31,Nebraska/NE,3100200,"Northeast Nebraska PUMA, Nebraska/NE",31051,"Dixon County, Nebraska",5746,87,2,1514,35,0.032,107,49,82,18,5,5,125,54,87,10,131,141,266,40,7,4,49,2,18,2,31,47,53,20,33
31,Nebraska/NE,3100200,"Northeast Nebraska PUMA, Nebraska/NE",31107,"Knox County, Nebraska",8460,160,0,1891,0,0.047,157,72,121,27,8,8,184,80,129,16,193,209,393,40,7,4,49,2,18,2,31,47,53,20,33
31,Nebraska/NE,3100200,"Northeast Nebraska PUMA, Nebraska/NE",31119,"Madison County, Nebraska",35164,860,7,2446,20,0.192,640,295,493,109,31,31,749,326,524,62,788,850,1599,40,7,4,49,2,18,2,31,47,53,20,33
31,Nebraska/NE,3100200,"Northeast Nebraska PUMA, Nebraska/NE",31125,"Nance County, Nebraska",3554,46,0,1294,0,0.02,67,31,51,11,3,3,78,34,54,6,82,88,166,40,7,4,49,2,19,2,31,47,53,20,33
31,Nebraska/NE,3100200,"Northeast Nebraska PUMA, Nebraska/NE",31139,"Pierce County, Nebraska",7157,103,8,1439,112,0.039,130,60,100,22,6,6,152,66,106,12,160,172,324,40,7,4,49,2,19,2,31,47,53,20,33
31,Nebraska/NE,3100200,"Northeast Nebraska PUMA, Nebraska/NE",31141,"Platte County, Nebraska",33063,1069,3,3233,9,0.18,600,276,463,102,30,29,702,306,492,59,739,798,1500,40,7,4,49,2,18,2,31,47,53,20,33
31,Nebraska/NE,3100200,"Northeast Nebraska PUMA, Nebraska/NE",31167,"Stanton County, Nebraska",5992,39,0,651,0,0.033,110,51,85,19,5,5,129,56,90,10,136,146,275,40,7,4,49,2,19,2,31,47,53,20,33
31,Nebraska/NE,3100200,"Northeast Nebraska PUMA, Nebraska/NE",31173,"Thurston County, Nebraska",7140,256,4,3585,56,0.039,130,60,100,22,6,6,152,66,106,12,160,172,324,40,7,4,49,2,19,2,31,47,53,20,33
31,Nebraska/NE,3100200,"Northeast Nebraska PUMA, Nebraska/NE",31179,"Wayne County, Nebraska",9367,139,0,1484,0,0.051,170,78,131,29,8,8,199,86,139,16,209,225,424,40,7,4,49,2,18,2,31,47,53,20,33
31,Nebraska/NE,3100300,"Central Nebraska PUMA, Nebraska/NE",31009,"Blaine County, Nebraska",480,1,0,208,0,0.004,9,3,6,2,0,1,11,3,7,1,9,10,21,43,10,5,43,0,14,5,29,52,48,14,33
31,Nebraska/NE,3100300,"Central Nebraska PUMA, Nebraska/NE",31041,"Custer County, Nebraska",10830,84,4,776,37,0.099,227,63,142,39,0,13,266,63,155,13,205,218,484,47,8,3,42,0,13,3,29,55,45,13,32
31,Nebraska/NE,3100300,"Central Nebraska PUMA, Nebraska/NE",31071,"Garfield County, Nebraska",1975,10,0,506,0,0.018,41,12,26,7,0,2,48,12,28,2,38,40,88,47,8,2,43,0,14,2,30,55,45,14,32
31,Nebraska/NE,3100300,"Central Nebraska PUMA, Nebraska/NE",31077,"Greeley County, Nebraska",2410,27,0,1120,0,0.022,50,14,32,9,0,3,59,14,35,3,46,49,108,46,8,3,43,0,13,3,30,55,45,13,32
31,Nebraska/NE,3100300,"Central Nebraska PUMA, Nebraska/NE",31079,"Hall County, Nebraska",61343,2003,47,3265,77,0.564,1291,362,812,221,0,74,1512,362,886,74,1174,1248,2760,47,8,3,43,0,13,3,29,55,45,13,32
31,Nebraska/NE,3100300,"Central Nebraska PUMA, Nebraska/NE",31081,"Hamilton County, Nebraska",9178,132,13,1438,142,0.084,192,54,121,33,0,11,225,54,132,11,175,186,411,47,8,3,43,0,13,3,29,55,45,13,32
31,Nebraska/NE,3100300,"Central Nebraska PUMA, Nebraska/NE",31093,"Howard County, Nebraska",6405,95,5,1483,78,0.059,135,38,85,23,0,8,158,38,93,8,123,131,289,47,8,3,43,0,13,3,29,55,45,13,32
31,Nebraska/NE,3100300,"Central Nebraska PUMA, Nebraska/NE",31115,"Loup County, Nebraska",585,3,0,513,0,0.005,11,3,7,2,0,1,13,3,8,1,10,11,24,46,8,4,42,0,12,4,29,54,46,12,33
31,Nebraska/NE,3100300,"Central Nebraska PUMA, Nebraska/NE",31121,"Merrick County, Nebraska",7803,80,1,1025,13,0.072,165,46,104,28,0,10,193,46,114,10,150,160,353,47,8,3,42,0,13,3,29,55,45,13,32
31,Nebraska/NE,3100300,"Central Nebraska PUMA, Nebraska/NE",31163,"Sherman County, Nebraska",3042,24,1,789,33,0.028,64,18,40,11,0,4,75,18,44,4,58,62,137,47,8,3,42,0,13,3,29,55,45,13,32
31,Nebraska/NE,3100300,"Central Nebraska PUMA, Nebraska/NE",31175,"Valley County, Nebraska",4224,37,0,876,0,0.038,87,24,55,15,0,5,102,24,60,5,79,84,186,47,8,3,42,0,13,3,30,55,45,13,32
31,Nebraska/NE,3100300,"Central Nebraska PUMA, Nebraska/NE",31183,"Wheeler County, Nebraska",822,1,0,122,0,0.007,16,4,10,3,0,1,19,4,11,1,14,15,34,47,9,3,41,0,12,3,29,56,44,12,32
31,Nebraska/NE,3100400,"Southwest Nebraska PUMA, Nebraska/NE",31005,"Arthur County, Nebraska",418,1,0,239,0,0.005,8,4,4,1,0,4,9,4,8,4,8,12,21,38,5,19,38,0,19,19,19,43,57,19,38
31,Nebraska/NE,3100400,"Southwest Nebraska PUMA, Nebraska/NE",31029,"Chase County, Nebraska",3734,23,0,616,0,0.038,61,27,33,11,0,29,72,27,62,29,60,89,161,38,7,18,37,0,17,18,20,45,55,17,39
31,Nebraska/NE,3100400,"Southwest Nebraska PUMA, Nebraska/NE",31047,"Dawson County, Nebraska",23804,1075,12,4516,50,0.228,363,164,199,66,0,173,429,164,372,173,363,536,965,38,7,18,38,0,17,18,21,44,56,17,39
31,Nebraska/NE,3100400,"Southwest Nebraska PUMA, Nebraska/NE",31057,"Dundy County, Nebraska",2023,11,1,544,49,0.018,29,13,16,5,0,14,34,13,30,14,29,43,77,38,6,18,38,0,17,18,21,44,56,17,39
31,Nebraska/NE,3100400,"Southwest Nebraska PUMA, Nebraska/NE",31063,"Frontier County, Nebraska",2609,7,0,268,0,0.025,40,18,22,7,0,19,47,18,41,19,40,59,106,38,7,18,38,0,17,18,21,44,56,17,39
31,Nebraska/NE,3100400,"Southwest Nebraska PUMA, Nebraska/NE",31065,"Furnas County, Nebraska",4786,39,1,815,21,0.046,73,33,40,13,0,35,86,33,75,35,73,108,194,38,7,18,38,0,17,18,21,44,56,17,39
31,Nebraska/NE,3100400,"Southwest Nebraska PUMA, Nebraska/NE",31073,"Gosper County, Nebraska",2015,34,0,1687,0,0.019,30,14,17,5,0,14,35,14,31,14,31,45,80,38,6,18,39,0,18,18,21,44,56,18,39
31,Nebraska/NE,3100400,"Southwest Nebraska PUMA, Nebraska/NE",31075,"Grant County, Nebraska",718,1,0,139,0,0.006,10,4,5,2,0,5,12,4,10,5,9,14,26,38,8,19,35,0,15,19,19,46,54,15,38
31,Nebraska/NE,3100400,"Southwest Nebraska PUMA, Nebraska/NE",31087,"Hitchcock County, Nebraska",2843,4,0,141,0,0.027,43,19,24,8,0,20,51,19,44,20,43,63,114,38,7,18,38,0,17,18,21,45,55,17,39
31,Nebraska/NE,3100400,"Southwest Nebraska PUMA, Nebraska/NE",31091,"Hooker County, Nebraska",691,7,0,1013,0,0.007,11,5,6,2,0,5,13,5,11,5,11,16,29,38,7,17,38,0,17,17,21,45,55,17,38
31,Nebraska/NE,3100400,"Southwest Nebraska PUMA, Nebraska/NE",31101,"Keith County, Nebraska",8099,64,0,790,0,0.077,123,55,67,22,0,58,145,55,125,58,122,180,325,38,7,18,38,0,17,18,21,45,55,17,38
31,Nebraska/NE,3100400,"Southwest Nebraska PUMA, Nebraska/NE",31111,"Lincoln County, Nebraska",35433,368,2,1039,6,0.343,547,247,299,99,0,260,646,247,559,260,546,806,1452,38,7,18,38,0,17,18,21,44,56,17,38
31,Nebraska/NE,3100400,"Southwest Nebraska PUMA, Nebraska/NE",31113,"Logan County, Nebraska",886,6,0,677,0,0.007,11,5,6,2,0,5,13,5,11,5,11,16,29,38,7,17,38,0,17,17,21,45,55,17,38
31,Nebraska/NE,3100400,"Southwest Nebraska PUMA, Nebraska/NE",31117,"McPherson County, Nebraska",454,6,0,1322,0,0.005,8,4,4,1,0,4,9,4,8,4,8,12,21,38,5,19,38,0,19,19,19,43,57,19,38
31,Nebraska/NE,3100400,"Southwest Nebraska PUMA, Nebraska/NE",31135,"Perkins County, Nebraska",2907,33,10,1135,344,0.028,45,20,24,8,0,21,53,20,45,21,44,65,118,38,7,18,37,0,17,18,20,45,55,17,38
31,Nebraska/NE,3100400,"Southwest Nebraska PUMA, Nebraska/NE",31145,"Red Willow County, Nebraska",10806,33,0,305,0,0.104,166,75,91,30,0,79,196,75,170,79,166,245,441,38,7,18,38,0,17,18,21,44,56,17,39
31,Nebraska/NE,3100400,"Southwest Nebraska PUMA, Nebraska/NE",31171,"Thomas County, Nebraska",645,4,0,620,0,0.007,11,5,6,2,0,5,13,5,11,5,11,16,29,38,7,17,38,0,17,17,21,45,55,17,38
31,Nebraska/NE,3100400,"Southwest Nebraska PUMA, Nebraska/NE",31085,"Hayes County, Nebraska",943,NA,NA,NA,NA,0.009,14,6,8,3,0,7,17,6,15,7,14,21,38,37,8,18,37,0,16,18,21,45,55,16,39
31,Nebraska/NE,3100500,"South Central Nebraska PUMA, Nebraska/NE",31001,"Adams County, Nebraska",31583,542,12,1716,38,0.27,461,69,123,14,0,12,475,69,135,12,192,204,679,68,2,2,28,0,10,2,18,70,30,10,20
31,Nebraska/NE,3100500,"South Central Nebraska PUMA, Nebraska/NE",31019,"Buffalo County, Nebraska",49030,1043,4,2127,8,0.421,719,108,191,22,0,19,741,108,210,19,299,318,1059,68,2,2,28,0,10,2,18,70,30,10,20
31,Nebraska/NE,3100500,"South Central Nebraska PUMA, Nebraska/NE",31035,"Clay County, Nebraska",6232,72,0,1155,0,0.052,89,13,24,3,0,2,92,13,26,2,37,39,131,68,2,2,28,0,10,2,18,70,30,10,20
31,Nebraska/NE,3100500,"South Central Nebraska PUMA, Nebraska/NE",31061,"Franklin County, Nebraska",3006,28,0,931,0,0.026,44,7,12,1,0,1,45,7,13,1,19,20,65,68,2,2,29,0,11,2,18,69,31,11,20
31,Nebraska/NE,3100500,"South Central Nebraska PUMA, Nebraska/NE",31083,"Harlan County, Nebraska",3438,21,0,611,0,0.03,51,8,14,2,0,1,53,8,15,1,22,23,76,67,3,1,29,0,11,1,18,70,30,11,20
31,Nebraska/NE,3100500,"South Central Nebraska PUMA, Nebraska/NE",31099,"Kearney County, Nebraska",6552,140,0,2137,0,0.056,96,14,25,3,0,3,99,14,28,3,39,42,141,68,2,2,28,0,10,2,18,70,30,10,20
31,Nebraska/NE,3100500,"South Central Nebraska PUMA, Nebraska/NE",31129,"Nuckolls County, Nebraska",4275,16,0,374,0,0.036,62,9,16,2,0,2,64,9,18,2,25,27,91,68,2,2,27,0,10,2,18,70,30,10,20
31,Nebraska/NE,3100500,"South Central Nebraska PUMA, Nebraska/NE",31137,"Phelps County, Nebraska",9120,106,0,1162,0,0.079,135,20,36,4,0,4,139,20,40,4,56,60,199,68,2,2,28,0,10,2,18,70,30,10,20
31,Nebraska/NE,3100500,"South Central Nebraska PUMA, Nebraska/NE",31181,"Webster County, Nebraska",3571,16,0,448,0,0.031,53,8,14,2,0,1,55,8,15,1,22,23,78,68,3,1,28,0,10,1,18,71,29,10,19
31,Nebraska/NE,3100600,"Southeast Nebraska PUMA, Nebraska/NE",31023,"Butler County, Nebraska",8067,113,1,1401,12,0.059,137,9,27,14,3,1,151,12,28,4,36,40,191,72,7,2,19,2,5,1,14,79,21,6,15
31,Nebraska/NE,3100600,"Southeast Nebraska PUMA, Nebraska/NE",31059,"Fillmore County, Nebraska",5574,55,1,987,18,0.042,98,7,19,10,2,0,108,9,19,2,26,28,136,72,7,1,19,1,5,0,14,79,21,7,14
31,Nebraska/NE,3100600,"Southeast Nebraska PUMA, Nebraska/NE",31067,"Gage County, Nebraska",21595,239,5,1107,23,0.159,370,25,72,38,9,2,408,34,74,11,97,108,516,72,7,2,19,2,5,0,14,79,21,7,14
31,Nebraska/NE,3100600,"Southeast Nebraska PUMA, Nebraska/NE",31095,"Jefferson County, Nebraska",7188,29,0,403,0,0.052,121,8,24,12,3,1,133,11,25,4,32,36,169,72,7,2,19,2,5,1,14,79,21,7,15
31,Nebraska/NE,3100600,"Southeast Nebraska PUMA, Nebraska/NE",31097,"Johnson County, Nebraska",5197,46,0,885,0,0.038,88,6,17,9,2,0,97,8,17,2,23,25,122,72,7,2,19,2,5,0,14,80,20,7,14
31,Nebraska/NE,3100600,"Southeast Nebraska PUMA, Nebraska/NE",31127,"Nemaha County, Nebraska",7004,122,0,1742,0,0.051,119,8,23,12,3,1,131,11,24,4,31,35,166,72,7,2,19,2,5,1,14,79,21,7,14
31,Nebraska/NE,3100600,"Southeast Nebraska PUMA, Nebraska/NE",31131,"Otoe County, Nebraska",15896,146,1,918,6,0.117,272,18,53,28,7,1,300,25,54,8,71,79,379,72,7,2,19,2,5,0,14,79,21,7,14
31,Nebraska/NE,3100600,"Southeast Nebraska PUMA, Nebraska/NE",31133,"Pawnee County, Nebraska",2676,19,0,710,0,0.019,44,3,9,5,1,0,49,4,9,1,12,13,62,71,8,2,19,2,5,0,15,79,21,6,15
31,Nebraska/NE,3100600,"Southeast Nebraska PUMA, Nebraska/NE",31143,"Polk County, Nebraska",5255,57,1,1085,19,0.038,88,6,17,9,2,0,97,8,17,2,23,25,122,72,7,2,19,2,5,0,14,80,20,7,14
31,Nebraska/NE,3100600,"Southeast Nebraska PUMA, Nebraska/NE",31147,"Richardson County, Nebraska",8009,53,1,662,12,0.059,137,9,27,14,3,1,151,12,28,4,36,40,191,72,7,2,19,2,5,1,14,79,21,6,15
31,Nebraska/NE,3100600,"Southeast Nebraska PUMA, Nebraska/NE",31151,"Saline County, Nebraska",14288,723,2,5060,14,0.104,242,16,47,25,6,1,267,22,48,7,63,70,337,72,7,2,19,2,5,0,14,79,21,7,14
31,Nebraska/NE,3100600,"Southeast Nebraska PUMA, Nebraska/NE",31159,"Seward County, Nebraska",17127,223,3,1302,18,0.126,293,20,57,30,7,1,323,27,58,8,77,85,408,72,7,2,19,2,5,0,14,79,21,7,14
31,Nebraska/NE,3100600,"Southeast Nebraska PUMA, Nebraska/NE",31169,"Thayer County, Nebraska",5098,31,0,608,0,0.037,86,6,17,9,2,0,95,8,17,2,23,25,120,72,8,2,19,2,5,0,14,79,21,7,14
31,Nebraska/NE,3100600,"Southeast Nebraska PUMA, Nebraska/NE",31185,"York County, Nebraska",13799,162,2,1174,14,0.1,233,16,45,24,6,1,257,22,46,7,61,68,325,72,7,2,19,2,5,0,14,79,21,7,14
31,Nebraska/NE,3100701,"Dodge, Cass, Saunders & Washington Counties PUMA, Nebraska/NE",31025,"Cass County, Nebraska",25702,325,2,1264,8,0.247,371,27,42,27,24,0,398,51,42,24,69,93,491,76,5,5,14,5,5,0,9,81,19,10,9
31,Nebraska/NE,3100701,"Dodge, Cass, Saunders & Washington Counties PUMA, Nebraska/NE",31053,"Dodge County, Nebraska",36683,1153,12,3143,33,0.353,531,39,60,39,34,0,570,73,60,34,99,133,703,76,6,5,14,5,6,0,9,81,19,10,9
31,Nebraska/NE,3100701,"Dodge, Cass, Saunders & Washington Counties PUMA, Nebraska/NE",31155,"Saunders County, Nebraska",21024,456,3,2169,14,0.202,304,22,35,22,20,0,326,42,35,20,57,77,403,75,5,5,14,5,5,0,9,81,19,10,9
31,Nebraska/NE,3100701,"Dodge, Cass, Saunders & Washington Counties PUMA, Nebraska/NE",31177,"Washington County, Nebraska",20219,262,4,1296,20,0.198,298,22,34,22,19,0,320,41,34,19,56,75,395,75,6,5,14,5,6,0,9,81,19,10,9
31,Nebraska/NE,3100702,"Sarpy County--Bellevue City PUMA, Nebraska/NE",31153,"Sarpy County, Nebraska",178351,3547,26,1989,15,1,629,33,222,68,172,13,697,205,235,185,255,440,1137,55,6,16,22,15,3,1,20,61,39,18,21
31,Nebraska/NE,3100801,"Lancaster County--Lincoln City (North) PUMA, Nebraska/NE",31109,"Lancaster County, Nebraska",310094,6137,24,1979,8,1,353,0,99,241,308,195,594,308,294,503,99,602,1196,30,20,42,8,26,0,16,8,50,50,26,25
31,Nebraska/NE,3100802,"Lancaster County--Lincoln City (South) PUMA, Nebraska/NE",31109,"Lancaster County, Nebraska",310094,6137,24,1979,8,1,349,91,156,2,387,42,351,478,198,429,247,676,1027,34,0,42,24,38,9,4,15,34,66,47,19
31,Nebraska/NE,3100901,"Douglas County--Omaha City (Northwest) PUMA, Nebraska/NE",31055,"Douglas County, Nebraska",554992,15702,193,2829,35,1,308,0,252,24,0,185,332,0,437,185,252,437,769,40,3,24,33,0,0,24,33,43,57,0,57
31,Nebraska/NE,3100902,"Douglas County--Omaha City (Southwest) PUMA, Nebraska/NE",31055,"Douglas County, Nebraska",554992,15702,193,2829,35,1,689,26,76,92,129,17,781,155,93,146,102,248,1029,67,9,14,10,13,3,2,7,76,24,15,9
31,Nebraska/NE,3100903,"Douglas County--Omaha City (Northeast) PUMA, Nebraska/NE",31055,"Douglas County, Nebraska",554992,15702,193,2829,35,1,489,44,218,55,238,979,544,282,1197,1217,262,1479,2023,24,3,60,13,12,2,48,11,27,73,14,59
31,Nebraska/NE,3100904,"Douglas County--Omaha City (Southeast) PUMA, Nebraska/NE",31055,"Douglas County, Nebraska",554992,15702,193,2829,35,1,530,675,1371,537,0,14,1067,675,1385,14,2046,2060,3127,17,17,0,65,0,22,0,44,34,66,22,44
32,Nevada/NV,3200101,"Washoe County (South Central)--Reno City PUMA, Nevada/NV",32031,"Washoe County, Nevada",450486,9172,155,2036,34,1,207,0,81,193,42,42,400,42,123,84,81,165,565,37,34,15,14,7,0,7,14,71,29,7,22
32,Nevada/NV,3200102,"Washoe County (South) PUMA, Nevada/NV",32031,"Washoe County, Nevada",450486,9172,155,2036,34,1,54,0,113,50,0,0,104,0,113,0,113,113,217,25,23,0,52,0,0,0,52,48,52,0,52
32,Nevada/NV,3200103,"Washoe County (North)--Sparks City PUMA, Nevada/NV",32031,"Washoe County, Nevada",450486,9172,155,2036,34,1,201,0,261,103,0,0,304,0,261,0,261,261,565,36,18,0,46,0,0,0,46,54,46,0,46
32,Nevada/NV,3200200,"Carson City, Lyon, Douglas & Storey Counties PUMA, Nevada/NV",32005,"Douglas County, Nevada",47828,298,1,623,2,0.3,91,6,58,23,0,0,114,6,58,0,64,64,178,51,13,0,36,0,3,0,33,64,36,3,33
32,Nevada/NV,3200200,"Carson City, Lyon, Douglas & Storey Counties PUMA, Nevada/NV",32019,"Lyon County, Nevada",53155,434,7,816,13,0.332,101,6,65,26,0,0,127,6,65,0,71,71,198,51,13,0,36,0,3,0,33,64,36,3,33
32,Nevada/NV,3200200,"Carson City, Lyon, Douglas & Storey Counties PUMA, Nevada/NV",32029,"Storey County, Nevada",3941,10,0,254,0,0.025,8,0,5,2,0,0,10,0,5,0,5,5,15,53,13,0,33,0,0,0,33,67,33,0,33
32,Nevada/NV,3200200,"Carson City, Lyon, Douglas & Storey Counties PUMA, Nevada/NV",32510,"Carson City, Nevada",54467,536,8,984,15,0.342,104,6,67,27,0,0,131,6,67,0,73,73,204,51,13,0,36,0,3,0,33,64,36,3,33
32,Nevada/NV,3200300,"Rural Nevada PUMA, Nevada/NV",32001,"Churchill County, Nevada",24010,140,3,583,12,0.142,71,6,135,16,1,8,87,7,143,9,141,150,237,30,7,4,59,0,3,3,57,37,63,3,60
32,Nevada/NV,3200300,"Rural Nevada PUMA, Nevada/NV",32007,"Elko County, Nevada",52252,945,10,1809,19,0.305,153,12,289,34,3,16,187,15,305,19,301,320,507,30,7,4,59,1,2,3,57,37,63,3,60
32,Nevada/NV,3200300,"Rural Nevada PUMA, Nevada/NV",32011,"Eureka County, Nevada",1830,10,0,546,0,0.011,6,0,10,1,0,1,7,0,11,1,10,11,18,33,6,6,56,0,0,6,56,39,61,0,61
32,Nevada/NV,3200300,"Rural Nevada PUMA, Nevada/NV",32013,"Humboldt County, Nevada",16904,121,4,716,24,0.099,50,4,94,11,1,5,61,5,99,6,98,104,165,30,7,4,59,1,2,3,57,37,63,3,60
32,Nevada/NV,3200300,"Rural Nevada PUMA, Nevada/NV",32015,"Lander County, Nevada",5746,70,1,1218,17,0.033,17,1,31,4,0,2,21,1,33,2,32,34,55,31,7,4,58,0,2,4,56,38,62,2,60
32,Nevada/NV,3200300,"Rural Nevada PUMA, Nevada/NV",32017,"Lincoln County, Nevada",5174,7,0,135,0,0.03,15,1,28,3,0,2,18,1,30,2,29,31,49,31,6,4,59,0,2,4,57,37,63,2,61
32,Nevada/NV,3200300,"Rural Nevada PUMA, Nevada/NV",32021,"Mineral County, Nevada",4448,13,0,292,0,0.026,13,1,25,3,0,1,16,1,26,1,26,27,43,30,7,2,60,0,2,2,58,37,63,2,60
32,Nevada/NV,3200300,"Rural Nevada PUMA, Nevada/NV",32023,"Nye County, Nevada",43705,510,15,1167,34,0.254,128,10,241,29,2,13,157,12,254,15,251,266,423,30,7,4,59,0,2,3,57,37,63,3,60
32,Nevada/NV,3200300,"Rural Nevada PUMA, Nevada/NV",32027,"Pershing County, Nevada",6611,21,0,318,0,0.038,19,2,36,4,0,2,23,2,38,2,38,40,63,30,6,3,60,0,3,3,57,37,63,3,60
32,Nevada/NV,3200300,"Rural Nevada PUMA, Nevada/NV",32033,"White Pine County, Nevada",9737,60,1,616,10,0.057,29,2,54,6,1,3,35,3,57,4,56,60,95,31,6,4,59,1,2,3,57,37,63,3,60
32,Nevada/NV,3200300,"Rural Nevada PUMA, Nevada/NV",32009,"Esmeralda County, Nevada",981,NA,NA,NA,NA,0.005,3,0,5,1,0,0,4,0,5,0,5,5,9,33,11,0,56,0,0,0,56,44,56,0,56
32,Nevada/NV,3200401,"Clark County (Northwest Central)--Northwest Las Vegas Valley PUMA, Nevada/NV",32003,"Clark County, Nevada",2141574,65583,1368,3062,64,1,155,0,0,0,0,0,155,0,0,0,0,0,155,100,0,0,0,0,0,0,0,100,0,0,0
32,Nevada/NV,3200402,"Clark County (North)--Las Vegas (Northeast) & North Las Vegas (Outer) Cities PUMA, Nevada/NV",32003,"Clark County, Nevada",2141574,65583,1368,3062,64,1,24,0,94,0,0,0,24,0,94,0,94,94,118,20,0,0,80,0,0,0,80,20,80,0,80
32,Nevada/NV,3200403,"Clark County (Central)--Greater North Las Vegas City PUMA, Nevada/NV",32003,"Clark County, Nevada",2141574,65583,1368,3062,64,1,72,13,196,19,0,0,91,13,196,0,209,209,300,24,6,0,70,0,4,0,65,30,70,4,65
32,Nevada/NV,3200404,"Clark County (East)--Mesquite City, Sunrise Manor (North), Moapa Valley & Nellis AFB PUMA, Nevada/NV",32003,"Clark County, Nevada",2141574,65583,1368,3062,64,1,189,0,44,17,0,0,206,0,44,0,44,44,250,76,7,0,18,0,0,0,18,82,18,0,18
32,Nevada/NV,3200405,"Las Vegas City (Southeast) PUMA, Nevada/NV",32003,"Clark County, Nevada",2141574,65583,1368,3062,64,1,56,11,136,87,0,0,143,11,136,0,147,147,290,19,30,0,51,0,4,0,47,49,51,4,47
32,Nevada/NV,3200406,"Las Vegas City (South Central) PUMA, Nevada/NV",32003,"Clark County, Nevada",2141574,65583,1368,3062,64,1,29,13,38,48,11,15,77,24,53,26,51,77,154,19,31,17,33,7,8,10,25,50,50,16,34
32,Nevada/NV,3200407,"Clark County (West)--Las Vegas City (Southwest) PUMA, Nevada/NV",32003,"Clark County, Nevada",2141574,65583,1368,3062,64,1,18,0,0,0,20,0,18,20,0,20,0,20,38,47,0,53,0,53,0,0,0,47,53,53,0
32,Nevada/NV,3200408,"Clark County (Central)--Spring Valley & Summerlin South PUMA, Nevada/NV",32003,"Clark County, Nevada",2141574,65583,1368,3062,64,1,0,26,41,0,0,0,0,26,41,0,67,67,67,0,0,0,100,0,39,0,61,0,100,39,61
32,Nevada/NV,3200409,"Clark County (Central)--Paradise (Northwest) & Winchester PUMA, Nevada/NV",32003,"Clark County, Nevada",2141574,65583,1368,3062,64,1,16,15,32,24,0,18,40,15,50,18,47,65,105,15,23,17,45,0,14,17,30,38,62,14,48
32,Nevada/NV,3200410,"Clark County (Central)--Whitney, Sunrise Manor (South) & Paradise (Northeast) PUMA, Nevada/NV",32003,"Clark County, Nevada",2141574,65583,1368,3062,64,1,70,56,38,49,0,25,119,56,63,25,94,119,238,29,21,11,39,0,24,11,16,50,50,24,26
32,Nevada/NV,3200411,"Clark County (Central)--Henderson City (West) PUMA, Nevada/NV",32003,"Clark County, Nevada",2141574,65583,1368,3062,64,1,117,17,0,14,0,0,131,17,0,0,17,17,148,79,9,0,11,0,11,0,0,89,11,11,0
32,Nevada/NV,3200412,"Clark County (South)--Henderson (East) & Boulder Cities PUMA, Nevada/NV",32003,"Clark County, Nevada",2141574,65583,1368,3062,64,1,146,15,7,96,0,0,242,15,7,0,22,22,264,55,36,0,8,0,6,0,3,92,8,6,3
32,Nevada/NV,3200413,"Clark County (Central)--Paradise (South) & Enterprise PUMA, Nevada/NV",32003,"Clark County, Nevada",2141574,65583,1368,3062,64,1,18,38,7,37,0,76,55,38,83,76,45,121,176,10,21,43,26,0,22,43,4,31,69,22,47
33,New Hampshire/NH,3300100,"Northern New Hampshire--Grafton & Coos Counties PUMA, New Hampshire/NH",33007,"Coos County, New Hampshire",32038,22,0,69,0,0.265,83,0,0,0,20,0,83,20,0,20,0,20,103,81,0,19,0,19,0,0,0,81,19,19,0
33,New Hampshire/NH,3300100,"Northern New Hampshire--Grafton & Coos Counties PUMA, New Hampshire/NH",33009,"Grafton County, New Hampshire",89811,138,1,154,1,0.735,229,0,0,0,54,0,229,54,0,54,0,54,283,81,0,19,0,19,0,0,0,81,19,19,0
33,New Hampshire/NH,3300200,"Lakes Region--Belknap, Carroll & Merrimack (Northern) Counties PUMA, New Hampshire/NH",33001,"Belknap County, New Hampshire",60640,147,4,242,7,0.493,90,0,0,1,0,0,91,0,0,0,0,0,91,99,1,0,0,0,0,0,0,100,0,0,0
33,New Hampshire/NH,3300200,"Lakes Region--Belknap, Carroll & Merrimack (Northern) Counties PUMA, New Hampshire/NH",33003,"Carroll County, New Hampshire",47840,123,2,257,4,0.337,62,0,0,1,0,0,63,0,0,0,0,0,63,98,2,0,0,0,0,0,0,100,0,0,0
33,New Hampshire/NH,3300200,"Lakes Region--Belknap, Carroll & Merrimack (Northern) Counties PUMA, New Hampshire/NH",33013,"Merrimack County, New Hampshire",149452,569,23,381,15,0.17,31,0,0,0,0,0,31,0,0,0,0,0,31,100,0,0,0,0,0,0,0,100,0,0,0
33,New Hampshire/NH,3300300,"Strafford Region--Strafford, Rockingham (Northern) & Carroll (Southeastern) Counties PUMA, New Hampshire/NH",33003,"Carroll County, New Hampshire",47840,123,2,257,4,0.037,12,0,0,0,0,0,12,0,0,0,0,0,12,100,0,0,0,0,0,0,0,100,0,0,0
33,New Hampshire/NH,3300300,"Strafford Region--Strafford, Rockingham (Northern) & Carroll (Southeastern) Counties PUMA, New Hampshire/NH",33015,"Rockingham County, New Hampshire",305129,2003,103,656,34,0.132,41,0,0,0,0,0,41,0,0,0,0,0,41,100,0,0,0,0,0,0,0,100,0,0,0
33,New Hampshire/NH,3300300,"Strafford Region--Strafford, Rockingham (Northern) & Carroll (Southeastern) Counties PUMA, New Hampshire/NH",33017,"Strafford County, New Hampshire",128237,538,13,420,10,0.831,260,0,0,0,0,0,260,0,0,0,0,0,260,100,0,0,0,0,0,0,0,100,0,0,0
33,New Hampshire/NH,3300400,"Central New Hampshire--Merrimack County (Central)--Concord City PUMA, New Hampshire/NH",33013,"Merrimack County, New Hampshire",149452,569,23,381,15,1,271,0,0,0,16,94,271,16,94,110,0,110,381,71,0,29,0,4,0,25,0,71,29,4,25
33,New Hampshire/NH,3300500,"Southwestern New Hampshire--Cheshire & Sullivan Counties PUMA, New Hampshire/NH",33005,"Cheshire County, New Hampshire",76263,143,3,188,4,0.638,143,0,0,0,8,0,143,8,0,8,0,8,151,95,0,5,0,5,0,0,0,95,5,5,0
33,New Hampshire/NH,3300500,"Southwestern New Hampshire--Cheshire & Sullivan Counties PUMA, New Hampshire/NH",33019,"Sullivan County, New Hampshire",43125,53,1,123,2,0.362,81,0,0,0,5,0,81,5,0,5,0,5,86,94,0,6,0,6,0,0,0,94,6,6,0
33,New Hampshire/NH,3300600,"Hillsborough County (Western) PUMA, New Hampshire/NH",33011,"Hillsborough County, New Hampshire",411087,4345,288,1057,70,1,143,0,0,0,0,0,143,0,0,0,0,0,143,100,0,0,0,0,0,0,0,100,0,0,0
33,New Hampshire/NH,3300700,"Outer Manchester City PUMA, New Hampshire/NH",33011,"Hillsborough County, New Hampshire",411087,4345,288,1057,70,0.347,85,0,19,0,0,0,85,0,19,0,19,19,104,82,0,0,18,0,0,0,18,82,18,0,18
33,New Hampshire/NH,3300700,"Outer Manchester City PUMA, New Hampshire/NH",33013,"Merrimack County, New Hampshire",149452,569,23,381,15,0.088,22,0,5,0,0,0,22,0,5,0,5,5,27,81,0,0,19,0,0,0,19,81,19,0,19
33,New Hampshire/NH,3300700,"Outer Manchester City PUMA, New Hampshire/NH",33015,"Rockingham County, New Hampshire",305129,2003,103,656,34,0.565,139,0,32,0,0,0,139,0,32,0,32,32,171,81,0,0,19,0,0,0,19,81,19,0,19
33,New Hampshire/NH,3300800,"Manchester City PUMA, New Hampshire/NH",33011,"Hillsborough County, New Hampshire",411087,4345,288,1057,70,1,181,9,137,16,0,141,197,9,278,141,146,287,484,37,3,29,30,0,2,29,28,41,59,2,57
33,New Hampshire/NH,3300900,"Hillsborough County (Southeastern)--Greater Nashua City PUMA, New Hampshire/NH",33011,"Hillsborough County, New Hampshire",411087,4345,288,1057,70,1,34,0,0,33,0,0,67,0,0,0,0,0,67,51,49,0,0,0,0,0,0,100,0,0,0
33,New Hampshire/NH,3301000,"Seacoast Region--Rockingham County (Southern)--Portsmouth City PUMA, New Hampshire/NH",33015,"Rockingham County, New Hampshire",305129,2003,103,656,34,1,119,57,0,0,35,30,119,92,30,65,57,122,241,49,0,27,24,15,24,12,0,49,51,38,12
34,New Jersey/NJ,3400101,"Atlantic County (East)--Atlantic City & Ventnor City PUMA, New Jersey/NJ",34001,"Atlantic County, New Jersey",268539,4044,256,1506,95,1,37,32,36,108,0,25,145,32,61,25,68,93,238,16,45,11,29,0,13,11,15,61,39,13,26
34,New Jersey/NJ,3400102,"Atlantic County (Outside Somers Point City)--Pleasantville City & Hammonton Town PUMA, New Jersey/NJ",34001,"Atlantic County, New Jersey",268539,4044,256,1506,95,1,283,19,85,13,0,0,296,19,85,0,104,104,400,71,3,0,26,0,5,0,21,74,26,5,21
34,New Jersey/NJ,3400301,"Bergen County (South Central)--Hackensack & Englewood (West) Cities PUMA, New Jersey/NJ",34003,"Bergen County, New Jersey",929999,22574,2044,2427,220,1,44,0,203,81,0,20,125,0,223,20,203,223,348,13,23,6,58,0,0,6,58,36,64,0,64
34,New Jersey/NJ,3400302,"Bergen County (Southwest)--Rutherford, North Arlington & Hasbrouck Heights Boroughs PUMA, New Jersey/NJ",34003,"Bergen County, New Jersey",929999,22574,2044,2427,220,1,39,8,86,0,87,21,39,95,107,108,94,202,241,16,0,45,39,36,3,9,36,16,84,39,44
34,New Jersey/NJ,3400303,"Bergen County (Southeast)--Fort Lee, Cliffside Park & Palisades Park Boroughs PUMA, New Jersey/NJ",34003,"Bergen County, New Jersey",929999,22574,2044,2427,220,1,40,0,313,0,31,63,40,31,376,94,313,407,447,9,0,21,70,7,0,14,70,9,91,7,84
34,New Jersey/NJ,3400304,"Bergen County (West Central)--Fair Lawn Borough, Garfield City & Lodi Borough PUMA, New Jersey/NJ",34003,"Bergen County, New Jersey",929999,22574,2044,2427,220,1,37,23,34,11,17,12,48,40,46,29,57,86,134,28,8,22,43,13,17,9,25,36,64,30,34
34,New Jersey/NJ,3400305,"Bergen County (East)--Tenafly, Park Ridge & Cresskill Boroughs PUMA, New Jersey/NJ",34003,"Bergen County, New Jersey",929999,22574,2044,2427,220,1,21,0,0,0,0,0,21,0,0,0,0,0,21,100,0,0,0,0,0,0,0,100,0,0,0
34,New Jersey/NJ,3400306,"Bergen County (Northwest)--Ramsey, Oakland & Franklin Lakes Boroughs PUMA, New Jersey/NJ",34003,"Bergen County, New Jersey",929999,22574,2044,2427,220,1,0,0,0,0,21,0,0,21,0,21,0,21,21,0,0,100,0,100,0,0,0,0,100,100,0
34,New Jersey/NJ,3400307,"Bergen County (North Central)--Bergenfield, Paramus, Dumont & New Milford Boroughs PUMA, New Jersey/NJ",34003,"Bergen County, New Jersey",929999,22574,2044,2427,220,1,32,12,84,0,20,0,32,32,84,20,96,116,148,22,0,14,65,14,8,0,57,22,78,22,57
34,New Jersey/NJ,3400308,"Bergen County (Central)--Ridgewood Village, Glen Rock & Westwood Boroughs PUMA, New Jersey/NJ",34003,"Bergen County, New Jersey",929999,22574,2044,2427,220,1,83,0,0,14,13,0,97,13,0,13,0,13,110,75,13,12,0,12,0,0,0,88,12,12,0
34,New Jersey/NJ,3400400,"Passaic County (Southeast)--Paterson City PUMA, New Jersey/NJ",34031,"Passaic County, New Jersey",504041,19093,1253,3788,249,1,63,96,582,88,0,54,151,96,636,54,678,732,883,7,10,6,77,0,11,6,66,17,83,11,72
34,New Jersey/NJ,3400501,"Passaic County (South)--Passaic & Clifton (Southeast) Cities PUMA, New Jersey/NJ",34031,"Passaic County, New Jersey",504041,19093,1253,3788,249,1,160,102,572,32,78,0,192,180,572,78,674,752,944,17,3,8,71,8,11,0,61,20,80,19,61
34,New Jersey/NJ,3400502,"Passaic County (Central)--Hawthorne Borough & Clifton City (Northwest) PUMA, New Jersey/NJ",34031,"Passaic County, New Jersey",504041,19093,1253,3788,249,1,79,35,0,28,33,0,107,68,0,33,35,68,175,45,16,19,20,19,20,0,0,61,39,39,0
34,New Jersey/NJ,3400503,"Passaic County (North)--Ringwood, Wanaque & Pompton Lakes Boroughs PUMA, New Jersey/NJ",34031,"Passaic County, New Jersey",504041,19093,1253,3788,249,1,20,0,16,0,0,0,20,0,16,0,16,16,36,56,0,0,44,0,0,0,44,56,44,0,44
34,New Jersey/NJ,3400601,"Hudson County (Central)--Jersey City (North) PUMA, New Jersey/NJ",34017,"Hudson County, New Jersey",668631,20756,1514,3104,226,1,87,35,100,11,0,17,98,35,117,17,135,152,250,35,4,7,54,0,14,7,40,39,61,14,47
34,New Jersey/NJ,3400602,"Hudson County (Central)--Jersey City (South) PUMA, New Jersey/NJ",34017,"Hudson County, New Jersey",668631,20756,1514,3104,226,1,76,0,131,24,0,29,100,0,160,29,131,160,260,29,9,11,50,0,0,11,50,38,62,0,62
34,New Jersey/NJ,3400701,"Hudson County (North)--West New York, Secaucus & Guttenberg Towns PUMA, New Jersey/NJ",34017,"Hudson County, New Jersey",668631,20756,1514,3104,226,1,34,45,322,29,0,0,63,45,322,0,367,367,430,8,7,0,85,0,10,0,75,15,85,10,75
34,New Jersey/NJ,3400702,"Hudson County (Northeast)--Union City & Hoboken Cities PUMA, New Jersey/NJ",34017,"Hudson County, New Jersey",668631,20756,1514,3104,226,1,0,140,181,34,18,0,34,158,181,18,321,339,373,0,9,5,86,5,38,0,49,9,91,42,49
34,New Jersey/NJ,3400703,"Hudson County (South & West)--Bayonne City, Kearney & Harrison Towns PUMA, New Jersey/NJ",34017,"Hudson County, New Jersey",668631,20756,1514,3104,226,1,8,91,205,0,68,56,8,159,261,124,296,420,428,2,0,29,69,16,21,13,48,2,98,37,61
34,New Jersey/NJ,3400800,"Hunterdon County PUMA, New Jersey/NJ",34019,"Hunterdon County, New Jersey",125051,1361,125,1088,100,1,297,0,60,7,51,41,304,51,101,92,60,152,456,65,2,20,13,11,0,9,13,67,33,11,22
34,New Jersey/NJ,3400901,"Middlesex County (Southeast) PUMA, New Jersey/NJ",34023,"Middlesex County, New Jersey",826698,19521,1425,2361,172,1,75,0,0,0,0,0,75,0,0,0,0,0,75,100,0,0,0,0,0,0,0,100,0,0,0
34,New Jersey/NJ,3400902,"Middlesex County (Southwest) PUMA, New Jersey/NJ",34023,"Middlesex County, New Jersey",826698,19521,1425,2361,172,1,25,0,34,0,0,0,25,0,34,0,34,34,59,42,0,0,58,0,0,0,58,42,58,0,58
34,New Jersey/NJ,3400903,"Middlesex County (Northwest)--South Plainfield & Middlesex Boroughs PUMA, New Jersey/NJ",34023,"Middlesex County, New Jersey",826698,19521,1425,2361,172,1,37,17,0,0,15,0,37,32,0,15,17,32,69,54,0,22,25,22,25,0,0,54,46,46,0
34,New Jersey/NJ,3400904,"Middlesex County (North Central)--Metuchen Borough PUMA, New Jersey/NJ",34023,"Middlesex County, New Jersey",826698,19521,1425,2361,172,1,43,16,11,0,40,7,43,56,18,47,27,74,117,37,0,40,23,34,14,6,9,37,63,48,15
34,New Jersey/NJ,3400905,"Middlesex County (Northeast)--Carteret Borough PUMA, New Jersey/NJ",34023,"Middlesex County, New Jersey",826698,19521,1425,2361,172,1,43,0,29,53,9,8,96,9,37,17,29,46,142,30,37,12,20,6,0,6,20,68,32,6,26
34,New Jersey/NJ,3400906,"Middlesex County (Central)--New Brunswick City, South River & Highland Park Boroughs PUMA, New Jersey/NJ",34023,"Middlesex County, New Jersey",826698,19521,1425,2361,172,1,48,16,125,16,0,0,64,16,125,0,141,141,205,23,8,0,69,0,8,0,61,31,69,8,61
34,New Jersey/NJ,3400907,"Middlesex County (East Central)--Perth Amboy City & Sayreville Borough PUMA, New Jersey/NJ",34023,"Middlesex County, New Jersey",826698,19521,1425,2361,172,1,75,131,104,75,0,0,150,131,104,0,235,235,385,19,19,0,61,0,34,0,27,39,61,34,27
34,New Jersey/NJ,3401001,"Somerset County (North & West) PUMA, New Jersey/NJ",34035,"Somerset County, New Jersey",330176,5851,573,1772,174,1,26,0,38,0,11,0,26,11,38,11,38,49,75,35,0,15,51,15,0,0,51,35,65,15,51
34,New Jersey/NJ,3401002,"Somerset County (South) PUMA, New Jersey/NJ",34035,"Somerset County, New Jersey",330176,5851,573,1772,174,1,37,0,0,0,50,0,37,50,0,50,0,50,87,43,0,57,0,57,0,0,0,43,57,57,0
34,New Jersey/NJ,3401003,"Somerset County (Central)--North Plainfield & Somerville Boroughs PUMA, New Jersey/NJ",34035,"Somerset County, New Jersey",330176,5851,573,1772,174,1,32,0,0,0,96,37,32,96,37,133,0,133,165,19,0,81,0,58,0,22,0,19,81,58,22
34,New Jersey/NJ,3401101,"Monmouth County (Southeast)--Tinton Falls Borough (South) PUMA, New Jersey/NJ",34025,"Monmouth County, New Jersey",623387,11818,867,1896,139,1,11,0,14,0,0,0,11,0,14,0,14,14,25,44,0,0,56,0,0,0,56,44,56,0,56
34,New Jersey/NJ,3401102,"Monmouth County (Southwest)--Freehold Borough PUMA, New Jersey/NJ",34025,"Monmouth County, New Jersey",623387,11818,867,1896,139,1,43,12,101,0,0,0,43,12,101,0,113,113,156,28,0,0,72,0,8,0,65,28,72,8,65
34,New Jersey/NJ,3401103,"Monmouth County (East Central)--Long Branch, Asbury Park Cities & Eatontown Borough PUMA, New Jersey/NJ",34025,"Monmouth County, New Jersey",623387,11818,867,1896,139,1,0,0,18,0,0,73,0,0,91,73,18,91,91,0,0,80,20,0,0,80,20,0,100,0,100
34,New Jersey/NJ,3401104,"Monmouth County (Northeast)--Red Bank & Tinton Falls (North) Boroughs PUMA, New Jersey/NJ",34025,"Monmouth County, New Jersey",623387,11818,867,1896,139,1,19,0,108,11,0,0,30,0,108,0,108,108,138,14,8,0,78,0,0,0,78,22,78,0,78
34,New Jersey/NJ,3401105,"Monmouth County (Northwest)--Keansburg Borough PUMA, New Jersey/NJ",34025,"Monmouth County, New Jersey",623387,11818,867,1896,139,1,36,0,13,0,0,0,36,0,13,0,13,13,49,73,0,0,27,0,0,0,27,73,27,0,27
34,New Jersey/NJ,3401106,"Monmouth County (Central) PUMA, New Jersey/NJ",34025,"Monmouth County, New Jersey",623387,11818,867,1896,139,1,11,0,0,0,12,17,11,12,17,29,0,29,40,28,0,72,0,30,0,42,0,28,72,30,42
34,New Jersey/NJ,3401201,"Ocean County (South) PUMA, New Jersey/NJ",34029,"Ocean County, New Jersey",591939,12728,1047,2150,177,1,42,0,1,0,0,0,42,0,1,0,1,1,43,98,0,0,2,0,0,0,2,98,2,0,2
34,New Jersey/NJ,3401202,"Ocean County (Central)--Beachwood Borough PUMA, New Jersey/NJ",34029,"Ocean County, New Jersey",591939,12728,1047,2150,177,1,17,0,57,48,0,0,65,0,57,0,57,57,122,14,39,0,47,0,0,0,47,53,47,0,47
34,New Jersey/NJ,3401203,"Ocean County (North Central) PUMA, New Jersey/NJ",34029,"Ocean County, New Jersey",591939,12728,1047,2150,177,1,30,0,201,17,0,0,47,0,201,0,201,201,248,12,7,0,81,0,0,0,81,19,81,0,81
34,New Jersey/NJ,3401204,"Ocean County (Northwest) PUMA, New Jersey/NJ",34029,"Ocean County, New Jersey",591939,12728,1047,2150,177,1,224,0,20,0,37,0,224,37,20,37,20,57,281,80,0,13,7,13,0,0,7,80,20,13,7
34,New Jersey/NJ,3401205,"Ocean County (Northeast)--Point Pleasant Borough PUMA, New Jersey/NJ",34029,"Ocean County, New Jersey",591939,12728,1047,2150,177,1,51,0,0,0,0,0,51,0,0,0,0,0,51,100,0,0,0,0,0,0,0,100,0,0,0
34,New Jersey/NJ,3401301,"Essex County (Southeast)--Newark City (North & East) PUMA, New Jersey/NJ",34013,"Essex County, New Jersey",793555,21184,2129,2670,268,1,105,116,262,97,12,80,202,128,342,92,378,470,672,16,14,14,56,2,17,12,39,30,70,19,51
34,New Jersey/NJ,3401302,"Essex County (Southeast)--Newark City (Southwest) PUMA, New Jersey/NJ",34013,"Essex County, New Jersey",793555,21184,2129,2670,268,1,129,119,3,26,0,0,155,119,3,0,122,122,277,47,9,0,44,0,43,0,1,56,44,43,1
34,New Jersey/NJ,3401401,"Essex County (Northeast) PUMA, New Jersey/NJ",34013,"Essex County, New Jersey",793555,21184,2129,2670,268,1,64,145,36,35,28,0,99,173,36,28,181,209,308,21,11,9,59,9,47,0,12,32,68,56,12
34,New Jersey/NJ,3401402,"Essex County (South Central)--East Orange City PUMA, New Jersey/NJ",34013,"Essex County, New Jersey",793555,21184,2129,2670,268,1,138,0,51,0,65,0,138,65,51,65,51,116,254,54,0,26,20,26,0,0,20,54,46,26,20
34,New Jersey/NJ,3401403,"Essex County (Northwest) PUMA, New Jersey/NJ",34013,"Essex County, New Jersey",793555,21184,2129,2670,268,1,17,0,0,0,0,0,17,0,0,0,0,0,17,100,0,0,0,0,0,0,0,100,0,0,0
34,New Jersey/NJ,3401404,"Essex County (Southwest) PUMA, New Jersey/NJ",34013,"Essex County, New Jersey",793555,21184,2129,2670,268,1,36,0,0,0,23,0,36,23,0,23,0,23,59,61,0,39,0,39,0,0,0,61,39,39,0
34,New Jersey/NJ,3401501,"Morris County (North)--Dover Town & Kinnelon Borough PUMA, New Jersey/NJ",34027,"Morris County, New Jersey",494383,7966,831,1611,168,1,46,108,149,0,0,0,46,108,149,0,257,257,303,15,0,0,85,0,36,0,49,15,85,36,49
34,New Jersey/NJ,3401502,"Morris County (West) PUMA, New Jersey/NJ",34027,"Morris County, New Jersey",494383,7966,831,1611,168,1,227,21,29,26,0,43,253,21,72,43,50,93,346,66,8,12,14,0,6,12,8,73,27,6,21
34,New Jersey/NJ,3401503,"Morris County (East)--Lincoln Park Borough PUMA, New Jersey/NJ",34027,"Morris County, New Jersey",494383,7966,831,1611,168,1,3,53,0,0,0,13,3,53,13,13,53,66,69,4,0,19,77,0,77,19,0,4,96,77,19
34,New Jersey/NJ,3401504,"Morris County (South)--Morristown Town, Madison & Florham Park Boroughs PUMA, New Jersey/NJ",34027,"Morris County, New Jersey",494383,7966,831,1611,168,1,30,0,30,0,19,0,30,19,30,19,30,49,79,38,0,24,38,24,0,0,38,38,62,24,38
34,New Jersey/NJ,3401600,"Sussex County PUMA, New Jersey/NJ",34037,"Sussex County, New Jersey",142298,1517,198,1066,139,1,204,0,80,0,0,16,204,0,96,16,80,96,300,68,0,5,27,0,0,5,27,68,32,0,32
34,New Jersey/NJ,3401700,"Warren County PUMA, New Jersey/NJ",34041,"Warren County, New Jersey",106293,1448,171,1362,161,1,317,0,191,36,0,0,353,0,191,0,191,191,544,58,7,0,35,0,0,0,35,65,35,0,35
34,New Jersey/NJ,3401800,"Union County (Northeast)--Elizabeth City PUMA, New Jersey/NJ",34039,"Union County, New Jersey",553066,17731,1355,3206,245,1,10,55,606,66,26,0,76,81,606,26,661,687,763,1,9,3,87,3,7,0,79,10,90,11,79
34,New Jersey/NJ,3401901,"Union County (North Central)--Roselle Park Borough PUMA, New Jersey/NJ",34039,"Union County, New Jersey",553066,17731,1355,3206,245,1,58,35,120,21,0,0,79,35,120,0,155,155,234,25,9,0,66,0,15,0,51,34,66,15,51
34,New Jersey/NJ,3401903,"Union County (Southwest)--Plainfield City & Westfield Town (South) PUMA, New Jersey/NJ",34039,"Union County, New Jersey",553066,17731,1355,3206,245,1,52,11,128,0,18,0,52,29,128,18,139,157,209,25,0,9,67,9,5,0,61,25,75,14,61
34,New Jersey/NJ,3401904,"Union County (Southeast)--Linden, Rahway Cities & Roselle Borough (South) PUMA, New Jersey/NJ",34039,"Union County, New Jersey",553066,17731,1355,3206,245,1,0,9,35,56,0,0,56,9,35,0,44,44,100,0,56,0,44,0,9,0,35,56,44,9,35
34,New Jersey/NJ,3402001,"Burlington County (North)--Burlington City PUMA, New Jersey/NJ",34005,"Burlington County, New Jersey",446367,7103,496,1591,111,1,140,0,0,9,65,26,149,65,26,91,0,91,240,58,4,38,0,27,0,11,0,62,38,27,11
34,New Jersey/NJ,3402002,"Burlington County (West Central) PUMA, New Jersey/NJ",34005,"Burlington County, New Jersey",446367,7103,496,1591,111,1,104,0,58,0,0,0,104,0,58,0,58,58,162,64,0,0,36,0,0,0,36,64,36,0,36
34,New Jersey/NJ,3402003,"Burlington County (South & East) PUMA, New Jersey/NJ",34005,"Burlington County, New Jersey",446367,7103,496,1591,111,1,326,0,9,8,0,43,334,0,52,43,9,52,386,84,2,11,2,0,0,11,2,87,13,0,13
34,New Jersey/NJ,3402101,"Camden County (North)--Camden & Gloucester Cities PUMA, New Jersey/NJ",34007,"Camden County, New Jersey",507367,9876,608,1947,120,1,150,67,220,326,96,53,476,163,273,149,287,436,912,16,36,16,31,11,7,6,24,52,48,18,30
34,New Jersey/NJ,3402102,"Camden County (Central)--Lindenwold & Collingswood Boroughs PUMA, New Jersey/NJ",34007,"Camden County, New Jersey",507367,9876,608,1947,120,1,85,0,0,0,6,0,85,6,0,6,0,6,91,93,0,7,0,7,0,0,0,93,7,7,0
34,New Jersey/NJ,3402103,"Camden County (South & West)--Bellmawr & Pine Hill Boroughs PUMA, New Jersey/NJ",34007,"Camden County, New Jersey",507367,9876,608,1947,120,1,229,38,0,2,17,23,231,55,23,40,38,78,309,74,1,13,12,6,12,7,0,75,25,18,7
34,New Jersey/NJ,3402104,"Camden County (East Central)--Haddonfield Borough PUMA, New Jersey/NJ",34007,"Camden County, New Jersey",507367,9876,608,1947,120,1,126,0,1,0,37,45,126,37,46,82,1,83,209,60,0,39,0,18,0,22,0,60,40,18,22
34,New Jersey/NJ,3402201,"Gloucester County (Northeast)--Woodbury City PUMA, New Jersey/NJ",34015,"Gloucester County, New Jersey",290852,4466,227,1535,78,1,191,0,11,0,90,0,191,90,11,90,11,101,292,65,0,31,4,31,0,0,4,65,35,31,4
34,New Jersey/NJ,3402202,"Gloucester County (South & West)--Glassboro Borough PUMA, New Jersey/NJ",34015,"Gloucester County, New Jersey",290852,4466,227,1535,78,1,384,0,231,5,0,19,389,0,250,19,231,250,639,60,1,3,36,0,0,3,36,61,39,0,39
34,New Jersey/NJ,3402301,"Mercer County (West Central)--Trenton City PUMA, New Jersey/NJ",34021,"Mercer County, New Jersey",368762,8651,635,2346,172,1,43,0,55,125,37,14,168,37,69,51,55,106,274,16,46,19,20,14,0,5,20,61,39,14,25
34,New Jersey/NJ,3402302,"Mercer County (North)--Princeton Borough PUMA, New Jersey/NJ",34021,"Mercer County, New Jersey",368762,8651,635,2346,172,1,91,0,14,0,0,0,91,0,14,0,14,14,105,87,0,0,13,0,0,0,13,87,13,0,13
34,New Jersey/NJ,3402303,"Mercer County (South) PUMA, New Jersey/NJ",34021,"Mercer County, New Jersey",368762,8651,635,2346,172,1,64,0,22,0,38,0,64,38,22,38,22,60,124,52,0,31,18,31,0,0,18,52,48,31,18
34,New Jersey/NJ,3402400,"Cumberland County (South)--Vineland & Millville Cities PUMA, New Jersey/NJ",34011,"Cumberland County, New Jersey",153400,3780,159,2464,104,1,706,49,770,422,158,54,1128,207,824,212,819,1031,2159,33,20,10,38,7,2,3,36,52,48,10,38
34,New Jersey/NJ,3402500,"Salem & Cumberland (North) Counties--Bridgeton City PUMA, New Jersey/NJ",34011,"Cumberland County, New Jersey",153400,3780,159,2464,104,0.402,202,46,467,83,0,9,285,46,476,9,513,522,807,25,10,1,64,0,6,1,58,35,65,6,59
34,New Jersey/NJ,3402500,"Salem & Cumberland (North) Counties--Bridgeton City PUMA, New Jersey/NJ",34033,"Salem County, New Jersey",63336,1058,89,1670,141,0.598,301,69,695,124,0,14,425,69,709,14,764,778,1203,25,10,1,64,0,6,1,58,35,65,6,59
34,New Jersey/NJ,3402600,"Cape May & Atlantic (South Central) Counties--Ocean City & Somers Point City PUMA, New Jersey/NJ",34001,"Atlantic County, New Jersey",268539,4044,256,1506,95,0.101,3,0,1,1,0,2,4,0,3,2,1,3,7,43,14,29,14,0,0,29,14,57,43,0,43
34,New Jersey/NJ,3402600,"Cape May & Atlantic (South Central) Counties--Ocean City & Somers Point City PUMA, New Jersey/NJ",34009,"Cape May County, New Jersey",93705,1025,95,1094,101,0.899,29,0,9,6,0,22,35,0,31,22,9,31,66,44,9,33,14,0,0,33,14,53,47,0,47
35,New Mexico/NM,3500100,"Northwest New Mexico--Navajo Nation PUMA, New Mexico/NM",35006,"Cibola County, New Mexico",26978,744,21,2758,78,0.214,85,0,0,5,0,0,90,0,0,0,0,0,90,94,6,0,0,0,0,0,0,100,0,0,0
35,New Mexico/NM,3500100,"Northwest New Mexico--Navajo Nation PUMA, New Mexico/NM",35031,"McKinley County, New Mexico",72849,4316,256,5925,351,0.585,232,0,0,13,0,0,245,0,0,0,0,0,245,95,5,0,0,0,0,0,0,100,0,0,0
35,New Mexico/NM,3500100,"Northwest New Mexico--Navajo Nation PUMA, New Mexico/NM",35045,"San Juan County, New Mexico",127455,3307,198,2595,155,0.201,80,0,0,4,0,0,84,0,0,0,0,0,84,95,5,0,0,0,0,0,0,100,0,0,0
35,New Mexico/NM,3500200,"San Juan County (Northeast)--Farmington, Bloomfield & Aztec Cities PUMA, New Mexico/NM",35045,"San Juan County, New Mexico",127455,3307,198,2595,155,1,112,0,0,35,0,0,147,0,0,0,0,0,147,76,24,0,0,0,0,0,0,100,0,0,0
35,New Mexico/NM,3500300,"North Central New Mexico PUMA, New Mexico/NM",35028,"Los Alamos County, New Mexico",18356,33,0,180,0,0.147,16,8,3,8,0,0,24,8,3,0,11,11,35,46,23,0,31,0,23,0,9,69,31,23,9
35,New Mexico/NM,3500300,"North Central New Mexico PUMA, New Mexico/NM",35033,"Mora County, New Mexico",4563,7,0,153,0,0.036,4,2,1,2,0,0,6,2,1,0,3,3,9,44,22,0,33,0,22,0,11,67,33,22,11
35,New Mexico/NM,3500300,"North Central New Mexico PUMA, New Mexico/NM",35039,"Rio Arriba County, New Mexico",39307,391,13,995,33,0.324,35,17,7,18,0,0,53,17,7,0,24,24,77,45,23,0,31,0,22,0,9,69,31,22,9
35,New Mexico/NM,3500300,"North Central New Mexico PUMA, New Mexico/NM",35047,"San Miguel County, New Mexico",28034,98,0,350,0,0.225,24,12,5,13,0,0,37,12,5,0,17,17,54,44,24,0,31,0,22,0,9,69,31,22,9
35,New Mexico/NM,3500300,"North Central New Mexico PUMA, New Mexico/NM",35055,"Taos County, New Mexico",32888,139,4,423,12,0.268,29,14,6,15,0,0,44,14,6,0,20,20,64,45,23,0,31,0,22,0,9,69,31,22,9
35,New Mexico/NM,3500400,"Eastern Plains New Mexico PUMA, New Mexico/NM",35007,"Colfax County, New Mexico",12353,30,1,243,8,0.121,83,53,189,35,0,2,118,53,191,2,242,244,362,23,10,1,67,0,15,1,52,33,67,15,53
35,New Mexico/NM,3500400,"Eastern Plains New Mexico PUMA, New Mexico/NM",35009,"Curry County, New Mexico",50199,779,5,1552,10,0.498,341,218,779,143,0,7,484,218,786,7,997,1004,1488,23,10,0,67,0,15,0,52,33,67,15,53
35,New Mexico/NM,3500400,"Eastern Plains New Mexico PUMA, New Mexico/NM",35011,"De Baca County, New Mexico",2060,1,0,49,0,0.018,12,8,28,5,0,0,17,8,28,0,36,36,53,23,9,0,68,0,15,0,53,32,68,15,53
35,New Mexico/NM,3500400,"Eastern Plains New Mexico PUMA, New Mexico/NM",35019,"Guadalupe County, New Mexico",4382,34,1,776,23,0.043,29,19,67,12,0,1,41,19,68,1,86,87,128,23,9,1,67,0,15,1,52,32,68,15,53
35,New Mexico/NM,3500400,"Eastern Plains New Mexico PUMA, New Mexico/NM",35021,"Harding County, New Mexico",459,2,0,436,0,0.007,5,3,11,2,0,0,7,3,11,0,14,14,21,24,10,0,67,0,14,0,52,33,67,14,52
35,New Mexico/NM,3500400,"Eastern Plains New Mexico PUMA, New Mexico/NM",35037,"Quay County, New Mexico",8373,74,2,884,24,0.083,57,36,130,24,0,1,81,36,131,1,166,167,248,23,10,0,67,0,15,0,52,33,67,15,53
35,New Mexico/NM,3500400,"Eastern Plains New Mexico PUMA, New Mexico/NM",35041,"Roosevelt County, New Mexico",19117,281,4,1470,21,0.189,129,83,296,54,0,3,183,83,299,3,379,382,565,23,10,1,67,0,15,1,52,32,68,15,53
35,New Mexico/NM,3500400,"Eastern Plains New Mexico PUMA, New Mexico/NM",35059,"Union County, New Mexico",4175,32,2,766,48,0.041,28,18,64,12,0,1,40,18,65,1,82,83,123,23,10,1,67,0,15,1,52,33,67,15,53
35,New Mexico/NM,3500500,"Santa Fe County PUMA, New Mexico/NM",35049,"Santa Fe County, New Mexico",148917,980,6,658,4,1,33,0,90,232,26,0,265,26,90,26,90,116,381,9,61,7,24,7,0,0,24,70,30,7,24
35,New Mexico/NM,3500600,"Sandoval County PUMA, New Mexico/NM",35043,"Sandoval County, New Mexico",140769,1339,41,951,29,1,95,0,4,9,0,0,104,0,4,0,4,4,108,88,8,0,4,0,0,0,4,96,4,0,4
35,New Mexico/NM,3500700,"Valencia, Bernalillo (East Mountains) Counties & Isleta Pueblo PUMA, New Mexico/NM",35001,"Bernalillo County, New Mexico",677692,6381,177,942,26,0.248,32,46,9,12,0,0,44,46,9,0,55,55,99,32,12,0,56,0,46,0,9,44,56,46,9
35,New Mexico/NM,3500700,"Valencia, Bernalillo (East Mountains) Counties & Isleta Pueblo PUMA, New Mexico/NM",35061,"Valencia County, New Mexico",75956,609,4,802,5,0.752,97,141,27,35,0,0,132,141,27,0,168,168,300,32,12,0,56,0,47,0,9,44,56,47,9
35,New Mexico/NM,3500801,"Albuquerque City (Far Northeast Heights) PUMA, New Mexico/NM",35001,"Bernalillo County, New Mexico",677692,6381,177,942,26,1,0,0,0,5,0,0,5,0,0,0,0,0,5,0,100,0,0,0,0,0,0,100,0,0,0
35,New Mexico/NM,3500802,"Albuquerque City (Near Northeast Heights) PUMA, New Mexico/NM",35001,"Bernalillo County, New Mexico",677692,6381,177,942,26,1,27,0,0,48,0,0,75,0,0,0,0,0,75,36,64,0,0,0,0,0,0,100,0,0,0
35,New Mexico/NM,3500803,"Albuquerque City (Southeast Heights) PUMA, New Mexico/NM",35001,"Bernalillo County, New Mexico",677692,6381,177,942,26,1,112,13,109,51,0,0,163,13,109,0,122,122,285,39,18,0,43,0,5,0,38,57,43,5,38
35,New Mexico/NM,3500804,"Albuquerque City (Central) & Bernalillo County (North Valley) PUMA, New Mexico/NM",35001,"Bernalillo County, New Mexico",677692,6381,177,942,26,1,46,0,44,51,0,0,97,0,44,0,44,44,141,33,36,0,31,0,0,0,31,69,31,0,31
35,New Mexico/NM,3500805,"Albuquerque City (Northwest Mesa), Paradise Hills & Navajo Nation-Tohajiilee Chapter PUMA, New Mexico/NM",35001,"Bernalillo County, New Mexico",677692,6381,177,942,26,1,26,0,20,108,0,0,134,0,20,0,20,20,154,17,70,0,13,0,0,0,13,87,13,0,13
35,New Mexico/NM,3500806,"Albuquerque City (Southwest Mesa) & Bernalillo County (Southwest Mesa & South Valley) PUMA, New Mexico/NM",35001,"Bernalillo County, New Mexico",677692,6381,177,942,26,1,15,41,27,96,0,0,111,41,27,0,68,68,179,8,54,0,38,0,23,0,15,62,38,23,15
35,New Mexico/NM,3500900,"Southwest New Mexico PUMA, New Mexico/NM",35003,"Catron County, New Mexico",3539,9,1,254,28,0.034,14,3,11,6,1,0,20,4,11,1,14,15,35,40,17,3,40,3,9,0,31,57,43,11,31
35,New Mexico/NM,3500900,"Southwest New Mexico PUMA, New Mexico/NM",35017,"Grant County, New Mexico",28061,120,2,428,7,0.272,116,25,89,52,6,0,168,31,89,6,114,120,288,40,18,2,40,2,9,0,31,58,42,11,31
35,New Mexico/NM,3500900,"Southwest New Mexico PUMA, New Mexico/NM",35023,"Hidalgo County, New Mexico",4371,99,2,2265,46,0.041,17,4,13,8,1,0,25,5,13,1,17,18,43,40,19,2,40,2,9,0,30,58,42,12,30
35,New Mexico/NM,3500900,"Southwest New Mexico PUMA, New Mexico/NM",35029,"Luna County, New Mexico",24264,418,6,1723,25,0.235,100,22,77,45,5,0,145,27,77,5,99,104,249,40,18,2,40,2,9,0,31,58,42,11,31
35,New Mexico/NM,3500900,"Southwest New Mexico PUMA, New Mexico/NM",35051,"Sierra County, New Mexico",11135,45,1,404,9,0.108,46,10,36,21,2,0,67,12,36,2,46,48,115,40,18,2,40,2,9,0,31,58,42,10,31
35,New Mexico/NM,3500900,"Southwest New Mexico PUMA, New Mexico/NM",35053,"Socorro County, New Mexico",17000,102,6,600,35,0.164,70,15,54,31,4,0,101,19,54,4,69,73,174,40,18,2,40,2,9,0,31,58,42,11,31
35,New Mexico/NM,3500900,"Southwest New Mexico PUMA, New Mexico/NM",35057,"Torrance County, New Mexico",15595,115,1,737,6,0.147,62,14,48,28,3,0,90,17,48,3,62,65,155,40,18,2,40,2,9,0,31,58,42,11,31
35,New Mexico/NM,3501001,"DoÃ±a Ana County (Outer) PUMA, New Mexico/NM",35013,"Do�a Ana County, New Mexico",215338,3297,55,1531,26,1,15,225,866,407,0,0,422,225,866,0,1091,1091,1513,1,27,0,72,0,15,0,57,28,72,15,57
35,New Mexico/NM,3501002,"DoÃ±a Ana County (Central)--Las Cruces, Mesilla Cities & University Park PUMA, New Mexico/NM",35013,"Do�a Ana County, New Mexico",215338,3297,55,1531,26,1,26,0,16,321,0,0,347,0,16,0,16,16,363,7,88,0,4,0,0,0,4,96,4,0,4
35,New Mexico/NM,3501100,"Central Southeast New Mexico PUMA, New Mexico/NM",35005,"Chaves County, New Mexico",65459,1116,11,1705,17,0.435,218,49,221,170,0,0,388,49,221,0,270,270,658,33,26,0,41,0,7,0,34,59,41,7,34
35,New Mexico/NM,3501100,"Central Southeast New Mexico PUMA, New Mexico/NM",35027,"Lincoln County, New Mexico",19482,208,3,1068,15,0.129,64,14,66,50,0,0,114,14,66,0,80,80,194,33,26,0,41,0,7,0,34,59,41,7,34
35,New Mexico/NM,3501100,"Central Southeast New Mexico PUMA, New Mexico/NM",35035,"Otero County, New Mexico",65745,1166,13,1774,20,0.436,218,49,222,170,0,0,388,49,222,0,271,271,659,33,26,0,41,0,7,0,34,59,41,7,34
35,New Mexico/NM,3501200,"Far Southeast New Mexico PUMA, New Mexico/NM",35015,"Eddy County, New Mexico",57437,785,7,1367,12,0.452,76,15,137,57,0,0,133,15,137,0,152,152,285,27,20,0,53,0,5,0,48,47,53,5,48
35,New Mexico/NM,3501200,"Far Southeast New Mexico PUMA, New Mexico/NM",35025,"Lea County, New Mexico",70126,1430,22,2039,31,0.548,93,19,166,69,0,0,162,19,166,0,185,185,347,27,20,0,53,0,5,0,48,47,53,5,48
36,New York/NY,3600100,"St. Lawrence County PUMA, New York/NY",36089,"St. Lawrence County, New York",109558,322,4,294,4,1,786,0,14,8,0,0,794,0,14,0,14,14,808,97,1,0,2,0,0,0,2,98,2,0,2
36,New York/NY,3600200,"Clinton, Franklin, Essex & Hamilton Counties PUMA, New York/NY",36019,"Clinton County, New York",80794,158,5,196,6,0.466,372,0,34,0,23,25,372,23,59,48,34,82,454,82,0,11,7,5,0,6,7,82,18,5,13
36,New York/NY,3600200,"Clinton, Franklin, Essex & Hamilton Counties PUMA, New York/NY",36031,"Essex County, New York",37751,172,13,456,34,0.219,175,0,16,0,11,12,175,11,28,23,16,39,214,82,0,11,7,5,0,6,7,82,18,5,13
36,New York/NY,3600200,"Clinton, Franklin, Essex & Hamilton Counties PUMA, New York/NY",36033,"Franklin County, New York",50692,66,1,130,2,0.289,231,0,21,0,14,15,231,14,36,29,21,50,281,82,0,10,7,5,0,5,7,82,18,5,13
36,New York/NY,3600200,"Clinton, Franklin, Essex & Hamilton Counties PUMA, New York/NY",36041,"Hamilton County, New York",4575,15,1,328,22,0.026,21,0,2,0,1,1,21,1,3,2,2,4,25,84,0,8,8,4,0,4,8,84,16,4,12
36,New York/NY,3600300,"Warren & Washington Counties PUMA, New York/NY",36113,"Warren County, New York",64480,371,30,575,47,0.511,327,6,3,0,0,0,327,6,3,0,9,9,336,97,0,0,3,0,2,0,1,97,3,2,1
36,New York/NY,3600300,"Warren & Washington Counties PUMA, New York/NY",36115,"Washington County, New York",61828,294,14,476,23,0.489,313,6,3,0,0,0,313,6,3,0,9,9,322,97,0,0,3,0,2,0,1,97,3,2,1
36,New York/NY,3600401,"Herkimer (North & Central) & Oneida (Outer) Counties PUMA, New York/NY",36043,"Herkimer County, New York",62505,331,10,530,16,0.499,374,0,1,0,14,16,374,14,17,30,1,31,405,92,0,7,0,3,0,4,0,92,8,3,4
36,New York/NY,3600401,"Herkimer (North & Central) & Oneida (Outer) Counties PUMA, New York/NY",36065,"Oneida County, New York",230782,2400,121,1040,52,0.501,375,0,1,0,14,16,375,14,17,30,1,31,406,92,0,7,0,3,0,4,0,92,8,3,4
36,New York/NY,3600402,"Oneida County (Central)--Greater Utica & Rome Cities PUMA, New York/NY",36065,"Oneida County, New York",230782,2400,121,1040,52,1,262,39,0,59,137,209,321,176,209,346,39,385,706,37,8,49,6,19,6,30,0,45,55,25,30
36,New York/NY,3600403,"Otsego, Schoharie, Oneida (South) & Herkimer (South) Counties PUMA, New York/NY",36043,"Herkimer County, New York",62505,331,10,530,16,0.056,61,0,1,0,1,0,61,1,1,1,1,2,63,97,0,2,2,2,0,0,2,97,3,2,2
36,New York/NY,3600403,"Otsego, Schoharie, Oneida (South) & Herkimer (South) Counties PUMA, New York/NY",36065,"Oneida County, New York",230782,2400,121,1040,52,0.113,122,0,1,0,3,0,122,3,1,3,1,4,126,97,0,2,1,2,0,0,1,97,3,2,1
36,New York/NY,3600403,"Otsego, Schoharie, Oneida (South) & Herkimer (South) Counties PUMA, New York/NY",36077,"Otsego County, New York",60244,335,4,556,7,0.546,592,0,5,1,14,0,593,14,5,14,5,19,612,97,0,2,1,2,0,0,1,97,3,2,1
36,New York/NY,3600403,"Otsego, Schoharie, Oneida (South) & Herkimer (South) Counties PUMA, New York/NY",36095,"Schoharie County, New York",31364,83,2,265,6,0.285,309,0,3,0,7,0,309,7,3,7,3,10,319,97,0,2,1,2,0,0,1,97,3,2,1
36,New York/NY,3600500,"Jefferson & Lewis Counties PUMA, New York/NY",36045,"Jefferson County, New York",114448,167,1,146,1,0.809,1050,14,13,0,0,2,1050,14,15,2,27,29,1079,97,0,0,3,0,1,0,1,97,3,1,1
36,New York/NY,3600500,"Jefferson & Lewis Counties PUMA, New York/NY",36049,"Lewis County, New York",26719,50,5,187,19,0.191,248,3,3,0,0,1,248,3,4,1,6,7,255,97,0,0,2,0,1,0,1,97,3,1,2
36,New York/NY,3600600,"Oswego County PUMA, New York/NY",36075,"Oswego County, New York",119104,479,3,402,3,1,458,16,14,0,8,0,458,24,14,8,30,38,496,92,0,2,6,2,3,0,3,92,8,5,3
36,New York/NY,3600701,"Onondaga County (Central)--Syracuse City PUMA, New York/NY",36067,"Onondaga County, New York",464242,4321,180,931,39,1,115,0,13,75,15,151,190,15,164,166,13,179,369,31,20,45,4,4,0,41,4,51,49,4,44
36,New York/NY,3600702,"Onondaga County (North) PUMA, New York/NY",36067,"Onondaga County, New York",464242,4321,180,931,39,1,232,0,0,0,0,0,232,0,0,0,0,0,232,100,0,0,0,0,0,0,0,100,0,0,0
36,New York/NY,3600703,"Onondaga County (Central)--Syracuse City (Outer) PUMA, New York/NY",36067,"Onondaga County, New York",464242,4321,180,931,39,1,317,0,0,0,0,0,317,0,0,0,0,0,317,100,0,0,0,0,0,0,0,100,0,0,0
36,New York/NY,3600704,"Cayuga & Onondaga (South) Counties PUMA, New York/NY",36011,"Cayuga County, New York",77868,208,2,267,3,0.689,525,3,69,0,24,6,525,27,75,30,72,102,627,84,0,5,11,4,0,1,11,84,16,4,12
36,New York/NY,3600704,"Cayuga & Onondaga (South) Counties PUMA, New York/NY",36067,"Onondaga County, New York",464242,4321,180,931,39,0.311,237,2,31,0,11,2,237,13,33,13,33,46,283,84,0,5,12,4,1,1,11,84,16,5,12
36,New York/NY,3600800,"Wayne & Seneca Counties PUMA, New York/NY",36099,"Seneca County, New York",34612,106,1,306,3,0.277,279,24,36,0,0,0,279,24,36,0,60,60,339,82,0,0,18,0,7,0,11,82,18,7,11
36,New York/NY,3600800,"Wayne & Seneca Counties PUMA, New York/NY",36117,"Wayne County, New York",90856,315,3,347,3,0.723,730,64,93,0,0,0,730,64,93,0,157,157,887,82,0,0,18,0,7,0,10,82,18,7,10
36,New York/NY,3600901,"Monroe County (East) PUMA, New York/NY",36055,"Monroe County, New York",744248,5986,259,804,35,1,99,0,0,22,0,0,121,0,0,0,0,0,121,82,18,0,0,0,0,0,0,100,0,0,0
36,New York/NY,3600902,"Monroe County (Central)--Rochester City (East) PUMA, New York/NY",36055,"Monroe County, New York",744248,5986,259,804,35,1,157,0,27,46,6,0,203,6,27,6,27,33,236,67,19,3,11,3,0,0,11,86,14,3,11
36,New York/NY,3600903,"Monroe County (Central)--Rochester City (West) PUMA, New York/NY",36055,"Monroe County, New York",744248,5986,259,804,35,1,120,0,22,30,34,15,150,34,37,49,22,71,221,54,14,22,10,15,0,7,10,68,32,15,17
36,New York/NY,3600904,"Monroe County (Central)--Greece & Gates Towns PUMA, New York/NY",36055,"Monroe County, New York",744248,5986,259,804,35,1,254,0,0,21,20,0,275,20,0,20,0,20,295,86,7,7,0,7,0,0,0,93,7,7,0
36,New York/NY,3600905,"Monroe County (North & West) PUMA, New York/NY",36055,"Monroe County, New York",744248,5986,259,804,35,1,89,0,19,0,0,0,89,0,19,0,19,19,108,82,0,0,18,0,0,0,18,82,18,0,18
36,New York/NY,3600906,"Monroe County (South) PUMA, New York/NY",36055,"Monroe County, New York",744248,5986,259,804,35,1,154,0,0,48,0,0,202,0,0,0,0,0,202,76,24,0,0,0,0,0,0,100,0,0,0
36,New York/NY,3601000,"Genesee & Orleans Counties PUMA, New York/NY",36037,"Genesee County, New York",58112,317,6,545,10,0.586,561,36,165,23,16,0,584,52,165,16,201,217,801,70,3,2,25,2,4,0,21,73,27,6,21
36,New York/NY,3601000,"Genesee & Orleans Counties PUMA, New York/NY",36073,"Orleans County, New York",41175,330,55,801,134,0.414,396,26,117,17,11,0,413,37,117,11,143,154,567,70,3,2,25,2,5,0,21,73,27,7,21
36,New York/NY,3601101,"Niagara County (Southwest)--Greater Niagara Falls & North Tonawanda Area PUMA, New York/NY",36063,"Niagara County, New York",211704,1766,89,834,42,1,152,0,0,20,17,0,172,17,0,17,0,17,189,80,11,9,0,9,0,0,0,91,9,9,0
36,New York/NY,3601102,"Niagara County (North & East) PUMA, New York/NY",36063,"Niagara County, New York",211704,1766,89,834,42,1,476,0,13,42,19,0,518,19,13,19,13,32,550,87,8,3,2,3,0,0,2,94,6,3,2
36,New York/NY,3601201,"Erie County (Northwest) PUMA, New York/NY",36029,"Erie County, New York",919866,11251,623,1223,68,1,213,0,5,0,0,0,213,0,5,0,5,5,218,98,0,0,2,0,0,0,2,98,2,0,2
36,New York/NY,3601202,"Erie County (North Central) PUMA, New York/NY",36029,"Erie County, New York",919866,11251,623,1223,68,1,198,0,0,0,0,0,198,0,0,0,0,0,198,100,0,0,0,0,0,0,0,100,0,0,0
36,New York/NY,3601203,"Erie County (Northeast) PUMA, New York/NY",36029,"Erie County, New York",919866,11251,623,1223,68,1,341,0,0,21,0,0,362,0,0,0,0,0,362,94,6,0,0,0,0,0,0,100,0,0,0
36,New York/NY,3601204,"Erie County (Central) PUMA, New York/NY",36029,"Erie County, New York",919866,11251,623,1223,68,1,580,0,3,31,69,8,611,69,11,77,3,80,691,84,4,11,0,10,0,1,0,88,12,10,2
36,New York/NY,3601205,"Erie County (West Central)--Buffalo City (East) PUMA, New York/NY",36029,"Erie County, New York",919866,11251,623,1223,68,1,313,0,9,75,0,43,388,0,52,43,9,52,440,71,17,10,2,0,0,10,2,88,12,0,12
36,New York/NY,3601206,"Erie County (West Central)--Buffalo City (West) PUMA, New York/NY",36029,"Erie County, New York",919866,11251,623,1223,68,1,96,0,2,58,138,57,154,138,59,195,2,197,351,27,17,56,1,39,0,16,1,44,56,39,17
36,New York/NY,3601207,"Erie County (South) PUMA, New York/NY",36029,"Erie County, New York",919866,11251,623,1223,68,1,638,0,33,0,78,0,638,78,33,78,33,111,749,85,0,10,4,10,0,0,4,85,15,10,4
36,New York/NY,3601300,"Livingston & Wyoming Counties PUMA, New York/NY",36051,"Livingston County, New York",63907,206,6,322,9,0.612,733,0,130,38,6,0,771,6,130,6,130,136,907,81,4,1,14,1,0,0,14,85,15,1,14
36,New York/NY,3601300,"Livingston & Wyoming Counties PUMA, New York/NY",36121,"Wyoming County, New York",40565,135,5,333,12,0.388,465,0,82,24,3,0,489,3,82,3,82,85,574,81,4,1,14,1,0,0,14,85,15,1,14
36,New York/NY,3601400,"Ontario & Yates Counties PUMA, New York/NY",36069,"Ontario County, New York",109472,469,28,428,26,0.815,724,0,107,46,0,0,770,0,107,0,107,107,877,83,5,0,12,0,0,0,12,88,12,0,12
36,New York/NY,3601400,"Ontario & Yates Counties PUMA, New York/NY",36123,"Yates County, New York",25009,62,6,248,24,0.185,164,0,24,11,0,0,175,0,24,0,24,24,199,82,6,0,12,0,0,0,12,88,12,0,12
36,New York/NY,3601500,"Madison & Cortland Counties PUMA, New York/NY",36023,"Cortland County, New York",48123,169,1,351,2,0.403,390,0,0,0,0,0,390,0,0,0,0,0,390,100,0,0,0,0,0,0,0,100,0,0,0
36,New York/NY,3601500,"Madison & Cortland Counties PUMA, New York/NY",36053,"Madison County, New York",71359,492,9,689,13,0.597,578,0,0,0,0,0,578,0,0,0,0,0,578,100,0,0,0,0,0,0,0,100,0,0,0
36,New York/NY,3601600,"Fulton & Montgomery Counties PUMA, New York/NY",36035,"Fulton County, New York",53743,333,28,620,52,0.522,331,0,0,13,8,0,344,8,0,8,0,8,352,94,4,2,0,2,0,0,0,98,2,2,0
36,New York/NY,3601600,"Fulton & Montgomery Counties PUMA, New York/NY",36057,"Montgomery County, New York",49426,232,9,469,18,0.478,304,0,0,11,7,0,315,7,0,7,0,7,322,94,3,2,0,2,0,0,0,98,2,2,0
36,New York/NY,3601700,"Schenectady County--Schenectady City PUMA, New York/NY",36093,"Schenectady County, New York",154883,1398,46,903,30,1,185,0,0,0,0,0,185,0,0,0,0,0,185,100,0,0,0,0,0,0,0,100,0,0,0
36,New York/NY,3601801,"Saratoga County (South & Central) PUMA, New York/NY",36091,"Saratoga County, New York",227377,1031,15,453,7,1,238,0,24,0,0,0,238,0,24,0,24,24,262,91,0,0,9,0,0,0,9,91,9,0,9
36,New York/NY,3601802,"Saratoga County (Outer) PUMA, New York/NY",36091,"Saratoga County, New York",227377,1031,15,453,7,1,196,9,13,0,0,0,196,9,13,0,22,22,218,90,0,0,10,0,4,0,6,90,10,4,6
36,New York/NY,3601900,"Rensselaer County--Troy City PUMA, New York/NY",36083,"Rensselaer County, New York",159431,905,42,568,26,1,287,4,0,17,0,0,304,4,0,0,4,4,308,93,6,0,1,0,1,0,0,99,1,1,0
36,New York/NY,3602001,"Albany County (East Central)--Albany City PUMA, New York/NY",36001,"Albany County, New York",307426,3063,123,996,40,1,147,0,34,0,0,0,147,0,34,0,34,34,181,81,0,0,19,0,0,0,19,81,19,0,19
36,New York/NY,3602002,"Albany County (Outside Albany City) PUMA, New York/NY",36001,"Albany County, New York",307426,3063,123,996,40,1,333,0,0,14,10,0,347,10,0,10,0,10,357,93,4,3,0,3,0,0,0,97,3,3,0
36,New York/NY,3602100,"Columbia & Greene Counties PUMA, New York/NY",36021,"Columbia County, New York",60919,588,47,965,77,0.562,218,25,83,0,13,4,218,38,87,17,108,125,343,64,0,5,31,4,7,1,24,64,36,11,25
36,New York/NY,3602100,"Columbia & Greene Counties PUMA, New York/NY",36039,"Greene County, New York",47617,323,14,678,29,0.438,170,20,65,0,10,3,170,30,68,13,85,98,268,63,0,5,32,4,7,1,24,63,37,11,25
36,New York/NY,3602201,"Broome County (West Central)--Greater Binghamton City & Greater Johnson City Village PUMA, New York/NY",36007,"Broome County, New York",194402,1513,85,778,44,1,190,0,0,23,12,16,213,12,16,28,0,28,241,79,10,12,0,5,0,7,0,88,12,5,7
36,New York/NY,3602202,"Broome (Outer West) & Tioga Counties PUMA, New York/NY",36007,"Broome County, New York",194402,1513,85,778,44,0.542,187,0,0,0,0,0,187,0,0,0,0,0,187,100,0,0,0,0,0,0,0,100,0,0,0
36,New York/NY,3602202,"Broome (Outer West) & Tioga Counties PUMA, New York/NY",36107,"Tioga County, New York",49045,229,21,467,43,0.458,158,0,0,0,0,0,158,0,0,0,0,0,158,100,0,0,0,0,0,0,0,100,0,0,0
36,New York/NY,3602203,"Chenango, Delaware & Broome (East) Counties PUMA, New York/NY",36007,"Broome County, New York",194402,1513,85,778,44,0.126,129,1,0,0,1,2,129,2,2,3,1,4,133,97,0,2,1,1,1,2,0,97,3,2,2
36,New York/NY,3602203,"Chenango, Delaware & Broome (East) Counties PUMA, New York/NY",36017,"Chenango County, New York",48348,248,6,513,12,0.451,463,5,0,0,5,7,463,10,7,12,5,17,480,96,0,2,1,1,1,1,0,96,4,2,1
36,New York/NY,3602203,"Chenango, Delaware & Broome (East) Counties PUMA, New York/NY",36025,"Delaware County, New York",45502,133,4,292,9,0.423,434,5,0,0,4,6,434,9,6,10,5,15,449,97,0,2,1,1,1,1,0,97,3,2,1
36,New York/NY,3602300,"Tompkins County PUMA, New York/NY",36109,"Tompkins County, New York",102962,408,0,396,0,1,402,0,13,37,82,0,439,82,13,82,13,95,534,75,7,15,2,15,0,0,2,82,18,15,2
36,New York/NY,3602401,"Chemung (South) & Steuben (East) Counties--Greater Elmira & Greater Corning Cities PUMA, New York/NY",36015,"Chemung County, New York",85740,415,4,484,5,0.756,189,0,0,0,0,14,189,0,14,14,0,14,203,93,0,7,0,0,0,7,0,93,7,0,7
36,New York/NY,3602401,"Chemung (South) & Steuben (East) Counties--Greater Elmira & Greater Corning Cities PUMA, New York/NY",36101,"Steuben County, New York",96927,387,41,399,42,0.244,61,0,0,0,0,4,61,0,4,4,0,4,65,94,0,6,0,0,0,6,0,94,6,0,6
36,New York/NY,3602402,"Steuben (North & West), Schuyler & Chemung (North) Counties PUMA, New York/NY",36015,"Chemung County, New York",85740,415,4,484,5,0.093,98,1,4,2,0,0,100,1,4,0,5,5,105,93,2,0,5,0,1,0,4,95,5,1,4
36,New York/NY,3602402,"Steuben (North & West), Schuyler & Chemung (North) Counties PUMA, New York/NY",36097,"Schuyler County, New York",17992,41,0,228,0,0.182,191,2,7,4,0,0,195,2,7,0,9,9,204,94,2,0,4,0,1,0,3,96,4,1,3
36,New York/NY,3602402,"Steuben (North & West), Schuyler & Chemung (North) Counties PUMA, New York/NY",36101,"Steuben County, New York",96927,387,41,399,42,0.725,761,8,29,14,0,0,775,8,29,0,37,37,812,94,2,0,5,0,1,0,4,95,5,1,4
36,New York/NY,3602500,"Cattaraugus & Allegany Counties PUMA, New York/NY",36003,"Allegany County, New York",47025,103,2,219,4,0.377,418,0,0,1,0,0,419,0,0,0,0,0,419,100,0,0,0,0,0,0,0,100,0,0,0
36,New York/NY,3602500,"Cattaraugus & Allegany Counties PUMA, New York/NY",36009,"Cattaraugus County, New York",77686,258,7,332,9,0.623,690,0,0,2,0,0,692,0,0,0,0,0,692,100,0,0,0,0,0,0,0,100,0,0,0
36,New York/NY,3602600,"Chautauqua County PUMA, New York/NY",36013,"Chautauqua County, New York",129656,561,4,433,3,1,1188,0,114,370,0,0,1558,0,114,0,114,114,1672,71,22,0,7,0,0,0,7,93,7,0,7
36,New York/NY,3602701,"Sullivan & Ulster (West) Counties PUMA, New York/NY",36105,"Sullivan County, New York",75211,1581,37,2102,49,0.687,212,0,137,23,0,0,235,0,137,0,137,137,372,57,6,0,37,0,0,0,37,63,37,0,37
36,New York/NY,3602701,"Sullivan & Ulster (West) Counties PUMA, New York/NY",36111,"Ulster County, New York",179303,2255,84,1258,47,0.313,97,0,62,10,0,0,107,0,62,0,62,62,169,57,6,0,37,0,0,0,37,63,37,0,37
36,New York/NY,3602702,"Ulster County (East) PUMA, New York/NY",36111,"Ulster County, New York",179303,2255,84,1258,47,1,114,0,146,0,0,0,114,0,146,0,146,146,260,44,0,0,56,0,0,0,56,44,56,0,56
36,New York/NY,3602801,"Dutchess County (North & East) PUMA, New York/NY",36027,"Dutchess County, New York",293894,5108,156,1738,53,1,175,52,184,0,13,43,175,65,227,56,236,292,467,37,0,12,51,3,11,9,39,37,63,14,49
36,New York/NY,3602802,"Dutchess County (Southwest) PUMA, New York/NY",36027,"Dutchess County, New York",293894,5108,156,1738,53,1,127,0,27,0,0,0,127,0,27,0,27,27,154,82,0,0,18,0,0,0,18,82,18,0,18
36,New York/NY,3602901,"Orange County (Northeast)--Greater Newburgh City PUMA, New York/NY",36071,"Orange County, New York",378227,11970,412,3165,109,1,85,71,80,100,0,0,185,71,80,0,151,151,336,25,30,0,45,0,21,0,24,55,45,21,24
36,New York/NY,3602902,"Orange County (Northwest) PUMA, New York/NY",36071,"Orange County, New York",378227,11970,412,3165,109,1,462,0,132,29,0,0,491,0,132,0,132,132,623,74,5,0,21,0,0,0,21,79,21,0,21
36,New York/NY,3602903,"Orange County (Southeast) PUMA, New York/NY",36071,"Orange County, New York",378227,11970,412,3165,109,1,125,14,0,0,9,0,125,23,0,9,14,23,148,84,0,6,9,6,9,0,0,84,16,16,0
36,New York/NY,3603001,"Rockland County (North)--New City & Congers PUMA, New York/NY",36087,"Rockland County, New York",323686,15045,509,4648,157,1,64,12,149,0,59,0,64,71,149,59,161,220,284,23,0,21,57,21,4,0,52,23,77,25,52
36,New York/NY,3603002,"Rockland County (South)--Orangetown, Clarkstown (South) & Ramapo (Southeast) Towns PUMA, New York/NY",36087,"Rockland County, New York",323686,15045,509,4648,157,1,8,0,89,0,0,0,8,0,89,0,89,89,97,8,0,0,92,0,0,0,92,8,92,0,92
36,New York/NY,3603003,"Rockland County (West)--Spring Valley, Suffern Villages & Monsey PUMA, New York/NY",36087,"Rockland County, New York",323686,15045,509,4648,157,1,77,0,69,0,24,15,77,24,84,39,69,108,185,42,0,21,37,13,0,8,37,42,58,13,45
36,New York/NY,3603101,"Putnam County PUMA, New York/NY",36079,"Putnam County, New York",99070,1594,63,1609,64,0.974,81,0,0,0,0,7,81,0,7,7,0,7,88,92,0,8,0,0,0,8,0,92,8,0,8
36,New York/NY,3603101,"Putnam County PUMA, New York/NY",36119,"Westchester County, New York",968815,38000,1456,3922,150,0.026,2,0,0,0,0,0,2,0,0,0,0,0,2,100,0,0,0,0,0,0,0,100,0,0,0
36,New York/NY,3603102,"Westchester County (Northwest) PUMA, New York/NY",36119,"Westchester County, New York",968815,38000,1456,3922,150,1,225,13,1,0,0,57,225,13,58,57,14,71,296,76,0,19,5,0,4,19,0,76,24,4,20
36,New York/NY,3603103,"Westchester County (Northeast) PUMA, New York/NY",36119,"Westchester County, New York",968815,38000,1456,3922,150,1,55,0,4,0,0,0,55,0,4,0,4,4,59,93,0,0,7,0,0,0,7,93,7,0,7
36,New York/NY,3603104,"Westchester County (Southeast) PUMA, New York/NY",36119,"Westchester County, New York",968815,38000,1456,3922,150,1,42,0,95,62,0,15,104,0,110,15,95,110,214,20,29,7,44,0,0,7,44,49,51,0,51
36,New York/NY,3603105,"Westchester County (Central)--White Plains City PUMA, New York/NY",36119,"Westchester County, New York",968815,38000,1456,3922,150,1,15,0,64,0,8,0,15,8,64,8,64,72,87,17,0,9,74,9,0,0,74,17,83,9,74
36,New York/NY,3603106,"Westchester County (Southwest)--Yonkers City PUMA, New York/NY",36119,"Westchester County, New York",968815,38000,1456,3922,150,1,40,38,87,178,0,0,218,38,87,0,125,125,343,12,52,0,36,0,11,0,25,64,36,11,25
36,New York/NY,3603107,"Westchester County (South Central)--New Rochelle & Mount Vernon Cities PUMA, New York/NY",36119,"Westchester County, New York",968815,38000,1456,3922,150,1,98,19,107,0,0,0,98,19,107,0,126,126,224,44,0,0,56,0,8,0,48,44,56,8,48
36,New York/NY,3603201,"Nassau County (Northwest)--North Hempstead Town (North) PUMA, New York/NY",36059,"Nassau County, New York",1356564,46505,2201,3428,162,1,46,0,6,0,0,0,46,0,6,0,6,6,52,88,0,0,12,0,0,0,12,88,12,0,12
36,New York/NY,3603202,"Nassau County (Northeast)--Oyster Bay Town (North) & Glen Cove City PUMA, New York/NY",36059,"Nassau County, New York",1356564,46505,2201,3428,162,1,32,23,49,12,0,0,44,23,49,0,72,72,116,28,10,0,62,0,20,0,42,38,62,20,42
36,New York/NY,3603203,"Nassau County (East Central)--Oyster Bay Town (Central) PUMA, New York/NY",36059,"Nassau County, New York",1356564,46505,2201,3428,162,1,0,0,137,0,0,0,0,0,137,0,137,137,137,0,0,0,100,0,0,0,100,0,100,0,100
36,New York/NY,3603204,"Nassau County (West Central)--North Hempstead Town (South) PUMA, New York/NY",36059,"Nassau County, New York",1356564,46505,2201,3428,162,1,73,0,158,0,13,0,73,13,158,13,158,171,244,30,0,5,65,5,0,0,65,30,70,5,65
36,New York/NY,3603205,"Nassau County (West Central)--Hempstead Town (Northwest) PUMA, New York/NY",36059,"Nassau County, New York",1356564,46505,2201,3428,162,1,71,0,28,0,0,42,71,0,70,42,28,70,141,50,0,30,20,0,0,30,20,50,50,0,50
36,New York/NY,3603206,"Nassau County (Central)--Hempstead Town (North Central)--Meadowbrook Corridor PUMA, New York/NY",36059,"Nassau County, New York",1356564,46505,2201,3428,162,1,0,0,207,0,0,19,0,0,226,19,207,226,226,0,0,8,92,0,0,8,92,0,100,0,100
36,New York/NY,3603207,"Nassau County (Central)--Hempstead Town (Northeast) PUMA, New York/NY",36059,"Nassau County, New York",1356564,46505,2201,3428,162,1,14,0,0,22,0,0,36,0,0,0,0,0,36,39,61,0,0,0,0,0,0,100,0,0,0
36,New York/NY,3603208,"Nassau County (Southeast)--Oyster Bay Town (South) PUMA, New York/NY",36059,"Nassau County, New York",1356564,46505,2201,3428,162,1,26,0,0,0,0,0,26,0,0,0,0,0,26,100,0,0,0,0,0,0,0,100,0,0,0
36,New York/NY,3603209,"Nassau County (Central)--Hempstead Town (East Central) PUMA, New York/NY",36059,"Nassau County, New York",1356564,46505,2201,3428,162,1,31,0,0,0,0,0,31,0,0,0,0,0,31,100,0,0,0,0,0,0,0,100,0,0,0
36,New York/NY,3603210,"Nassau County (South Central)--Hempstead Town (Southeast) PUMA, New York/NY",36059,"Nassau County, New York",1356564,46505,2201,3428,162,1,31,0,0,0,0,0,31,0,0,0,0,0,31,100,0,0,0,0,0,0,0,100,0,0,0
36,New York/NY,3603211,"Nassau County (West Central)--Hempstead Town (West Central) PUMA, New York/NY",36059,"Nassau County, New York",1356564,46505,2201,3428,162,1,0,11,17,0,0,0,0,11,17,0,28,28,28,0,0,0,100,0,39,0,61,0,100,39,61
36,New York/NY,3603301,"Suffolk County (Northwest)--Huntington Town (North) PUMA, New York/NY",36103,"Suffolk County, New York",1487901,46293,2013,3111,135,1,47,0,14,0,0,0,47,0,14,0,14,14,61,77,0,0,23,0,0,0,23,77,23,0,23
36,New York/NY,3603302,"Suffolk County (Northwest)--Huntington Town (South) PUMA, New York/NY",36103,"Suffolk County, New York",1487901,46293,2013,3111,135,1,132,0,27,0,24,45,132,24,72,69,27,96,228,58,0,30,12,11,0,20,12,58,42,11,32
36,New York/NY,3603303,"Suffolk County (Northwest)--Smithtown Town PUMA, New York/NY",36103,"Suffolk County, New York",1487901,46293,2013,3111,135,1,42,0,0,0,27,0,42,27,0,27,0,27,69,61,0,39,0,39,0,0,0,61,39,39,0
36,New York/NY,3603304,"Suffolk County (North Central)--Brookhaven Town (North) PUMA, New York/NY",36103,"Suffolk County, New York",1487901,46293,2013,3111,135,1,130,13,0,0,0,0,130,13,0,0,13,13,143,91,0,0,9,0,9,0,0,91,9,9,0
36,New York/NY,3603305,"Suffolk County (East) PUMA, New York/NY",36103,"Suffolk County, New York",1487901,46293,2013,3111,135,1,97,76,212,0,0,8,97,76,220,8,288,296,393,25,0,2,73,0,19,2,54,25,75,19,56
36,New York/NY,3603306,"Suffolk County (South Central)--Brookhaven Town (South) PUMA, New York/NY",36103,"Suffolk County, New York",1487901,46293,2013,3111,135,1,300,11,42,0,0,0,300,11,42,0,53,53,353,85,0,0,15,0,3,0,12,85,15,3,12
36,New York/NY,3603307,"Suffolk County (Central)--Brookhaven Town (Central) PUMA, New York/NY",36103,"Suffolk County, New York",1487901,46293,2013,3111,135,1,156,0,30,63,63,22,219,63,52,85,30,115,334,47,19,25,9,19,0,7,9,66,34,19,16
36,New York/NY,3603308,"Suffolk County (Central)--Brookhaven Town (West Central) PUMA, New York/NY",36103,"Suffolk County, New York",1487901,46293,2013,3111,135,1,61,0,3,16,22,16,77,22,19,38,3,41,118,52,14,32,3,19,0,14,3,65,35,19,16
36,New York/NY,3603310,"Suffolk County (Central)--Islip Town (Northwest) PUMA, New York/NY",36103,"Suffolk County, New York",1487901,46293,2013,3111,135,1,37,87,151,94,0,0,131,87,151,0,238,238,369,10,25,0,64,0,24,0,41,36,64,24,41
36,New York/NY,3603311,"Suffolk County (Southwest)--Islip Town (South) PUMA, New York/NY",36103,"Suffolk County, New York",1487901,46293,2013,3111,135,1,0,0,88,0,0,0,0,0,88,0,88,88,88,0,0,0,100,0,0,0,100,0,100,0,100
36,New York/NY,3603312,"Suffolk County (Southwest)--Babylon Town (Southeast) PUMA, New York/NY",36103,"Suffolk County, New York",1487901,46293,2013,3111,135,1,41,0,0,0,9,0,41,9,0,9,0,9,50,82,0,18,0,18,0,0,0,82,18,18,0
36,New York/NY,3603313,"Suffolk County (West Central)--Babylon Town (Northwest) PUMA, New York/NY",36103,"Suffolk County, New York",1487901,46293,2013,3111,135,1,23,0,31,75,0,0,98,0,31,0,31,31,129,18,58,0,24,0,0,0,24,76,24,0,24
36,New York/NY,3603701,"NYC-Bronx Community District 8--Riverdale, Fieldston & Kingsbridge PUMA, New York/NY",36005,"Bronx County, New York",1437872,NA,NA,NA,NA,1,56,0,0,28,0,0,84,0,0,0,0,0,84,67,33,0,0,0,0,0,0,100,0,0,0
36,New York/NY,3603702,"NYC-Bronx Community District 12--Wakefield, Williamsbridge & Woodlawn PUMA, New York/NY",36005,"Bronx County, New York",1437872,NA,NA,NA,NA,1,63,0,29,41,128,0,104,128,29,128,29,157,261,24,16,49,11,49,0,0,11,40,60,49,11
36,New York/NY,3603703,"NYC-Bronx Community District 10--Co-op City, Pelham Bay & Schuylerville PUMA, New York/NY",36005,"Bronx County, New York",1437872,NA,NA,NA,NA,1,59,24,0,0,0,15,59,24,15,15,24,39,98,60,0,15,24,0,24,15,0,60,40,24,15
36,New York/NY,3603704,"NYC-Bronx Community District 11--Pelham Parkway, Morris Park & Laconia PUMA, New York/NY",36005,"Bronx County, New York",1437872,NA,NA,NA,NA,1,0,21,120,104,132,0,104,153,120,132,141,273,377,0,28,35,37,35,6,0,32,28,72,41,32
36,New York/NY,3603705,"NYC-Bronx Community District 3 & 6--Belmont, Crotona Park East & East Tremont PUMA, New York/NY",36005,"Bronx County, New York",1437872,NA,NA,NA,NA,1,44,16,186,21,0,46,65,16,232,46,202,248,313,14,7,15,65,0,5,15,59,21,79,5,74
36,New York/NY,3603706,"NYC-Bronx Community District 7--Bedford Park, Fordham North & Norwood PUMA, New York/NY",36005,"Bronx County, New York",1437872,NA,NA,NA,NA,1,0,0,87,0,15,0,0,15,87,15,87,102,102,0,0,15,85,15,0,0,85,0,100,15,85
36,New York/NY,3603707,"NYC-Bronx Community District 5--Morris Heights, Fordham South & Mount Hope PUMA, New York/NY",36005,"Bronx County, New York",1437872,NA,NA,NA,NA,1,25,29,93,56,0,0,81,29,93,0,122,122,203,12,28,0,60,0,14,0,46,40,60,14,46
36,New York/NY,3603708,"NYC-Bronx Community District 4--Concourse, Highbridge & Mount Eden PUMA, New York/NY",36005,"Bronx County, New York",1437872,NA,NA,NA,NA,1,0,23,96,41,0,0,41,23,96,0,119,119,160,0,26,0,74,0,14,0,60,26,74,14,60
36,New York/NY,3603709,"NYC-Bronx Community District 9--Castle Hill, Clason Point & Parkchester PUMA, New York/NY",36005,"Bronx County, New York",1437872,NA,NA,NA,NA,1,0,44,98,103,50,26,103,94,124,76,142,218,321,0,32,24,44,16,14,8,31,32,68,29,39
36,New York/NY,3603710,"NYC-Bronx Community District 1 & 2--Hunts Point, Longwood & Melrose PUMA, New York/NY",36005,"Bronx County, New York",1437872,NA,NA,NA,NA,1,0,0,143,64,0,0,64,0,143,0,143,143,207,0,31,0,69,0,0,0,69,31,69,0,69
36,New York/NY,3603801,"NYC-Manhattan Community District 12--Washington Heights, Inwood & Marble Hill PUMA, New York/NY",36061,"New York County, New York",1632480,NA,NA,NA,NA,1,78,133,252,15,0,0,93,133,252,0,385,385,478,16,3,0,81,0,28,0,53,19,81,28,53
36,New York/NY,3603802,"NYC-Manhattan Community District 9--Hamilton Heights, Manhattanville & West Harlem PUMA, New York/NY",36061,"New York County, New York",1632480,NA,NA,NA,NA,1,36,0,0,15,0,3,51,0,3,3,0,3,54,67,28,6,0,0,0,6,0,94,6,0,6
36,New York/NY,3603803,"NYC-Manhattan Community District 10--Central Harlem PUMA, New York/NY",36061,"New York County, New York",1632480,NA,NA,NA,NA,1,0,0,14,29,0,0,29,0,14,0,14,14,43,0,67,0,33,0,0,0,33,67,33,0,33
36,New York/NY,3603804,"NYC-Manhattan Community District 11--East Harlem PUMA, New York/NY",36061,"New York County, New York",1632480,NA,NA,NA,NA,1,0,42,54,130,22,27,130,64,81,49,96,145,275,0,47,18,35,8,15,10,20,47,53,23,29
36,New York/NY,3603805,"NYC-Manhattan Community District 8--Upper East Side PUMA, New York/NY",36061,"New York County, New York",1632480,NA,NA,NA,NA,1,100,0,0,0,0,0,100,0,0,0,0,0,100,100,0,0,0,0,0,0,0,100,0,0,0
36,New York/NY,3603806,"NYC-Manhattan Community District 7--Upper West Side & West Side PUMA, New York/NY",36061,"New York County, New York",1632480,NA,NA,NA,NA,1,44,0,0,157,39,3,201,39,3,42,0,42,243,18,65,17,0,16,0,1,0,83,17,16,1
36,New York/NY,3603807,"NYC-Manhattan Community District 4 & 5--Chelsea, Clinton & Midtown Business District PUMA, New York/NY",36061,"New York County, New York",1632480,NA,NA,NA,NA,1,0,0,22,0,0,0,0,0,22,0,22,22,22,0,0,0,100,0,0,0,100,0,100,0,100
36,New York/NY,3603808,"NYC-Manhattan Community District 6--Murray Hill, Gramercy & Stuyvesant Town PUMA, New York/NY",36061,"New York County, New York",1632480,NA,NA,NA,NA,1,0,0,0,0,0,4,0,0,4,4,0,4,4,0,0,100,0,0,0,100,0,0,100,0,100
36,New York/NY,3603809,"NYC-Manhattan Community District 3--Chinatown & Lower East Side PUMA, New York/NY",36061,"New York County, New York",1632480,NA,NA,NA,NA,1,36,0,0,19,33,17,55,33,17,50,0,50,105,34,18,48,0,31,0,16,0,52,48,31,16
36,New York/NY,3603810,"NYC-Manhattan Community District 1 & 2--Battery Park City, Greenwich Village & Soho PUMA, New York/NY",36061,"New York County, New York",1632480,NA,NA,NA,NA,1,0,0,0,0,0,2,0,0,2,2,0,2,2,0,0,100,0,0,0,100,0,0,100,0,100
36,New York/NY,3603901,"NYC-Staten Island Community District 3--Tottenville, Great Kills & Annadale PUMA, New York/NY",36085,"Richmond County, New York",474101,NA,NA,NA,NA,1,56,0,0,0,0,9,56,0,9,9,0,9,65,86,0,14,0,0,0,14,0,86,14,0,14
36,New York/NY,3603902,"NYC-Staten Island Community District 2--New Springville & South Beach PUMA, New York/NY",36085,"Richmond County, New York",474101,NA,NA,NA,NA,1,45,0,0,0,0,0,45,0,0,0,0,0,45,100,0,0,0,0,0,0,0,100,0,0,0
36,New York/NY,3603903,"NYC-Staten Island Community District 1--Port Richmond, Stapleton & Mariner's Harbor PUMA, New York/NY",36085,"Richmond County, New York",474101,NA,NA,NA,NA,1,112,7,59,0,62,0,112,69,59,62,66,128,240,47,0,26,28,26,3,0,25,47,53,29,25
36,New York/NY,3604001,"NYC-Brooklyn Community District 1--Greenpoint & Williamsburg PUMA, New York/NY",36047,"Kings County, New York",2600747,NA,NA,NA,NA,1,0,56,32,0,68,42,0,124,74,110,88,198,198,0,0,56,44,34,28,21,16,0,100,63,37
36,New York/NY,3604002,"NYC-Brooklyn Community District 4--Bushwick PUMA, New York/NY",36047,"Kings County, New York",2600747,NA,NA,NA,NA,1,76,56,266,78,0,0,154,56,266,0,322,322,476,16,16,0,68,0,12,0,56,32,68,12,56
36,New York/NY,3604003,"NYC-Brooklyn Community District 3--Bedford-Stuyvesant PUMA, New York/NY",36047,"Kings County, New York",2600747,NA,NA,NA,NA,1,100,0,15,70,0,0,170,0,15,0,15,15,185,54,38,0,8,0,0,0,8,92,8,0,8
36,New York/NY,3604004,"NYC-Brooklyn Community District 2--Brooklyn Heights & Fort Greene PUMA, New York/NY",36047,"Kings County, New York",2600747,NA,NA,NA,NA,1,46,0,0,18,0,0,64,0,0,0,0,0,64,72,28,0,0,0,0,0,0,100,0,0,0
36,New York/NY,3604005,"NYC-Brooklyn Community District 6--Park Slope, Carroll Gardens & Red Hook PUMA, New York/NY",36047,"Kings County, New York",2600747,NA,NA,NA,NA,1,10,0,64,0,18,25,10,18,89,43,64,107,117,9,0,37,55,15,0,21,55,9,91,15,76
36,New York/NY,3604006,"NYC-Brooklyn Community District 8--Crown Heights North & Prospect Heights PUMA, New York/NY",36047,"Kings County, New York",2600747,NA,NA,NA,NA,1,56,0,94,5,0,0,61,0,94,0,94,94,155,36,3,0,61,0,0,0,61,39,61,0,61
36,New York/NY,3604007,"NYC-Brooklyn Community District 16--Brownsville & Ocean Hill PUMA, New York/NY",36047,"Kings County, New York",2600747,NA,NA,NA,NA,1,110,0,39,3,17,0,113,17,39,17,39,56,169,65,2,10,23,10,0,0,23,67,33,10,23
36,New York/NY,3604008,"NYC-Brooklyn Community District 5--East New York & Starrett City PUMA, New York/NY",36047,"Kings County, New York",2600747,NA,NA,NA,NA,1,29,46,0,18,13,27,47,59,27,40,46,86,133,22,14,30,35,10,35,20,0,35,65,44,20
36,New York/NY,3604009,"NYC-Brooklyn Community District 18--Canarsie & Flatlands PUMA, New York/NY",36047,"Kings County, New York",2600747,NA,NA,NA,NA,1,42,0,0,0,10,19,42,10,19,29,0,29,71,59,0,41,0,14,0,27,0,59,41,14,27
36,New York/NY,3604010,"NYC-Brooklyn Community District 17--East Flatbush, Farragut & Rugby PUMA, New York/NY",36047,"Kings County, New York",2600747,NA,NA,NA,NA,1,0,53,0,0,11,17,0,64,17,28,53,81,81,0,0,35,65,14,65,21,0,0,100,79,21
36,New York/NY,3604012,"NYC-Brooklyn Community District 7--Sunset Park & Windsor Terrace PUMA, New York/NY",36047,"Kings County, New York",2600747,NA,NA,NA,NA,1,48,42,250,31,62,116,79,104,366,178,292,470,549,9,6,32,53,11,8,21,46,14,86,19,67
36,New York/NY,3604013,"NYC-Brooklyn Community District 10--Bay Ridge & Dyker Heights PUMA, New York/NY",36047,"Kings County, New York",2600747,NA,NA,NA,NA,1,31,0,44,0,27,39,31,27,83,66,44,110,141,22,0,47,31,19,0,28,31,22,78,19,59
36,New York/NY,3604014,"NYC-Brooklyn Community District 12--Borough Park, Kensington & Ocean Parkway PUMA, New York/NY",36047,"Kings County, New York",2600747,NA,NA,NA,NA,1,72,0,0,0,0,65,72,0,65,65,0,65,137,53,0,47,0,0,0,47,0,53,47,0,47
36,New York/NY,3604015,"NYC-Brooklyn Community District 14--Flatbush & Midwood PUMA, New York/NY",36047,"Kings County, New York",2600747,NA,NA,NA,NA,1,30,0,0,0,11,41,30,11,41,52,0,52,82,37,0,63,0,13,0,50,0,37,63,13,50
36,New York/NY,3604016,"NYC-Brooklyn Community District 15--Sheepshead Bay, Gerritsen Beach & Homecrest PUMA, New York/NY",36047,"Kings County, New York",2600747,NA,NA,NA,NA,1,0,0,0,0,29,23,0,29,23,52,0,52,52,0,0,100,0,56,0,44,0,0,100,56,44
36,New York/NY,3604017,"NYC-Brooklyn Community District 11--Bensonhurst & Bath Beach PUMA, New York/NY",36047,"Kings County, New York",2600747,NA,NA,NA,NA,1,77,15,115,0,123,158,77,138,273,281,130,411,488,16,0,58,27,25,3,32,24,16,84,28,56
36,New York/NY,3604018,"NYC-Brooklyn Community District 13--Brighton Beach & Coney Island PUMA, New York/NY",36047,"Kings County, New York",2600747,NA,NA,NA,NA,1,8,0,44,0,65,24,8,65,68,89,44,133,141,6,0,63,31,46,0,17,31,6,94,46,48
36,New York/NY,3604101,"NYC-Queens Community District 1--Astoria & Long Island City PUMA, New York/NY",36081,"Queens County, New York",2298513,NA,NA,NA,NA,1,39,15,18,32,68,8,71,83,26,76,33,109,180,22,18,42,18,38,8,4,10,39,61,46,14
36,New York/NY,3604102,"NYC-Queens Community District 3--Jackson Heights & North Corona PUMA, New York/NY",36081,"Queens County, New York",2298513,NA,NA,NA,NA,1,110,60,264,50,72,17,160,132,281,89,324,413,573,19,9,16,57,13,10,3,46,28,72,23,49
36,New York/NY,3604103,"NYC-Queens Community District 7--Flushing, Murray Hill & Whitestone PUMA, New York/NY",36081,"Queens County, New York",2298513,NA,NA,NA,NA,1,60,10,23,21,12,99,81,22,122,111,33,144,225,27,9,49,15,5,4,44,10,36,64,10,54
36,New York/NY,3604104,"NYC-Queens Community District 11--Bayside, Douglaston & Little Neck PUMA, New York/NY",36081,"Queens County, New York",2298513,NA,NA,NA,NA,1,0,0,0,0,35,17,0,35,17,52,0,52,52,0,0,100,0,67,0,33,0,0,100,67,33
36,New York/NY,3604105,"NYC-Queens Community District 13--Queens Village, Cambria Heights & Rosedale PUMA, New York/NY",36081,"Queens County, New York",2298513,NA,NA,NA,NA,1,0,18,0,0,0,0,0,18,0,0,18,18,18,0,0,0,100,0,100,0,0,0,100,100,0
36,New York/NY,3604106,"NYC-Queens Community District 8--Briarwood, Fresh Meadows & Hillcrest PUMA, New York/NY",36081,"Queens County, New York",2298513,NA,NA,NA,NA,1,8,0,32,55,83,69,63,83,101,152,32,184,247,3,22,62,13,34,0,28,13,26,74,34,41
36,New York/NY,3604107,"NYC-Queens Community District 4--Elmhurst & South Corona PUMA, New York/NY",36081,"Queens County, New York",2298513,NA,NA,NA,NA,1,0,18,147,0,35,16,0,53,163,51,165,216,216,0,0,24,76,16,8,7,68,0,100,25,75
36,New York/NY,3604108,"NYC-Queens Community District 6--Forest Hills & Rego Park PUMA, New York/NY",36081,"Queens County, New York",2298513,NA,NA,NA,NA,1,0,0,0,0,58,0,0,58,0,58,0,58,58,0,0,100,0,100,0,0,0,0,100,100,0
36,New York/NY,3604109,"NYC-Queens Community District 2--Sunnyside & Woodside PUMA, New York/NY",36081,"Queens County, New York",2298513,NA,NA,NA,NA,1,0,0,62,0,34,12,0,34,74,46,62,108,108,0,0,43,57,31,0,11,57,0,100,31,69
36,New York/NY,3604110,"NYC-Queens Community District 5--Ridgewood, Glendale & Middle Village PUMA, New York/NY",36081,"Queens County, New York",2298513,NA,NA,NA,NA,1,31,14,49,23,28,14,54,42,63,42,63,105,159,19,14,26,40,18,9,9,31,34,66,26,40
36,New York/NY,3604111,"NYC-Queens Community District 9--Richmond Hill & Woodhaven PUMA, New York/NY",36081,"Queens County, New York",2298513,NA,NA,NA,NA,1,0,9,48,0,23,33,0,32,81,56,57,113,113,0,0,50,50,20,8,29,42,0,100,28,72
36,New York/NY,3604112,"NYC-Queens Community District 12--Jamaica, Hollis & St. Albans PUMA, New York/NY",36081,"Queens County, New York",2298513,NA,NA,NA,NA,1,16,68,0,0,115,93,16,183,93,208,68,276,292,5,0,71,23,39,23,32,0,5,95,63,32
36,New York/NY,3604113,"NYC-Queens Community District 10--Howard Beach & Ozone Park PUMA, New York/NY",36081,"Queens County, New York",2298513,NA,NA,NA,NA,1,26,10,48,21,20,27,47,30,75,47,58,105,152,17,14,31,38,13,7,18,32,31,69,20,49
36,New York/NY,3604114,"NYC-Queens Community District 14--Far Rockaway, Breezy Point & Broad Channel PUMA, New York/NY",36081,"Queens County, New York",2298513,NA,NA,NA,NA,1,31,0,40,88,0,0,119,0,40,0,40,40,159,19,55,0,25,0,0,0,25,75,25,0,25
37,North Carolina/NC,3700100,"Boone High Country--Watauga, Ashe, Yancey, Avery & Mitchell Counties PUMA, North Carolina/NC",37009,"Ashe County, North Carolina",26786,266,1,993,4,0.205,165,0,23,0,0,0,165,0,23,0,23,23,188,88,0,0,12,0,0,0,12,88,12,0,12
37,North Carolina/NC,3700100,"Boone High Country--Watauga, Ashe, Yancey, Avery & Mitchell Counties PUMA, North Carolina/NC",37011,"Avery County, North Carolina",17501,348,0,1988,0,0.134,108,0,15,0,0,0,108,0,15,0,15,15,123,88,0,0,12,0,0,0,12,88,12,0,12
37,North Carolina/NC,3700100,"Boone High Country--Watauga, Ashe, Yancey, Avery & Mitchell Counties PUMA, North Carolina/NC",37121,"Mitchell County, North Carolina",15040,150,3,997,20,0.115,93,0,13,0,0,0,93,0,13,0,13,13,106,88,0,0,12,0,0,0,12,88,12,0,12
37,North Carolina/NC,3700100,"Boone High Country--Watauga, Ashe, Yancey, Avery & Mitchell Counties PUMA, North Carolina/NC",37189,"Watauga County, North Carolina",54117,816,1,1508,2,0.411,331,0,46,0,0,0,331,0,46,0,46,46,377,88,0,0,12,0,0,0,12,88,12,0,12
37,North Carolina/NC,3700100,"Boone High Country--Watauga, Ashe, Yancey, Avery & Mitchell Counties PUMA, North Carolina/NC",37199,"Yancey County, North Carolina",17667,209,0,1183,0,0.135,109,0,15,0,0,0,109,0,15,0,15,15,124,88,0,0,12,0,0,0,12,88,12,0,12
37,North Carolina/NC,3700200,"Wilkesboro High Country--Surry, Wilkes & Alleghany Counties PUMA, North Carolina/NC",37005,"Alleghany County, North Carolina",10973,226,0,2060,0,0.072,83,11,33,10,0,8,93,11,41,8,44,52,145,57,7,6,30,0,8,6,23,64,36,8,28
37,North Carolina/NC,3700200,"Wilkesboro High Country--Surry, Wilkes & Alleghany Counties PUMA, North Carolina/NC",37171,"Surry County, North Carolina",72099,1313,23,1821,32,0.475,547,73,219,65,0,51,612,73,270,51,292,343,955,57,7,5,31,0,8,5,23,64,36,8,28
37,North Carolina/NC,3700200,"Wilkesboro High Country--Surry, Wilkes & Alleghany Counties PUMA, North Carolina/NC",37193,"Wilkes County, North Carolina",68460,1201,33,1754,48,0.453,522,69,209,62,0,48,584,69,257,48,278,326,910,57,7,5,31,0,8,5,23,64,36,8,28
37,North Carolina/NC,3700300,"Rockingham & Stokes Counties PUMA, North Carolina/NC",37157,"Rockingham County, North Carolina",91270,1207,14,1322,15,0.665,340,0,180,0,0,0,340,0,180,0,180,180,520,65,0,0,35,0,0,0,35,65,35,0,35
37,North Carolina/NC,3700300,"Rockingham & Stokes Counties PUMA, North Carolina/NC",37169,"Stokes County, North Carolina",45905,424,3,924,7,0.335,171,0,90,0,0,0,171,0,90,0,90,90,261,66,0,0,34,0,0,0,34,66,34,0,34
37,North Carolina/NC,3700400,"Granville, Person & Caswell Counties PUMA, North Carolina/NC",37033,"Caswell County, North Carolina",22746,349,4,1534,18,0.189,43,0,15,12,0,0,55,0,15,0,15,15,70,61,17,0,21,0,0,0,21,79,21,0,21
37,North Carolina/NC,3700400,"Granville, Person & Caswell Counties PUMA, North Carolina/NC",37077,"Granville County, North Carolina",58874,1715,49,2913,83,0.487,111,0,38,30,0,0,141,0,38,0,38,38,179,62,17,0,21,0,0,0,21,79,21,0,21
37,North Carolina/NC,3700400,"Granville, Person & Caswell Counties PUMA, North Carolina/NC",37145,"Person County, North Carolina",39305,427,7,1086,18,0.324,74,0,25,20,0,0,94,0,25,0,25,25,119,62,17,0,21,0,0,0,21,79,21,0,21
37,North Carolina/NC,3700500,"Franklin, Vance & Warren (West) Counties PUMA, North Carolina/NC",37069,"Franklin County, North Carolina",64902,1207,31,1860,48,0.526,394,11,312,21,0,0,415,11,312,0,323,323,738,53,3,0,44,0,1,0,42,56,44,1,42
37,North Carolina/NC,3700500,"Franklin, Vance & Warren (West) Counties PUMA, North Carolina/NC",37181,"Vance County, North Carolina",44482,1032,44,2320,99,0.36,270,7,214,14,0,0,284,7,214,0,221,221,505,53,3,0,44,0,1,0,42,56,44,1,42
37,North Carolina/NC,3700500,"Franklin, Vance & Warren (West) Counties PUMA, North Carolina/NC",37185,"Warren County, North Carolina",20033,338,7,1687,35,0.114,86,2,68,5,0,0,91,2,68,0,70,70,161,53,3,0,43,0,1,0,42,57,43,1,42
37,North Carolina/NC,3700600,"Halifax, Hertford, Northampton & Warren (East) Counties PUMA, North Carolina/NC",37083,"Halifax County, North Carolina",51737,1006,19,1944,37,0.509,731,13,55,1,0,0,732,13,55,0,68,68,800,91,0,0,8,0,2,0,7,92,8,2,7
37,North Carolina/NC,3700600,"Halifax, Hertford, Northampton & Warren (East) Counties PUMA, North Carolina/NC",37091,"Hertford County, North Carolina",24153,744,29,3080,120,0.237,341,6,26,0,0,0,341,6,26,0,32,32,373,91,0,0,9,0,2,0,7,91,9,2,7
37,North Carolina/NC,3700600,"Halifax, Hertford, Northampton & Warren (East) Counties PUMA, North Carolina/NC",37131,"Northampton County, North Carolina",20186,449,17,2224,84,0.197,283,5,21,0,0,0,283,5,21,0,26,26,309,92,0,0,8,0,2,0,7,92,8,2,7
37,North Carolina/NC,3700600,"Halifax, Hertford, Northampton & Warren (East) Counties PUMA, North Carolina/NC",37185,"Warren County, North Carolina",20033,338,7,1687,35,0.057,82,1,6,0,0,0,82,1,6,0,7,7,89,92,0,0,8,0,1,0,7,92,8,1,7
37,North Carolina/NC,3700700,"Northeast Albemarle Sound Region PUMA, North Carolina/NC",37029,"Camden County, North Carolina",10447,113,3,1082,29,0.09,53,0,5,0,0,2,53,0,7,2,5,7,60,88,0,3,8,0,0,3,8,88,12,0,12
37,North Carolina/NC,3700700,"Northeast Albemarle Sound Region PUMA, North Carolina/NC",37041,"Chowan County, North Carolina",14205,346,3,2436,21,0.125,73,0,6,0,0,3,73,0,9,3,6,9,82,89,0,4,7,0,0,4,7,89,11,0,11
37,North Carolina/NC,3700700,"Northeast Albemarle Sound Region PUMA, North Carolina/NC",37053,"Currituck County, North Carolina",25796,182,3,706,12,0.224,131,0,11,0,0,6,131,0,17,6,11,17,148,89,0,4,7,0,0,4,7,89,11,0,11
37,North Carolina/NC,3700700,"Northeast Albemarle Sound Region PUMA, North Carolina/NC",37073,"Gates County, North Carolina",11563,138,3,1193,26,0.1,58,0,5,0,0,2,58,0,7,2,5,7,65,89,0,3,8,0,0,3,8,89,11,0,11
37,North Carolina/NC,3700700,"Northeast Albemarle Sound Region PUMA, North Carolina/NC",37139,"Pasquotank County, North Carolina",39479,695,30,1760,76,0.346,202,0,18,0,0,9,202,0,27,9,18,27,229,88,0,4,8,0,0,4,8,88,12,0,12
37,North Carolina/NC,3700700,"Northeast Albemarle Sound Region PUMA, North Carolina/NC",37143,"Perquimans County, North Carolina",13459,186,3,1382,22,0.116,68,0,6,0,0,3,68,0,9,3,6,9,77,88,0,4,8,0,0,4,8,88,12,0,12
37,North Carolina/NC,3700800,"South & West Albemarle Sound & Northern Outer Banks Regions PUMA, North Carolina/NC",37015,"Bertie County, North Carolina",19644,577,8,2937,41,0.197,305,0,24,2,0,0,307,0,24,0,24,24,331,92,1,0,7,0,0,0,7,93,7,0,7
37,North Carolina/NC,3700800,"South & West Albemarle Sound & Northern Outer Banks Regions PUMA, North Carolina/NC",37055,"Dare County, North Carolina",35741,271,3,758,8,0.357,552,0,43,3,0,0,555,0,43,0,43,43,598,92,1,0,7,0,0,0,7,93,7,0,7
37,North Carolina/NC,3700800,"South & West Albemarle Sound & Northern Outer Banks Regions PUMA, North Carolina/NC",37095,"Hyde County, North Carolina",5393,126,5,2336,93,0.055,85,0,7,0,0,0,85,0,7,0,7,7,92,92,0,0,8,0,0,0,8,92,8,0,8
37,North Carolina/NC,3700800,"South & West Albemarle Sound & Northern Outer Banks Regions PUMA, North Carolina/NC",37117,"Martin County, North Carolina",23054,453,10,1965,43,0.23,356,0,28,2,0,0,358,0,28,0,28,28,386,92,1,0,7,0,0,0,7,93,7,0,7
37,North Carolina/NC,3700800,"South & West Albemarle Sound & Northern Outer Banks Regions PUMA, North Carolina/NC",37177,"Tyrrell County, North Carolina",4119,116,3,2816,73,0.041,63,0,5,0,0,0,63,0,5,0,5,5,68,93,0,0,7,0,0,0,7,93,7,0,7
37,North Carolina/NC,3700800,"South & West Albemarle Sound & Northern Outer Banks Regions PUMA, North Carolina/NC",37187,"Washington County, North Carolina",12156,209,8,1719,66,0.121,187,0,15,1,0,0,188,0,15,0,15,15,203,92,0,0,7,0,0,0,7,93,7,0,7
37,North Carolina/NC,3700900,"Nash & Edgecombe Counties--Rocky Mount City PUMA, North Carolina/NC",37065,"Edgecombe County, North Carolina",53332,1342,47,2516,88,0.362,456,59,135,44,0,0,500,59,135,0,194,194,694,66,6,0,28,0,9,0,19,72,28,9,19
37,North Carolina/NC,3700900,"Nash & Edgecombe Counties--Rocky Mount City PUMA, North Carolina/NC",37127,"Nash County, North Carolina",94003,2295,39,2441,41,0.638,805,105,237,77,0,0,882,105,237,0,342,342,1224,66,6,0,28,0,9,0,19,72,28,9,19
37,North Carolina/NC,3701000,"Wilson & Greene Counties--Wilson City PUMA, North Carolina/NC",37079,"Greene County, North Carolina",21008,593,5,2823,24,0.206,220,18,175,11,12,0,231,30,175,12,193,205,436,50,3,3,44,3,4,0,40,53,47,7,40
37,North Carolina/NC,3701000,"Wilson & Greene Counties--Wilson City PUMA, North Carolina/NC",37195,"Wilson County, North Carolina",81336,2196,49,2700,60,0.794,849,71,673,43,44,0,892,115,673,44,744,788,1680,51,3,3,44,3,4,0,40,53,47,7,40
37,North Carolina/NC,3701100,"Johnston County PUMA, North Carolina/NC",37101,"Johnston County, North Carolina",191172,4477,56,2342,29,1,583,0,341,17,0,0,600,0,341,0,341,341,941,62,2,0,36,0,0,0,36,64,36,0,36
37,North Carolina/NC,3701201,"Raleigh City (South & Central) PUMA, North Carolina/NC",37183,"Wake County, North Carolina",1046558,17654,243,1687,23,1,259,0,99,0,0,0,259,0,99,0,99,99,358,72,0,0,28,0,0,0,28,72,28,0,28
37,North Carolina/NC,3701202,"Raleigh City (North) PUMA, North Carolina/NC",37183,"Wake County, North Carolina",1046558,17654,243,1687,23,1,86,0,0,11,0,0,97,0,0,0,0,0,97,89,11,0,0,0,0,0,0,100,0,0,0
37,North Carolina/NC,3701203,"Wake County (Northeast)--Raleigh City (Northeast), Wake Forest & Rolesville Towns PUMA, North Carolina/NC",37183,"Wake County, North Carolina",1046558,17654,243,1687,23,1,98,61,34,18,102,0,116,163,34,102,95,197,313,31,6,33,30,33,19,0,11,37,63,52,11
37,North Carolina/NC,3701204,"Wake County (East)--Raleigh City (East), Knightdale & Garner (North) Towns PUMA, North Carolina/NC",37183,"Wake County, North Carolina",1046558,17654,243,1687,23,1,60,17,85,32,0,0,92,17,85,0,102,102,194,31,16,0,53,0,9,0,44,47,53,9,44
37,North Carolina/NC,3701205,"Wake County (Southeast)--Garner (South) & Fuquay-Varina Towns PUMA, North Carolina/NC",37183,"Wake County, North Carolina",1046558,17654,243,1687,23,1,166,0,23,0,0,0,166,0,23,0,23,23,189,88,0,0,12,0,0,0,12,88,12,0,12
37,North Carolina/NC,3701206,"Wake County (Northwest)--Raleigh City (Northwest) & Morrisville Town PUMA, North Carolina/NC",37183,"Wake County, North Carolina",1046558,17654,243,1687,23,1,0,0,0,0,48,58,0,48,58,106,0,106,106,0,0,100,0,45,0,55,0,0,100,45,55
37,North Carolina/NC,3701207,"Wake County (West Central)--Cary Town PUMA, North Carolina/NC",37183,"Wake County, North Carolina",1046558,17654,243,1687,23,1,59,9,0,0,88,0,59,97,0,88,9,97,156,38,0,56,6,56,6,0,0,38,62,62,0
37,North Carolina/NC,3701208,"Wake County (Southwest)--Apex & Holly Springs Towns PUMA, North Carolina/NC",37183,"Wake County, North Carolina",1046558,17654,243,1687,23,1,76,0,87,10,28,0,86,28,87,28,87,115,201,38,5,14,43,14,0,0,43,43,57,14,43
37,North Carolina/NC,3701301,"Durham County (South)--Durham City (South) PUMA, North Carolina/NC",37063,"Durham County, North Carolina",306457,7682,95,2507,31,1,264,0,319,41,36,0,305,36,319,36,319,355,660,40,6,5,48,5,0,0,48,46,54,5,48
37,North Carolina/NC,3701302,"Durham County (North)--Durham City (North) PUMA, North Carolina/NC",37063,"Durham County, North Carolina",306457,7682,95,2507,31,1,162,0,57,0,0,19,162,0,76,19,57,76,238,68,0,8,24,0,0,8,24,68,32,0,32
37,North Carolina/NC,3701400,"Orange County--Chapel Hill Town PUMA, North Carolina/NC",37135,"Orange County, North Carolina",142938,2636,55,1844,38,1,147,0,41,0,40,0,147,40,41,40,41,81,228,64,0,18,18,18,0,0,18,64,36,18,18
37,North Carolina/NC,3701500,"Chatham & Lee Counties PUMA, North Carolina/NC",37037,"Chatham County, North Carolina",69791,1654,57,2370,82,0.548,215,88,258,88,0,0,303,88,258,0,346,346,649,33,14,0,53,0,14,0,40,47,53,14,40
37,North Carolina/NC,3701500,"Chatham & Lee Counties PUMA, North Carolina/NC",37105,"Lee County, North Carolina",60125,1631,14,2713,23,0.452,177,73,213,72,0,0,249,73,213,0,286,286,535,33,13,0,53,0,14,0,40,47,53,14,40
37,North Carolina/NC,3701600,"Alamance County--Burlington City PUMA, North Carolina/NC",37001,"Alamance County, North Carolina",160576,3881,54,2417,34,1,280,66,406,25,0,0,305,66,406,0,472,472,777,36,3,0,61,0,8,0,52,39,61,8,52
37,North Carolina/NC,3701701,"Greensboro City (North) PUMA, North Carolina/NC",37081,"Guilford County, North Carolina",523582,8463,180,1616,34,1,78,41,108,112,0,54,190,41,162,54,149,203,393,20,28,14,38,0,10,14,27,48,52,10,41
37,North Carolina/NC,3701702,"Greensboro City (South) PUMA, North Carolina/NC",37081,"Guilford County, North Carolina",523582,8463,180,1616,34,1,210,28,29,10,0,0,220,28,29,0,57,57,277,76,4,0,21,0,10,0,10,79,21,10,10
37,North Carolina/NC,3701703,"Guilford County (North)--Summerfield Town PUMA, North Carolina/NC",37081,"Guilford County, North Carolina",523582,8463,180,1616,34,1,374,0,108,21,0,52,395,0,160,52,108,160,555,67,4,9,19,0,0,9,19,71,29,0,29
37,North Carolina/NC,3701704,"Guilford County (South)--High Point City PUMA, North Carolina/NC",37081,"Guilford County, North Carolina",523582,8463,180,1616,34,1,49,13,83,0,0,239,49,13,322,239,96,335,384,13,0,62,25,0,3,62,22,13,87,3,84
37,North Carolina/NC,3701801,"Winston-Salem City (North) PUMA, North Carolina/NC",37067,"Forsyth County, North Carolina",371573,6956,98,1872,26,1,320,0,36,13,28,78,333,28,114,106,36,142,475,67,3,22,8,6,0,16,8,70,30,6,24
37,North Carolina/NC,3701802,"Winston-Salem City (South) PUMA, North Carolina/NC",37067,"Forsyth County, North Carolina",371573,6956,98,1872,26,1,160,0,25,19,0,0,179,0,25,0,25,25,204,78,9,0,12,0,0,0,12,88,12,0,12
37,North Carolina/NC,3701803,"Forsyth County (Outside Winston-Salem City)--Kernersville Town & Clemmons Village PUMA, North Carolina/NC",37067,"Forsyth County, North Carolina",371573,6956,98,1872,26,1,294,48,29,0,0,0,294,48,29,0,77,77,371,79,0,0,21,0,13,0,8,79,21,13,8
37,North Carolina/NC,3701900,"Davie, Yadkin & Iredell (North) Counties PUMA, North Carolina/NC",37059,"Davie County, North Carolina",41991,553,6,1317,14,0.394,162,12,88,0,0,0,162,12,88,0,100,100,262,62,0,0,38,0,5,0,34,62,38,5,34
37,North Carolina/NC,3701900,"Davie, Yadkin & Iredell (North) Counties PUMA, North Carolina/NC",37097,"Iredell County, North Carolina",172525,3045,30,1765,17,0.254,104,8,57,0,0,0,104,8,57,0,65,65,169,62,0,0,38,0,5,0,34,62,38,5,34
37,North Carolina/NC,3701900,"Davie, Yadkin & Iredell (North) Counties PUMA, North Carolina/NC",37197,"Yadkin County, North Carolina",37665,736,7,1954,19,0.352,145,11,78,0,0,0,145,11,78,0,89,89,234,62,0,0,38,0,5,0,33,62,38,5,33
37,North Carolina/NC,3702000,"Caldwell & Alexander Counties PUMA, North Carolina/NC",37003,"Alexander County, North Carolina",37119,516,7,1390,19,0.315,82,31,73,24,0,0,106,31,73,0,104,104,210,39,11,0,50,0,15,0,35,50,50,15,35
37,North Carolina/NC,3702000,"Caldwell & Alexander Counties PUMA, North Carolina/NC",37027,"Caldwell County, North Carolina",81779,1653,18,2021,22,0.685,178,68,159,53,0,0,231,68,159,0,227,227,458,39,12,0,50,0,15,0,35,50,50,15,35
37,North Carolina/NC,3702100,"Burke & McDowell Counties PUMA, North Carolina/NC",37023,"Burke County, North Carolina",89712,2104,38,2345,42,0.663,174,0,121,148,19,18,322,19,139,37,121,158,480,36,31,8,25,4,0,4,25,67,33,4,29
37,North Carolina/NC,3702100,"Burke & McDowell Counties PUMA, North Carolina/NC",37111,"McDowell County, North Carolina",45109,972,26,2155,58,0.337,89,0,62,75,10,9,164,10,71,19,62,81,245,36,31,8,25,4,0,4,25,67,33,4,29
37,North Carolina/NC,3702201,"Buncombe County (Southeast)--Asheville City PUMA, North Carolina/NC",37021,"Buncombe County, North Carolina",254474,3081,82,1211,32,1,132,0,88,0,0,0,132,0,88,0,88,88,220,60,0,0,40,0,0,0,40,60,40,0,40
37,North Carolina/NC,3702202,"Buncombe County (Northwest) PUMA, North Carolina/NC",37021,"Buncombe County, North Carolina",254474,3081,82,1211,32,1,176,0,112,17,0,0,193,0,112,0,112,112,305,58,6,0,37,0,0,0,37,63,37,0,37
37,North Carolina/NC,3702300,"Haywood, Madison, Swain, Graham & Jackson (North) Counties PUMA, North Carolina/NC",37075,"Graham County, North Carolina",8557,143,3,1671,35,0.077,13,2,9,3,0,0,16,2,9,0,11,11,27,48,11,0,41,0,7,0,33,59,41,7,33
37,North Carolina/NC,3702300,"Haywood, Madison, Swain, Graham & Jackson (North) Counties PUMA, North Carolina/NC",37087,"Haywood County, North Carolina",60433,603,31,998,51,0.546,92,12,65,24,0,0,116,12,65,0,77,77,193,48,12,0,40,0,6,0,34,60,40,6,34
37,North Carolina/NC,3702300,"Haywood, Madison, Swain, Graham & Jackson (North) Counties PUMA, North Carolina/NC",37099,"Jackson County, North Carolina",42256,638,7,1510,17,0.056,9,1,7,2,0,0,11,1,7,0,8,8,19,47,11,0,42,0,5,0,37,58,42,5,37
37,North Carolina/NC,3702300,"Haywood, Madison, Swain, Graham & Jackson (North) Counties PUMA, North Carolina/NC",37115,"Madison County, North Carolina",21405,99,1,463,5,0.192,32,4,23,8,0,0,40,4,23,0,27,27,67,48,12,0,40,0,6,0,34,60,40,6,34
37,North Carolina/NC,3702300,"Haywood, Madison, Swain, Graham & Jackson (North) Counties PUMA, North Carolina/NC",37173,"Swain County, North Carolina",14254,142,3,996,21,0.129,22,3,15,6,0,0,28,3,15,0,18,18,46,48,13,0,39,0,7,0,33,61,39,7,33
37,North Carolina/NC,3702400,"Jackson (South), Macon, Cherokee & Clay Counties PUMA, North Carolina/NC",37039,"Cherokee County, North Carolina",27668,614,12,2219,43,0.255,92,3,9,5,0,0,97,3,9,0,12,12,109,84,5,0,11,0,3,0,8,89,11,3,8
37,North Carolina/NC,3702400,"Jackson (South), Macon, Cherokee & Clay Counties PUMA, North Carolina/NC",37043,"Clay County, North Carolina",10813,116,2,1073,18,0.1,36,1,4,2,0,0,38,1,4,0,5,5,43,84,5,0,12,0,2,0,9,88,12,2,9
37,North Carolina/NC,3702400,"Jackson (South), Macon, Cherokee & Clay Counties PUMA, North Carolina/NC",37099,"Jackson County, North Carolina",42256,638,7,1510,17,0.33,118,4,12,7,0,0,125,4,12,0,16,16,141,84,5,0,11,0,3,0,9,89,11,3,9
37,North Carolina/NC,3702400,"Jackson (South), Macon, Cherokee & Clay Counties PUMA, North Carolina/NC",37113,"Macon County, North Carolina",34410,593,2,1723,6,0.315,113,3,12,7,0,0,120,3,12,0,15,15,135,84,5,0,11,0,2,0,9,89,11,2,9
37,North Carolina/NC,3702500,"Henderson & Transylvania Counties PUMA, North Carolina/NC",37089,"Henderson County, North Carolina",113625,1994,64,1755,56,0.773,63,0,422,0,0,0,63,0,422,0,422,422,485,13,0,0,87,0,0,0,87,13,87,0,87
37,North Carolina/NC,3702500,"Henderson & Transylvania Counties PUMA, North Carolina/NC",37175,"Transylvania County, North Carolina",33513,329,7,982,21,0.227,19,0,124,0,0,0,19,0,124,0,124,124,143,13,0,0,87,0,0,0,87,13,87,0,87
37,North Carolina/NC,3702600,"Rutherford, Cleveland (West) & Polk Counties--Shelby City PUMA, North Carolina/NC",37045,"Cleveland County, North Carolina",97159,2176,61,2240,63,0.363,131,23,36,0,0,0,131,23,36,0,59,59,190,69,0,0,31,0,12,0,19,69,31,12,19
37,North Carolina/NC,3702600,"Rutherford, Cleveland (West) & Polk Counties--Shelby City PUMA, North Carolina/NC",37149,"Polk County, North Carolina",20458,308,10,1506,49,0.149,54,10,15,0,0,0,54,10,15,0,25,25,79,68,0,0,32,0,13,0,19,68,32,13,19
37,North Carolina/NC,3702600,"Rutherford, Cleveland (West) & Polk Counties--Shelby City PUMA, North Carolina/NC",37161,"Rutherford County, North Carolina",66532,1191,33,1790,50,0.487,176,31,48,0,0,0,176,31,48,0,79,79,255,69,0,0,31,0,12,0,19,69,31,12,19
37,North Carolina/NC,3702700,"Lincoln & Cleveland (East) Counties PUMA, North Carolina/NC",37045,"Cleveland County, North Carolina",97159,2176,61,2240,63,0.37,113,16,24,0,0,11,113,16,35,11,40,51,164,69,0,7,24,0,10,7,15,69,31,10,21
37,North Carolina/NC,3702700,"Lincoln & Cleveland (East) Counties PUMA, North Carolina/NC",37109,"Lincoln County, North Carolina",81441,1575,14,1934,17,0.63,193,27,42,0,0,18,193,27,60,18,69,87,280,69,0,6,25,0,10,6,15,69,31,10,21
37,North Carolina/NC,3702800,"Catawba County--Hickory City PUMA, North Carolina/NC",37035,"Catawba County, North Carolina",156729,3129,52,1996,33,1,332,12,51,0,28,0,332,40,51,28,63,91,423,78,0,7,15,7,3,0,12,78,22,9,12
37,North Carolina/NC,3702900,"Iredell (South)--Mooresville Town & Statesville City PUMA, North Carolina/NC",37097,"Iredell County, North Carolina",172525,3045,30,1765,17,1,426,25,66,0,0,0,426,25,66,0,91,91,517,82,0,0,18,0,5,0,13,82,18,5,13
37,North Carolina/NC,3703001,"Gaston County (Northwest)--Mount Holly City PUMA, North Carolina/NC",37071,"Gaston County, North Carolina",216585,5087,81,2349,37,1,146,0,100,0,0,0,146,0,100,0,100,100,246,59,0,0,41,0,0,0,41,59,41,0,41
37,North Carolina/NC,3703002,"Gaston County (Southeast)--Gastonia & Belmont Cities PUMA, North Carolina/NC",37071,"Gaston County, North Carolina",216585,5087,81,2349,37,1,222,26,13,104,8,0,326,34,13,8,39,47,373,60,28,2,10,2,7,0,3,87,13,9,3
37,North Carolina/NC,3703101,"Charlotte City (Central) PUMA, North Carolina/NC",37119,"Mecklenburg County, North Carolina",1054314,28416,355,2695,34,1,168,0,112,11,65,117,179,65,229,182,112,294,473,36,2,38,24,14,0,25,24,38,62,14,48
37,North Carolina/NC,3703102,"Charlotte City (Northwest) PUMA, North Carolina/NC",37119,"Mecklenburg County, North Carolina",1054314,28416,355,2695,34,1,377,0,53,16,53,111,393,53,164,164,53,217,610,62,3,27,9,9,0,18,9,64,36,9,27
37,North Carolina/NC,3703103,"Charlotte City (Northeast) PUMA, North Carolina/NC",37119,"Mecklenburg County, North Carolina",1054314,28416,355,2695,34,1,207,0,132,0,26,133,207,26,265,159,132,291,498,42,0,32,27,5,0,27,27,42,58,5,53
37,North Carolina/NC,3703104,"Charlotte City (South) PUMA, North Carolina/NC",37119,"Mecklenburg County, North Carolina",1054314,28416,355,2695,34,1,98,26,11,23,0,0,121,26,11,0,37,37,158,62,15,0,23,0,16,0,7,77,23,16,7
37,North Carolina/NC,3703105,"Charlotte City (Southwest) PUMA, North Carolina/NC",37119,"Mecklenburg County, North Carolina",1054314,28416,355,2695,34,1,172,21,248,0,9,18,172,30,266,27,269,296,468,37,0,6,57,2,4,4,53,37,63,6,57
37,North Carolina/NC,3703106,"Mecklenburg County (North)--Huntersville, Cornelius & Davidson Towns PUMA, North Carolina/NC",37119,"Mecklenburg County, North Carolina",1054314,28416,355,2695,34,1,72,30,0,0,0,0,72,30,0,0,30,30,102,71,0,0,29,0,29,0,0,71,29,29,0
37,North Carolina/NC,3703107,"Mecklenburg County (East)--Mint Hill & Matthews (North) Towns PUMA, North Carolina/NC",37119,"Mecklenburg County, North Carolina",1054314,28416,355,2695,34,1,172,25,41,0,0,0,172,25,41,0,66,66,238,72,0,0,28,0,11,0,17,72,28,11,17
37,North Carolina/NC,3703108,"Mecklenburg County (South)--Matthews Town (South) PUMA, North Carolina/NC",37119,"Mecklenburg County, North Carolina",1054314,28416,355,2695,34,1,109,60,107,0,12,0,109,72,107,12,167,179,288,38,0,4,58,4,21,0,37,38,62,25,37
37,North Carolina/NC,3703200,"Cabarrus County (West)--Concord, Kannapolis Cities & Harrisburg Town PUMA, North Carolina/NC",37025,"Cabarrus County, North Carolina",201448,3966,68,1969,34,1,311,158,43,34,0,0,345,158,43,0,201,201,546,57,6,0,37,0,29,0,8,63,37,29,8
37,North Carolina/NC,3703300,"Stanley & Cabarrus (East) Counties PUMA, North Carolina/NC",37025,"Cabarrus County, North Carolina",201448,3966,68,1969,34,0.455,175,0,30,0,13,0,175,13,30,13,30,43,218,80,0,6,14,6,0,0,14,80,20,6,14
37,North Carolina/NC,3703300,"Stanley & Cabarrus (East) Counties PUMA, North Carolina/NC",37167,"Stanly County, North Carolina",61114,1891,56,3094,92,0.545,209,0,37,0,16,0,209,16,37,16,37,53,262,80,0,6,14,6,0,0,14,80,20,6,14
37,North Carolina/NC,3703400,"Rowan County PUMA, North Carolina/NC",37159,"Rowan County, North Carolina",139605,3325,97,2382,69,1,361,0,121,68,0,0,429,0,121,0,121,121,550,66,12,0,22,0,0,0,22,78,22,0,22
37,North Carolina/NC,3703500,"Davidson County PUMA, North Carolina/NC",37057,"Davidson County, North Carolina",164664,2714,34,1648,21,1,375,38,53,16,48,0,391,86,53,48,91,139,530,71,3,9,17,9,7,0,10,74,26,16,10
37,North Carolina/NC,3703600,"Randolph County PUMA, North Carolina/NC",37151,"Randolph County, North Carolina",142958,2809,52,1965,36,1,273,0,67,0,0,0,273,0,67,0,67,67,340,80,0,0,20,0,0,0,20,80,20,0,20
37,North Carolina/NC,3703700,"Moore & Montgomery Counties PUMA, North Carolina/NC",37123,"Montgomery County, North Carolina",27338,1042,30,3812,110,0.223,158,2,22,25,0,0,183,2,22,0,24,24,207,76,12,0,12,0,1,0,11,88,12,1,11
37,North Carolina/NC,3703700,"Moore & Montgomery Counties PUMA, North Carolina/NC",37125,"Moore County, North Carolina",95629,1630,27,1705,28,0.777,551,7,76,86,0,0,637,7,76,0,83,83,720,77,12,0,12,0,1,0,11,88,12,1,11
37,North Carolina/NC,3703800,"Harnett County PUMA, North Carolina/NC",37085,"Harnett County, North Carolina",130361,2210,52,1695,40,1,582,0,151,0,0,0,582,0,151,0,151,151,733,79,0,0,21,0,0,0,21,79,21,0,21
37,North Carolina/NC,3703900,"Sampson & Duplin Counties PUMA, North Carolina/NC",37061,"Duplin County, North Carolina",59062,2372,53,4016,90,0.483,1204,179,1654,83,41,35,1287,220,1689,76,1833,1909,3196,38,3,2,57,1,6,1,52,40,60,7,53
37,North Carolina/NC,3703900,"Sampson & Duplin Counties PUMA, North Carolina/NC",37163,"Sampson County, North Carolina",63561,2200,28,3461,44,0.517,1288,191,1770,88,44,37,1376,235,1807,81,1961,2042,3418,38,3,2,57,1,6,1,52,40,60,7,53
37,North Carolina/NC,3704000,"Wayne County PUMA, North Carolina/NC",37191,"Wayne County, North Carolina",124002,3336,67,2690,54,1,1294,198,1469,215,49,365,1509,247,1834,414,1667,2081,3590,36,6,12,46,1,6,10,41,42,58,7,51
37,North Carolina/NC,3704100,"Lenoir, Onslow (North) & Jones Counties PUMA, North Carolina/NC",37103,"Jones County, North Carolina",9695,157,11,1619,113,0.09,107,4,28,16,0,0,123,4,28,0,32,32,155,69,10,0,21,0,3,0,18,79,21,3,18
37,North Carolina/NC,3704100,"Lenoir, Onslow (North) & Jones Counties PUMA, North Carolina/NC",37107,"Lenoir County, North Carolina",57227,996,31,1740,54,0.525,622,26,161,91,0,0,713,26,161,0,187,187,900,69,10,0,21,0,3,0,18,79,21,3,18
37,North Carolina/NC,3704100,"Lenoir, Onslow (North) & Jones Counties PUMA, North Carolina/NC",37133,"Onslow County, North Carolina",193912,2151,25,1109,13,0.385,456,19,118,67,0,0,523,19,118,0,137,137,660,69,10,0,21,0,3,0,18,79,21,3,18
37,North Carolina/NC,3704200,"Pitt County--Greenville City PUMA, North Carolina/NC",37147,"Pitt County, North Carolina",177372,4852,29,2735,16,1,762,14,209,31,0,0,793,14,209,0,223,223,1016,75,3,0,22,0,1,0,21,78,22,1,21
37,North Carolina/NC,3704300,"Craven County PUMA, North Carolina/NC",37049,"Craven County, North Carolina",103082,1591,34,1543,33,1,218,69,332,59,0,0,277,69,332,0,401,401,678,32,9,0,59,0,10,0,49,41,59,10,49
37,North Carolina/NC,3704400,"Carteret, Beaufort & Pamlico Counties PUMA, North Carolina/NC",37013,"Beaufort County, North Carolina",47243,918,23,1943,49,0.368,166,0,12,3,0,0,169,0,12,0,12,12,181,92,2,0,7,0,0,0,7,93,7,0,7
37,North Carolina/NC,3704400,"Carteret, Beaufort & Pamlico Counties PUMA, North Carolina/NC",37031,"Carteret County, North Carolina",68920,677,5,982,7,0.533,241,0,17,4,0,0,245,0,17,0,17,17,262,92,2,0,6,0,0,0,6,94,6,0,6
37,North Carolina/NC,3704400,"Carteret, Beaufort & Pamlico Counties PUMA, North Carolina/NC",37137,"Pamlico County, North Carolina",12742,267,2,2095,16,0.099,45,0,3,1,0,0,46,0,3,0,3,3,49,92,2,0,6,0,0,0,6,94,6,0,6
37,North Carolina/NC,3704500,"Onslow County (South)--Jacksonville City PUMA, North Carolina/NC",37133,"Onslow County, North Carolina",193912,2151,25,1109,13,1,113,0,20,0,0,0,113,0,20,0,20,20,133,85,0,0,15,0,0,0,15,85,15,0,15
37,North Carolina/NC,3704600,"Pender & New Hanover (North) Counties PUMA, North Carolina/NC",37129,"New Hanover County, North Carolina",224231,4231,30,1887,13,0.487,121,18,160,16,0,6,137,18,166,6,178,184,321,38,5,2,55,0,6,2,50,43,57,6,52
37,North Carolina/NC,3704600,"Pender & New Hanover (North) Counties PUMA, North Carolina/NC",37141,"Pender County, North Carolina",59020,940,5,1593,8,0.513,128,18,168,17,0,7,145,18,175,7,186,193,338,38,5,2,55,0,5,2,50,43,57,5,52
37,North Carolina/NC,3704700,"New Hanover County (South)--Wilmington City PUMA, North Carolina/NC",37129,"New Hanover County, North Carolina",224231,4231,30,1887,13,1,128,0,82,0,0,0,128,0,82,0,82,82,210,61,0,0,39,0,0,0,39,61,39,0,39
37,North Carolina/NC,3704800,"Brunswick County PUMA, North Carolina/NC",37019,"Brunswick County, North Carolina",126860,1622,26,1279,20,1,248,0,7,0,0,0,248,0,7,0,7,7,255,97,0,0,3,0,0,0,3,97,3,0,3
37,North Carolina/NC,3704900,"Columbus, Bladen & Robeson (East) Counties PUMA, North Carolina/NC",37017,"Bladen County, North Carolina",33778,893,15,2644,44,0.325,373,5,119,9,0,0,382,5,119,0,124,124,506,74,2,0,25,0,1,0,24,75,25,1,24
37,North Carolina/NC,3704900,"Columbus, Bladen & Robeson (East) Counties PUMA, North Carolina/NC",37047,"Columbus County, North Carolina",56293,1357,56,2411,99,0.545,626,8,200,16,0,0,642,8,200,0,208,208,850,74,2,0,24,0,1,0,24,76,24,1,24
37,North Carolina/NC,3704900,"Columbus, Bladen & Robeson (East) Counties PUMA, North Carolina/NC",37155,"Robeson County, North Carolina",133442,4455,75,3339,56,0.129,148,2,47,4,0,0,152,2,47,0,49,49,201,74,2,0,24,0,1,0,23,76,24,1,23
37,North Carolina/NC,3705001,"Cumberland County (Central)--Fayetteville City (Central & East) PUMA, North Carolina/NC",37051,"Cumberland County, North Carolina",332106,5389,76,1623,23,1,751,0,18,106,8,60,857,8,78,68,18,86,943,80,11,7,2,1,0,6,2,91,9,1,8
37,North Carolina/NC,3705002,"Cumberland County (East)--Hope Mills & Spring Lake Towns PUMA, North Carolina/NC",37051,"Cumberland County, North Carolina",332106,5389,76,1623,23,1,307,53,218,12,23,171,319,76,389,194,271,465,784,39,2,25,35,3,7,22,28,41,59,10,50
37,North Carolina/NC,3705003,"Cumberland County (West)--Fayetteville City (West) PUMA, North Carolina/NC",37051,"Cumberland County, North Carolina",332106,5389,76,1623,23,1,472,33,148,195,21,0,667,54,148,21,181,202,869,54,22,2,21,2,4,0,17,77,23,6,17
37,North Carolina/NC,3705100,"Robeson County (West)--Lumberton City PUMA, North Carolina/NC",37155,"Robeson County, North Carolina",133442,4455,75,3339,56,1,2550,122,914,192,8,12,2742,130,926,20,1036,1056,3798,67,5,1,27,0,3,0,24,72,28,3,24
37,North Carolina/NC,3705200,"Hoke, Richmond & Scotland Counties PUMA, North Carolina/NC",37093,"Hoke County, North Carolina",53239,1138,17,2138,32,0.399,772,0,139,36,11,0,808,11,139,11,139,150,958,81,4,1,15,1,0,0,15,84,16,1,15
37,North Carolina/NC,3705200,"Hoke, Richmond & Scotland Counties PUMA, North Carolina/NC",37153,"Richmond County, North Carolina",45189,995,16,2202,35,0.337,652,0,117,30,9,0,682,9,117,9,117,126,808,81,4,1,14,1,0,0,14,84,16,1,14
37,North Carolina/NC,3705200,"Hoke, Richmond & Scotland Counties PUMA, North Carolina/NC",37165,"Scotland County, North Carolina",35262,1095,13,3105,37,0.264,511,0,92,23,7,0,534,7,92,7,92,99,633,81,4,1,15,1,0,0,15,84,16,1,15
37,North Carolina/NC,3705300,"Union (East) & Anson Counties--Monroe City PUMA, North Carolina/NC",37007,"Anson County, North Carolina",25306,577,4,2280,16,0.201,194,40,89,23,7,0,217,47,89,7,129,136,353,55,7,2,37,2,11,0,25,61,39,13,25
37,North Carolina/NC,3705300,"Union (East) & Anson Counties--Monroe City PUMA, North Carolina/NC",37179,"Union County, North Carolina",226694,4750,59,2095,26,0.799,772,159,356,93,29,0,865,188,356,29,515,544,1409,55,7,2,37,2,11,0,25,61,39,13,25
37,North Carolina/NC,3705400,"Union County (West)--Indian Trail & Stallings Towns PUMA, North Carolina/NC",37179,"Union County, North Carolina",226694,4750,59,2095,26,1,47,0,0,53,0,0,100,0,0,0,0,0,100,47,53,0,0,0,0,0,0,100,0,0,0
38,North Dakota/ND,3800100,"West North Dakota--Minot City PUMA, North Dakota/ND",38001,"Adams County, North Dakota",2351,20,0,851,0,0.011,21,0,1,0,0,0,21,0,1,0,1,1,22,95,0,0,5,0,0,0,5,95,5,0,5
38,North Dakota/ND,3800100,"West North Dakota--Minot City PUMA, North Dakota/ND",38007,"Billings County, North Dakota",946,15,0,1586,0,0.004,8,0,0,0,0,0,8,0,0,0,0,0,8,100,0,0,0,0,0,0,0,100,0,0,0
38,North Dakota/ND,3800100,"West North Dakota--Minot City PUMA, North Dakota/ND",38011,"Bowman County, North Dakota",3195,36,0,1127,0,0.015,29,0,1,0,0,0,29,0,1,0,1,1,30,97,0,0,3,0,0,0,3,97,3,0,3
38,North Dakota/ND,3800100,"West North Dakota--Minot City PUMA, North Dakota/ND",38013,"Burke County, North Dakota",2213,33,1,1491,45,0.01,19,0,0,0,0,0,19,0,0,0,0,0,19,100,0,0,0,0,0,0,0,100,0,0,0
38,North Dakota/ND,3800100,"West North Dakota--Minot City PUMA, North Dakota/ND",38023,"Divide County, North Dakota",2369,7,0,295,0,0.011,21,0,1,0,0,0,21,0,1,0,1,1,22,95,0,0,5,0,0,0,5,95,5,0,5
38,North Dakota/ND,3800100,"West North Dakota--Minot City PUMA, North Dakota/ND",38025,"Dunn County, North Dakota",4387,100,1,2279,23,0.02,38,0,1,0,0,0,38,0,1,0,1,1,39,97,0,0,3,0,0,0,3,97,3,0,3
38,North Dakota/ND,3800100,"West North Dakota--Minot City PUMA, North Dakota/ND",38033,"Golden Valley County, North Dakota",1882,43,0,2285,0,0.008,15,0,0,0,0,0,15,0,0,0,0,0,15,100,0,0,0,0,0,0,0,100,0,0,0
38,North Dakota/ND,3800100,"West North Dakota--Minot City PUMA, North Dakota/ND",38037,"Grant County, North Dakota",2380,17,0,714,0,0.011,21,0,1,0,0,0,21,0,1,0,1,1,22,95,0,0,5,0,0,0,5,95,5,0,5
38,North Dakota/ND,3800100,"West North Dakota--Minot City PUMA, North Dakota/ND",38041,"Hettinger County, North Dakota",2576,59,0,2290,0,0.012,23,0,1,0,0,0,23,0,1,0,1,1,24,96,0,0,4,0,0,0,4,96,4,0,4
38,North Dakota/ND,3800100,"West North Dakota--Minot City PUMA, North Dakota/ND",38049,"McHenry County, North Dakota",5927,59,1,995,17,0.028,53,0,1,0,0,0,53,0,1,0,1,1,54,98,0,0,2,0,0,0,2,98,2,0,2
38,North Dakota/ND,3800100,"West North Dakota--Minot City PUMA, North Dakota/ND",38053,"McKenzie County, North Dakota",12536,219,2,1747,16,0.059,112,0,3,0,0,0,112,0,3,0,3,3,115,97,0,0,3,0,0,0,3,97,3,0,3
38,North Dakota/ND,3800100,"West North Dakota--Minot City PUMA, North Dakota/ND",38055,"McLean County, North Dakota",9608,266,2,2769,21,0.045,86,0,2,0,0,0,86,0,2,0,2,2,88,98,0,0,2,0,0,0,2,98,2,0,2
38,North Dakota/ND,3800100,"West North Dakota--Minot City PUMA, North Dakota/ND",38057,"Mercer County, North Dakota",8570,140,0,1634,0,0.04,76,0,2,0,0,0,76,0,2,0,2,2,78,97,0,0,3,0,0,0,3,97,3,0,3
38,North Dakota/ND,3800100,"West North Dakota--Minot City PUMA, North Dakota/ND",38061,"Mountrail County, North Dakota",10152,242,2,2384,20,0.048,91,0,2,0,0,0,91,0,2,0,2,2,93,98,0,0,2,0,0,0,2,98,2,0,2
38,North Dakota/ND,3800100,"West North Dakota--Minot City PUMA, North Dakota/ND",38065,"Oliver County, North Dakota",1837,20,0,1089,0,0.009,17,0,0,0,0,0,17,0,0,0,0,0,17,100,0,0,0,0,0,0,0,100,0,0,0
38,North Dakota/ND,3800100,"West North Dakota--Minot City PUMA, North Dakota/ND",38075,"Renville County, North Dakota",2495,57,0,2285,0,0.012,23,0,1,0,0,0,23,0,1,0,1,1,24,96,0,0,4,0,0,0,4,96,4,0,4
38,North Dakota/ND,3800100,"West North Dakota--Minot City PUMA, North Dakota/ND",38085,"Sioux County, North Dakota",4413,147,3,3331,68,0.021,40,0,1,0,0,0,40,0,1,0,1,1,41,98,0,0,2,0,0,0,2,98,2,0,2
38,North Dakota/ND,3800100,"West North Dakota--Minot City PUMA, North Dakota/ND",38087,"Slope County, North Dakota",704,7,0,994,0,0.004,8,0,0,0,0,0,8,0,0,0,0,0,8,100,0,0,0,0,0,0,0,100,0,0,0
38,North Dakota/ND,3800100,"West North Dakota--Minot City PUMA, North Dakota/ND",38089,"Stark County, North Dakota",30876,1523,10,4933,32,0.145,276,0,7,0,0,1,276,0,8,1,7,8,284,97,0,0,2,0,0,0,2,97,3,0,3
38,North Dakota/ND,3800100,"West North Dakota--Minot City PUMA, North Dakota/ND",38101,"Ward County, North Dakota",69034,987,8,1430,12,0.327,623,0,15,1,0,2,624,0,17,2,15,17,641,97,0,0,2,0,0,0,2,97,3,0,3
38,North Dakota/ND,3800100,"West North Dakota--Minot City PUMA, North Dakota/ND",38105,"Williams County, North Dakota",34061,953,7,2798,21,0.16,305,0,8,0,0,1,305,0,9,1,8,9,314,97,0,0,3,0,0,0,3,97,3,0,3
38,North Dakota/ND,3800200,"East Central North Dakota--Jamestown City PUMA, North Dakota/ND",38003,"Barnes County, North Dakota",10836,228,0,2104,0,0.088,217,0,6,1,1,1,218,1,7,2,6,8,226,96,0,1,3,0,0,0,3,96,4,0,3
38,North Dakota/ND,3800200,"East Central North Dakota--Jamestown City PUMA, North Dakota/ND",38005,"Benson County, North Dakota",6886,340,6,4938,87,0.054,133,0,4,0,0,0,133,0,4,0,4,4,137,97,0,0,3,0,0,0,3,97,3,0,3
38,North Dakota/ND,3800200,"East Central North Dakota--Jamestown City PUMA, North Dakota/ND",38009,"Bottineau County, North Dakota",6589,65,1,986,15,0.053,130,0,4,0,0,0,130,0,4,0,4,4,134,97,0,0,3,0,0,0,3,97,3,0,3
38,North Dakota/ND,3800200,"East Central North Dakota--Jamestown City PUMA, North Dakota/ND",38021,"Dickey County, North Dakota",4970,62,0,1247,0,0.041,101,0,3,0,0,0,101,0,3,0,3,3,104,97,0,0,3,0,0,0,3,97,3,0,3
38,North Dakota/ND,3800200,"East Central North Dakota--Jamestown City PUMA, North Dakota/ND",38027,"Eddy County, North Dakota",2313,79,3,3415,130,0.019,47,0,1,0,0,0,47,0,1,0,1,1,48,98,0,0,2,0,0,0,2,98,2,0,2
38,North Dakota/ND,3800200,"East Central North Dakota--Jamestown City PUMA, North Dakota/ND",38031,"Foster County, North Dakota",3290,61,0,1854,0,0.026,64,0,2,0,0,0,64,0,2,0,2,2,66,97,0,0,3,0,0,0,3,97,3,0,3
38,North Dakota/ND,3800200,"East Central North Dakota--Jamestown City PUMA, North Dakota/ND",38045,"LaMoure County, North Dakota",4100,53,0,1293,0,0.033,81,0,2,0,0,0,81,0,2,0,2,2,83,98,0,0,2,0,0,0,2,98,2,0,2
38,North Dakota/ND,3800200,"East Central North Dakota--Jamestown City PUMA, North Dakota/ND",38063,"Nelson County, North Dakota",2920,48,0,1644,0,0.024,59,0,2,0,0,0,59,0,2,0,2,2,61,97,0,0,3,0,0,0,3,97,3,0,3
38,North Dakota/ND,3800200,"East Central North Dakota--Jamestown City PUMA, North Dakota/ND",38069,"Pierce County, North Dakota",4210,31,0,736,0,0.034,84,0,2,0,0,0,84,0,2,0,2,2,86,98,0,0,2,0,0,0,2,98,2,0,2
38,North Dakota/ND,3800200,"East Central North Dakota--Jamestown City PUMA, North Dakota/ND",38071,"Ramsey County, North Dakota",11557,207,2,1791,17,0.093,229,0,7,1,1,1,230,1,8,2,7,9,239,96,0,1,3,0,0,0,3,96,4,0,3
38,North Dakota/ND,3800200,"East Central North Dakota--Jamestown City PUMA, North Dakota/ND",38073,"Ransom County, North Dakota",5361,80,0,1492,0,0.043,106,0,3,0,0,0,106,0,3,0,3,3,109,97,0,0,3,0,0,0,3,97,3,0,3
38,North Dakota/ND,3800200,"East Central North Dakota--Jamestown City PUMA, North Dakota/ND",38077,"Richland County, North Dakota",16288,227,1,1394,6,0.131,322,0,10,1,1,1,323,1,11,2,10,12,335,96,0,1,3,0,0,0,3,96,4,0,3
38,North Dakota/ND,3800200,"East Central North Dakota--Jamestown City PUMA, North Dakota/ND",38079,"Rolette County, North Dakota",14603,175,4,1198,27,0.118,290,0,9,1,1,1,291,1,10,2,9,11,302,96,0,1,3,0,0,0,3,96,4,0,3
38,North Dakota/ND,3800200,"East Central North Dakota--Jamestown City PUMA, North Dakota/ND",38081,"Sargent County, North Dakota",3883,71,0,1828,0,0.031,76,0,2,0,0,0,76,0,2,0,2,2,78,97,0,0,3,0,0,0,3,97,3,0,3
38,North Dakota/ND,3800200,"East Central North Dakota--Jamestown City PUMA, North Dakota/ND",38083,"Sheridan County, North Dakota",1405,10,0,712,0,0.011,27,0,1,0,0,0,27,0,1,0,1,1,28,96,0,0,4,0,0,0,4,96,4,0,4
38,North Dakota/ND,3800200,"East Central North Dakota--Jamestown City PUMA, North Dakota/ND",38093,"Stutsman County, North Dakota",21064,505,3,2397,14,0.169,416,0,12,2,1,1,418,1,13,2,12,14,432,96,0,0,3,0,0,0,3,97,3,0,3
38,North Dakota/ND,3800200,"East Central North Dakota--Jamestown City PUMA, North Dakota/ND",38103,"Wells County, North Dakota",4055,33,0,814,0,0.033,81,0,2,0,0,0,81,0,2,0,2,2,83,98,0,0,2,0,0,0,2,98,2,0,2
38,North Dakota/ND,3800300,"South Central North Dakota--Bismarck City PUMA, North Dakota/ND",38015,"Burleigh County, North Dakota",93737,3434,42,3663,45,0.697,769,0,0,174,0,2,943,0,2,2,0,2,945,81,18,0,0,0,0,0,0,100,0,0,0
38,North Dakota/ND,3800300,"South Central North Dakota--Bismarck City PUMA, North Dakota/ND",38029,"Emmons County, North Dakota",3352,149,1,4445,30,0.025,28,0,0,6,0,0,34,0,0,0,0,0,34,82,18,0,0,0,0,0,0,100,0,0,0
38,North Dakota/ND,3800300,"South Central North Dakota--Bismarck City PUMA, North Dakota/ND",38043,"Kidder County, North Dakota",2460,43,0,1748,0,0.018,20,0,0,4,0,0,24,0,0,0,0,0,24,83,17,0,0,0,0,0,0,100,0,0,0
38,North Dakota/ND,3800300,"South Central North Dakota--Bismarck City PUMA, North Dakota/ND",38047,"Logan County, North Dakota",1927,45,0,2335,0,0.014,15,0,0,3,0,0,18,0,0,0,0,0,18,83,17,0,0,0,0,0,0,100,0,0,0
38,North Dakota/ND,3800300,"South Central North Dakota--Bismarck City PUMA, North Dakota/ND",38051,"McIntosh County, North Dakota",2654,61,3,2298,113,0.02,22,0,0,5,0,0,27,0,0,0,0,0,27,81,19,0,0,0,0,0,0,100,0,0,0
38,North Dakota/ND,3800300,"South Central North Dakota--Bismarck City PUMA, North Dakota/ND",38059,"Morton County, North Dakota",30544,1220,24,3994,79,0.227,250,0,0,57,0,1,307,0,1,1,0,1,308,81,19,0,0,0,0,0,0,100,0,0,0
38,North Dakota/ND,3800400,"Northeast North Dakota--Grand Forks City PUMA, North Dakota/ND",38019,"Cavalier County, North Dakota",3824,53,0,1386,0,0.036,67,0,1,10,0,3,77,0,4,3,1,4,81,83,12,4,1,0,0,4,1,95,5,0,5
38,North Dakota/ND,3800400,"Northeast North Dakota--Grand Forks City PUMA, North Dakota/ND",38035,"Grand Forks County, North Dakota",70400,2196,13,3119,18,0.662,1230,0,20,178,0,60,1408,0,80,60,20,80,1488,83,12,4,1,0,0,4,1,95,5,0,5
38,North Dakota/ND,3800400,"Northeast North Dakota--Grand Forks City PUMA, North Dakota/ND",38039,"Griggs County, North Dakota",2266,57,1,2515,44,0.021,39,0,1,6,0,2,45,0,3,2,1,3,48,81,12,4,2,0,0,4,2,94,6,0,6
38,North Dakota/ND,3800400,"Northeast North Dakota--Grand Forks City PUMA, North Dakota/ND",38067,"Pembina County, North Dakota",7016,72,0,1026,0,0.066,123,0,2,18,0,6,141,0,8,6,2,8,149,83,12,4,1,0,0,4,1,95,5,0,5
38,North Dakota/ND,3800400,"Northeast North Dakota--Grand Forks City PUMA, North Dakota/ND",38091,"Steele County, North Dakota",1910,28,0,1466,0,0.018,33,0,1,5,0,2,38,0,3,2,1,3,41,80,12,5,2,0,0,5,2,93,7,0,7
38,North Dakota/ND,3800400,"Northeast North Dakota--Grand Forks City PUMA, North Dakota/ND",38095,"Towner County, North Dakota",2246,18,0,801,0,0.021,39,0,1,6,0,2,45,0,3,2,1,3,48,81,12,4,2,0,0,4,2,94,6,0,6
38,North Dakota/ND,3800400,"Northeast North Dakota--Grand Forks City PUMA, North Dakota/ND",38097,"Traill County, North Dakota",8019,115,0,1434,0,0.075,139,0,2,20,0,7,159,0,9,7,2,9,168,83,12,4,1,0,0,4,1,95,5,0,5
38,North Dakota/ND,3800400,"Northeast North Dakota--Grand Forks City PUMA, North Dakota/ND",38099,"Walsh County, North Dakota",10802,185,1,1713,9,0.102,190,0,3,27,0,9,217,0,12,9,3,12,229,83,12,4,1,0,0,4,1,95,5,0,5
38,North Dakota/ND,3800500,"Cass County--Fargo City PUMA, North Dakota/ND",38017,"Cass County, North Dakota",174202,4984,77,2861,44,1,874,0,0,0,62,50,874,62,50,112,0,112,986,89,0,11,0,6,0,5,0,89,11,6,5
39,Ohio/OH,3900100,"Defiance, Williams, Henry & Paulding Counties PUMA, Ohio/OH",39039,"Defiance County, Ohio",38279,289,11,755,29,0.314,424,2,21,26,3,8,450,5,29,11,23,34,484,88,5,2,5,1,0,2,4,93,7,1,6
39,Ohio/OH,3900100,"Defiance, Williams, Henry & Paulding Counties PUMA, Ohio/OH",39069,"Henry County, Ohio",27316,312,13,1142,48,0.227,306,2,15,19,2,6,325,4,21,8,17,25,350,87,5,2,5,1,1,2,4,93,7,1,6
39,Ohio/OH,3900100,"Defiance, Williams, Henry & Paulding Counties PUMA, Ohio/OH",39125,"Paulding County, Ohio",18872,108,0,572,0,0.155,209,1,10,13,1,4,222,2,14,5,11,16,238,88,5,2,5,0,0,2,4,93,7,1,6
39,Ohio/OH,3900100,"Defiance, Williams, Henry & Paulding Counties PUMA, Ohio/OH",39171,"Williams County, Ohio",36936,207,3,560,8,0.304,410,2,20,25,3,8,435,5,28,11,22,33,468,88,5,2,5,1,0,2,4,93,7,1,6
39,Ohio/OH,3900200,"Wood (South), Fulton & Lucas (Southwest) Counties--Bowling Green City PUMA, Ohio/OH",39051,"Fulton County, Ohio",42305,241,1,570,2,0.368,311,0,81,33,0,0,344,0,81,0,81,81,425,73,8,0,19,0,0,0,19,81,19,0,19
39,Ohio/OH,3900200,"Wood (South), Fulton & Lucas (Southwest) Counties--Bowling Green City PUMA, Ohio/OH",39095,"Lucas County, Ohio",432379,7280,364,1684,84,0.029,25,0,6,3,0,0,28,0,6,0,6,6,34,74,9,0,18,0,0,0,18,82,18,0,18
39,Ohio/OH,3900200,"Wood (South), Fulton & Lucas (Southwest) Counties--Bowling Green City PUMA, Ohio/OH",39173,"Wood County, Ohio",129936,1841,72,1417,55,0.603,510,0,132,54,0,0,564,0,132,0,132,132,696,73,8,0,19,0,0,0,19,81,19,0,19
39,Ohio/OH,3900300,"Lucas (West) & Wood (North Central) Counties--Perrysburg, Sylvania & Maumee Cities PUMA, Ohio/OH",39095,"Lucas County, Ohio",432379,7280,364,1684,84,0.835,125,0,0,29,23,0,154,23,0,23,0,23,177,71,16,13,0,13,0,0,0,87,13,13,0
39,Ohio/OH,3900300,"Lucas (West) & Wood (North Central) Counties--Perrysburg, Sylvania & Maumee Cities PUMA, Ohio/OH",39173,"Wood County, Ohio",129936,1841,72,1417,55,0.165,25,0,0,6,4,0,31,4,0,4,0,4,35,71,17,11,0,11,0,0,0,89,11,11,0
39,Ohio/OH,3900400,"Toledo City (West) PUMA, Ohio/OH",39095,"Lucas County, Ohio",432379,7280,364,1684,84,1,542,0,0,0,0,0,542,0,0,0,0,0,542,100,0,0,0,0,0,0,0,100,0,0,0
39,Ohio/OH,3900500,"Toledo City (East) PUMA, Ohio/OH",39095,"Lucas County, Ohio",432379,7280,364,1684,84,1,447,42,12,0,0,0,447,42,12,0,54,54,501,89,0,0,11,0,8,0,2,89,11,8,2
39,Ohio/OH,3900600,"Ottawa, Wood (Northeast) & Lucas (East) Counties--Oregon City PUMA, Ohio/OH",39095,"Lucas County, Ohio",432379,7280,364,1684,84,0.275,42,1,5,0,0,0,42,1,5,0,6,6,48,88,0,0,12,0,2,0,10,88,12,2,10
39,Ohio/OH,3900600,"Ottawa, Wood (Northeast) & Lucas (East) Counties--Oregon City PUMA, Ohio/OH",39123,"Ottawa County, Ohio",40709,468,30,1150,74,0.386,59,2,7,0,0,0,59,2,7,0,9,9,68,87,0,0,13,0,3,0,10,87,13,3,10
39,Ohio/OH,3900600,"Ottawa, Wood (Northeast) & Lucas (East) Counties--Oregon City PUMA, Ohio/OH",39173,"Wood County, Ohio",129936,1841,72,1417,55,0.34,52,2,6,0,0,0,52,2,6,0,8,8,60,87,0,0,13,0,3,0,10,87,13,3,10
39,Ohio/OH,3900700,"Erie & Sandusky Counties PUMA, Ohio/OH",39043,"Erie County, Ohio",75136,935,46,1244,61,0.559,520,0,59,68,8,34,588,8,93,42,59,101,689,75,10,6,9,1,0,5,9,85,15,1,13
39,Ohio/OH,3900700,"Erie & Sandusky Counties PUMA, Ohio/OH",39143,"Sandusky County, Ohio",59299,563,20,949,34,0.441,410,0,47,54,6,26,464,6,73,32,47,79,543,76,10,6,9,1,0,5,9,85,15,1,13
39,Ohio/OH,3900801,"Lorain County (North)--Elyria & Lorain Cities PUMA, Ohio/OH",39093,"Lorain County, Ohio",306713,2307,86,752,28,1,300,16,20,270,0,42,570,16,62,42,36,78,648,46,42,6,6,0,2,6,3,88,12,2,10
39,Ohio/OH,3900802,"Lorain County (South)--Avon, Avon Lake & North Ridgeville Cities PUMA, Ohio/OH",39093,"Lorain County, Ohio",306713,2307,86,752,28,1,355,0,0,0,0,0,355,0,0,0,0,0,355,100,0,0,0,0,0,0,0,100,0,0,0
39,Ohio/OH,3900901,"Cuyahoga County--Olmsted Township, Bay Village, North Olmsted & Westlake Cities PUMA, Ohio/OH",39035,"Cuyahoga County, Ohio",1253783,17375,656,1386,52,1,37,0,31,0,13,0,37,13,31,13,31,44,81,46,0,16,38,16,0,0,38,46,54,16,38
39,Ohio/OH,3900902,"Cuyahoga County (West)--Berea, Brook Park, Lakewood & Rocky River Cities PUMA, Ohio/OH",39035,"Cuyahoga County, Ohio",1253783,17375,656,1386,52,1,92,20,0,32,20,0,124,40,0,20,20,40,164,56,20,12,12,12,12,0,0,76,24,24,0
39,Ohio/OH,3900903,"Cuyahoga County (South)--Broadview Heights, North Royalton & Strongsville Cities PUMA, Ohio/OH",39035,"Cuyahoga County, Ohio",1253783,17375,656,1386,52,1,131,0,0,0,0,0,131,0,0,0,0,0,131,100,0,0,0,0,0,0,0,100,0,0,0
39,Ohio/OH,3900904,"Cuyahoga County (South Central)--Brooklyn, Parma, Parma Heights & Seven Hills Cities PUMA, Ohio/OH",39035,"Cuyahoga County, Ohio",1253783,17375,656,1386,52,1,211,0,0,0,0,0,211,0,0,0,0,0,211,100,0,0,0,0,0,0,0,100,0,0,0
39,Ohio/OH,3900905,"Cleveland City (West) PUMA, Ohio/OH",39035,"Cuyahoga County, Ohio",1253783,17375,656,1386,52,1,253,0,48,140,0,10,393,0,58,10,48,58,451,56,31,2,11,0,0,2,11,87,13,0,13
39,Ohio/OH,3900906,"Cleveland City (Central) PUMA, Ohio/OH",39035,"Cuyahoga County, Ohio",1253783,17375,656,1386,52,1,111,0,40,84,0,0,195,0,40,0,40,40,235,47,36,0,17,0,0,0,17,83,17,0,17
39,Ohio/OH,3900907,"Cuyahoga County (Southeast)--Bedford, Garfield Heights & Maple Heights Cities PUMA, Ohio/OH",39035,"Cuyahoga County, Ohio",1253783,17375,656,1386,52,1,545,47,0,0,0,0,545,47,0,0,47,47,592,92,0,0,8,0,8,0,0,92,8,8,0
39,Ohio/OH,3900908,"Cleveland City (East) & Bratenahl Village PUMA, Ohio/OH",39035,"Cuyahoga County, Ohio",1253783,17375,656,1386,52,1,185,0,0,0,0,29,185,0,29,29,0,29,214,86,0,14,0,0,0,14,0,86,14,0,14
39,Ohio/OH,3900909,"Cuyahoga County (Northeast)--Euclid, Cleveland Heights & South Euclid Cities PUMA, Ohio/OH",39035,"Cuyahoga County, Ohio",1253783,17375,656,1386,52,1,282,0,0,12,0,0,294,0,0,0,0,0,294,96,4,0,0,0,0,0,0,100,0,0,0
39,Ohio/OH,3900910,"Cuyahoga County (East)--Lyndhurst, Mayfield Heights, Shaker Heights & Solon Cities PUMA, Ohio/OH",39035,"Cuyahoga County, Ohio",1253783,17375,656,1386,52,1,61,0,0,0,15,10,61,15,10,25,0,25,86,71,0,29,0,17,0,12,0,71,29,17,12
39,Ohio/OH,3901000,"Lake County (West)--Eastlake, Wickliffe, Willoughby & Willowick Cities PUMA, Ohio/OH",39085,"Lake County, Ohio",230052,1619,51,704,22,1,54,0,0,0,0,0,54,0,0,0,0,0,54,100,0,0,0,0,0,0,0,100,0,0,0
39,Ohio/OH,3901100,"Lake County (East)--Mentor, Painesville Cities & Madison Village PUMA, Ohio/OH",39085,"Lake County, Ohio",230052,1619,51,704,22,1,146,64,157,55,0,0,201,64,157,0,221,221,422,35,13,0,52,0,15,0,37,48,52,15,37
39,Ohio/OH,3901200,"Geauga & Lake (South) Counties PUMA, Ohio/OH",39055,"Geauga County, Ohio",93961,713,49,759,52,0.815,249,2,18,0,0,0,249,2,18,0,20,20,269,93,0,0,7,0,1,0,7,93,7,1,7
39,Ohio/OH,3901200,"Geauga & Lake (South) Counties PUMA, Ohio/OH",39085,"Lake County, Ohio",230052,1619,51,704,22,0.185,56,1,4,0,0,0,56,1,4,0,5,5,61,92,0,0,8,0,2,0,7,92,8,2,7
39,Ohio/OH,3901300,"Ashtabula County PUMA, Ohio/OH",39007,"Ashtabula County, Ohio",98136,657,48,669,49,1,375,0,0,29,0,0,404,0,0,0,0,0,404,93,7,0,0,0,0,0,0,100,0,0,0
39,Ohio/OH,3901400,"Trumbull (Outside Warren City) & Mahoning (Outside Youngstown City) Counties PUMA, Ohio/OH",39099,"Mahoning County, Ohio",231064,3053,281,1321,122,0.311,243,0,0,0,0,0,243,0,0,0,0,0,243,100,0,0,0,0,0,0,0,100,0,0,0
39,Ohio/OH,3901400,"Trumbull (Outside Warren City) & Mahoning (Outside Youngstown City) Counties PUMA, Ohio/OH",39155,"Trumbull County, Ohio",201794,1883,132,933,65,0.689,539,0,0,0,0,0,539,0,0,0,0,0,539,100,0,0,0,0,0,0,0,100,0,0,0
39,Ohio/OH,3901500,"Mahoning County (Northeast)--Youngstown City, Boardman & Austintown PUMA, Ohio/OH",39099,"Mahoning County, Ohio",231064,3053,281,1321,122,1,245,0,0,19,0,0,264,0,0,0,0,0,264,93,7,0,0,0,0,0,0,100,0,0,0
39,Ohio/OH,3901600,"Trumbull County (South Central)--Warren & Niles Cities PUMA, Ohio/OH",39155,"Trumbull County, Ohio",201794,1883,132,933,65,1,158,0,0,0,0,0,158,0,0,0,0,0,158,100,0,0,0,0,0,0,0,100,0,0,0
39,Ohio/OH,3901700,"Portage County PUMA, Ohio/OH",39133,"Portage County, Ohio",162644,1132,66,696,41,1,779,0,0,70,0,0,849,0,0,0,0,0,849,92,8,0,0,0,0,0,0,100,0,0,0
39,Ohio/OH,3901801,"Summit County (North & Northwest)--Hudson, Twinsburg & Macedonia Cities PUMA, Ohio/OH",39153,"Summit County, Ohio",541810,5265,252,972,47,1,115,0,30,0,17,0,115,17,30,17,30,47,162,71,0,10,19,10,0,0,19,71,29,10,19
39,Ohio/OH,3901802,"Summit County (East Central)--Cuyahoga Falls (Southeast), Stow & Tallmadge Cities PUMA, Ohio/OH",39153,"Summit County, Ohio",541810,5265,252,972,47,1,209,0,0,0,30,0,209,30,0,30,0,30,239,87,0,13,0,13,0,0,0,87,13,13,0
39,Ohio/OH,3901803,"Summit County (Central)--Akron City (East) PUMA, Ohio/OH",39153,"Summit County, Ohio",541810,5265,252,972,47,1,118,0,0,0,48,118,118,48,118,166,0,166,284,42,0,58,0,17,0,42,0,42,58,17,42
39,Ohio/OH,3901804,"Summit County (Central)--Akron (West) & Cuyahoga Falls (West) Cities PUMA, Ohio/OH",39153,"Summit County, Ohio",541810,5265,252,972,47,1,105,0,0,0,0,29,105,0,29,29,0,29,134,78,0,22,0,0,0,22,0,78,22,0,22
39,Ohio/OH,3901805,"Summit County (South)--Barberton, Green & New Franklin Cities PUMA, Ohio/OH",39153,"Summit County, Ohio",541810,5265,252,972,47,1,220,0,0,0,0,0,220,0,0,0,0,0,220,100,0,0,0,0,0,0,0,100,0,0,0
39,Ohio/OH,3901900,"Medina County PUMA, Ohio/OH",39103,"Medina County, Ohio",177257,1460,39,824,22,1,339,0,0,0,0,0,339,0,0,0,0,0,339,100,0,0,0,0,0,0,0,100,0,0,0
39,Ohio/OH,3902000,"Wayne County PUMA, Ohio/OH",39169,"Wayne County, Ohio",116208,927,67,798,58,1,1293,44,0,59,0,14,1352,44,14,14,44,58,1410,92,4,1,3,0,3,1,0,96,4,3,1
39,Ohio/OH,3902100,"Huron & Ashland Counties PUMA, Ohio/OH",39005,"Ashland County, Ohio",53477,237,4,443,7,0.479,599,3,127,42,0,0,641,3,127,0,130,130,771,78,5,0,17,0,0,0,16,83,17,0,16
39,Ohio/OH,3902100,"Huron & Ashland Counties PUMA, Ohio/OH",39077,"Huron County, Ohio",58457,542,7,927,12,0.521,651,4,138,46,0,0,697,4,138,0,142,142,839,78,5,0,17,0,0,0,16,83,17,0,16
39,Ohio/OH,3902200,"Richland County PUMA, Ohio/OH",39139,"Richland County, Ohio",121324,861,19,710,16,1,145,0,0,55,0,0,200,0,0,0,0,0,200,72,28,0,0,0,0,0,0,100,0,0,0
39,Ohio/OH,3902300,"Seneca, Crawford & Wyandot Counties PUMA, Ohio/OH",39033,"Crawford County, Ohio",42021,236,6,562,14,0.352,280,14,40,1,0,0,281,14,40,0,54,54,335,84,0,0,16,0,4,0,12,84,16,4,12
39,Ohio/OH,3902300,"Seneca, Crawford & Wyandot Counties PUMA, Ohio/OH",39147,"Seneca County, Ohio",55475,470,14,847,25,0.463,369,18,53,1,0,0,370,18,53,0,71,71,441,84,0,0,16,0,4,0,12,84,16,4,12
39,Ohio/OH,3902300,"Seneca, Crawford & Wyandot Counties PUMA, Ohio/OH",39175,"Wyandot County, Ohio",22107,210,12,950,54,0.185,147,7,21,1,0,0,148,7,21,0,28,28,176,84,1,0,16,0,4,0,12,84,16,4,12
39,Ohio/OH,3902400,"Hancock & Putnam Counties PUMA, Ohio/OH",39063,"Hancock County, Ohio",75690,695,10,918,13,0.69,555,43,26,141,14,43,696,57,69,57,69,126,822,68,17,7,8,2,5,5,3,85,15,7,8
39,Ohio/OH,3902400,"Hancock & Putnam Counties PUMA, Ohio/OH",39137,"Putnam County, Ohio",33969,585,23,1722,68,0.31,249,19,11,63,7,19,312,26,30,26,30,56,368,68,17,7,8,2,5,5,3,85,15,7,8
39,Ohio/OH,3902500,"Allen County PUMA, Ohio/OH",39003,"Allen County, Ohio",103642,1430,69,1380,67,1,1104,0,0,32,0,0,1136,0,0,0,0,0,1136,97,3,0,0,0,0,0,0,100,0,0,0
39,Ohio/OH,3902600,"Auglaize, Mercer & Van Wert Counties PUMA, Ohio/OH",39011,"Auglaize County, Ohio",45784,597,9,1304,20,0.399,578,5,36,15,0,30,593,5,66,30,41,71,664,87,2,5,6,0,1,5,5,89,11,1,10
39,Ohio/OH,3902600,"Auglaize, Mercer & Van Wert Counties PUMA, Ohio/OH",39107,"Mercer County, Ohio",40806,1119,18,2742,44,0.355,514,4,32,13,0,27,527,4,59,27,36,63,590,87,2,5,6,0,1,5,5,89,11,1,10
39,Ohio/OH,3902600,"Auglaize, Mercer & Van Wert Counties PUMA, Ohio/OH",39161,"Van Wert County, Ohio",28281,117,3,414,11,0.246,356,3,22,9,0,18,365,3,40,18,25,43,408,87,2,4,6,0,1,4,5,89,11,1,10
39,Ohio/OH,3902700,"Logan, Champaign & Hardin Counties PUMA, Ohio/OH",39021,"Champaign County, Ohio",38864,304,3,782,8,0.336,241,0,0,8,0,0,249,0,0,0,0,0,249,97,3,0,0,0,0,0,0,100,0,0,0
39,Ohio/OH,3902700,"Logan, Champaign & Hardin Counties PUMA, Ohio/OH",39065,"Hardin County, Ohio",31542,252,13,799,41,0.273,196,0,0,6,0,0,202,0,0,0,0,0,202,97,3,0,0,0,0,0,0,100,0,0,0
39,Ohio/OH,3902700,"Logan, Champaign & Hardin Counties PUMA, Ohio/OH",39091,"Logan County, Ohio",45307,309,3,682,7,0.391,280,0,0,9,0,0,289,0,0,0,0,0,289,97,3,0,0,0,0,0,0,100,0,0,0
39,Ohio/OH,3902800,"Marion, Knox & Morrow Counties PUMA, Ohio/OH",39083,"Knox County, Ohio",61215,284,15,464,25,0.378,448,0,37,9,0,8,457,0,45,8,37,45,502,89,2,2,7,0,0,2,7,91,9,0,9
39,Ohio/OH,3902800,"Marion, Knox & Morrow Counties PUMA, Ohio/OH",39101,"Marion County, Ohio",65344,3088,47,4726,72,0.404,478,0,39,10,0,8,488,0,47,8,39,47,535,89,2,1,7,0,0,1,7,91,9,0,9
39,Ohio/OH,3902800,"Marion, Knox & Morrow Counties PUMA, Ohio/OH",39117,"Morrow County, Ohio",34976,257,2,735,6,0.218,258,0,21,5,0,5,263,0,26,5,21,26,289,89,2,2,7,0,0,2,7,91,9,0,9
39,Ohio/OH,3902900,"Holmes, Guernsey & Coshocton Counties PUMA, Ohio/OH",39031,"Coshocton County, Ohio",36574,234,11,640,30,0.306,395,0,0,0,0,0,395,0,0,0,0,0,395,100,0,0,0,0,0,0,0,100,0,0,0
39,Ohio/OH,3902900,"Holmes, Guernsey & Coshocton Counties PUMA, Ohio/OH",39059,"Guernsey County, Ohio",39274,169,8,430,20,0.327,422,0,0,0,0,0,422,0,0,0,0,0,422,100,0,0,0,0,0,0,0,100,0,0,0
39,Ohio/OH,3902900,"Holmes, Guernsey & Coshocton Counties PUMA, Ohio/OH",39075,"Holmes County, Ohio",43859,385,9,878,21,0.367,474,0,0,0,0,0,474,0,0,0,0,0,474,100,0,0,0,0,0,0,0,100,0,0,0
39,Ohio/OH,3903000,"Tuscarawas & Harrison Counties PUMA, Ohio/OH",39067,"Harrison County, Ohio",15307,63,3,412,20,0.142,82,0,16,0,0,0,82,0,16,0,16,16,98,84,0,0,16,0,0,0,16,84,16,0,16
39,Ohio/OH,3903000,"Tuscarawas & Harrison Counties PUMA, Ohio/OH",39157,"Tuscarawas County, Ohio",92526,930,20,1005,22,0.858,498,0,99,0,0,0,498,0,99,0,99,99,597,83,0,0,17,0,0,0,17,83,17,0,17
39,Ohio/OH,3903100,"Stark County (West)--Massillon City PUMA, Ohio/OH",39151,"Stark County, Ohio",373475,2838,175,760,47,1,1246,0,0,0,24,0,1246,24,0,24,0,24,1270,98,0,2,0,2,0,0,0,98,2,2,0
39,Ohio/OH,3903200,"Stark County (Central)--Canton & North Canton Cities PUMA, Ohio/OH",39151,"Stark County, Ohio",373475,2838,175,760,47,1,766,41,0,14,0,0,780,41,0,0,41,41,821,93,2,0,5,0,5,0,0,95,5,5,0
39,Ohio/OH,3903300,"Stark County (East) & Carroll County--Alliance City PUMA, Ohio/OH",39019,"Carroll County, Ohio",27578,152,7,551,25,0.22,150,4,0,0,0,0,150,4,0,0,4,4,154,97,0,0,3,0,3,0,0,97,3,3,0
39,Ohio/OH,3903300,"Stark County (East) & Carroll County--Alliance City PUMA, Ohio/OH",39151,"Stark County, Ohio",373475,2838,175,760,47,0.78,532,12,0,0,0,0,532,12,0,0,12,12,544,98,0,0,2,0,2,0,0,98,2,2,0
39,Ohio/OH,3903400,"Columbiana County PUMA, Ohio/OH",39029,"Columbiana County, Ohio",104003,1929,80,1855,77,1,498,0,0,49,0,0,547,0,0,0,0,0,547,91,9,0,0,0,0,0,0,100,0,0,0
39,Ohio/OH,3903500,"Belmont & Jefferson Counties PUMA, Ohio/OH",39013,"Belmont County, Ohio",68472,718,27,1049,39,0.507,158,4,0,0,0,0,158,4,0,0,4,4,162,98,0,0,2,0,2,0,0,98,2,2,0
39,Ohio/OH,3903500,"Belmont & Jefferson Counties PUMA, Ohio/OH",39081,"Jefferson County, Ohio",66886,336,4,502,6,0.493,154,3,0,0,0,0,154,3,0,0,3,3,157,98,0,0,2,0,2,0,0,98,2,2,0
39,Ohio/OH,3903600,"Washington, Morgan, Noble & Monroe Counties PUMA, Ohio/OH",39111,"Monroe County, Ohio",14090,110,18,781,128,0.137,47,0,0,8,2,0,55,2,0,2,0,2,57,82,14,4,0,4,0,0,0,96,4,4,0
39,Ohio/OH,3903600,"Washington, Morgan, Noble & Monroe Counties PUMA, Ohio/OH",39115,"Morgan County, Ohio",14702,47,0,320,0,0.142,48,0,0,8,2,0,56,2,0,2,0,2,58,83,14,3,0,3,0,0,0,97,3,3,0
39,Ohio/OH,3903600,"Washington, Morgan, Noble & Monroe Counties PUMA, Ohio/OH",39121,"Noble County, Ohio",14443,28,0,194,0,0.138,47,0,0,8,2,0,55,2,0,2,0,2,57,82,14,4,0,4,0,0,0,96,4,4,0
39,Ohio/OH,3903600,"Washington, Morgan, Noble & Monroe Counties PUMA, Ohio/OH",39167,"Washington County, Ohio",60671,260,23,429,38,0.583,198,0,0,33,10,0,231,10,0,10,0,10,241,82,14,4,0,4,0,0,0,96,4,4,0
39,Ohio/OH,3903700,"Muskingum & Perry Counties PUMA, Ohio/OH",39119,"Muskingum County, Ohio",86076,401,2,466,2,0.706,667,0,0,0,0,0,667,0,0,0,0,0,667,100,0,0,0,0,0,0,0,100,0,0,0
39,Ohio/OH,3903700,"Muskingum & Perry Counties PUMA, Ohio/OH",39127,"Perry County, Ohio",35985,296,9,823,25,0.294,278,0,0,0,0,0,278,0,0,0,0,0,278,100,0,0,0,0,0,0,0,100,0,0,0
39,Ohio/OH,3903800,"Licking County PUMA, Ohio/OH",39089,"Licking County, Ohio",172293,1910,63,1109,37,1,542,0,0,21,0,0,563,0,0,0,0,0,563,96,4,0,0,0,0,0,0,100,0,0,0
39,Ohio/OH,3903900,"Fairfield County PUMA, Ohio/OH",39045,"Fairfield County, Ohio",152910,2087,53,1365,35,1,411,11,0,0,0,0,411,11,0,0,11,11,422,97,0,0,3,0,3,0,0,97,3,3,0
39,Ohio/OH,3904000,"Delaware County PUMA, Ohio/OH",39041,"Delaware County, Ohio",197008,2231,20,1132,10,1,187,0,0,0,21,14,187,21,14,35,0,35,222,84,0,16,0,9,0,6,0,84,16,9,6
39,Ohio/OH,3904101,"Columbus (Far Northeast), Gahanna & New Albany Cities PUMA, Ohio/OH",39049,"Franklin County, Ohio",1275333,26704,607,2094,48,1,224,0,0,0,112,0,224,112,0,112,0,112,336,67,0,33,0,33,0,0,0,67,33,33,0
39,Ohio/OH,3904102,"Columbus (North), Westerville & Worthington Cities PUMA, Ohio/OH",39049,"Franklin County, Ohio",1275333,26704,607,2094,48,1,0,0,0,0,0,38,0,0,38,38,0,38,38,0,0,100,0,0,0,100,0,0,100,0,100
39,Ohio/OH,3904103,"Columbus (Far Northwest), Dublin & Hilliard (North) Cities PUMA, Ohio/OH",39049,"Franklin County, Ohio",1275333,26704,607,2094,48,1,75,0,0,0,0,20,75,0,20,20,0,20,95,79,0,21,0,0,0,21,0,79,21,0,21
39,Ohio/OH,3904104,"Columbus (Northwest), Upper Arlington & Grandview Heights Cities PUMA, Ohio/OH",39049,"Franklin County, Ohio",1275333,26704,607,2094,48,1,54,0,0,0,0,0,54,0,0,0,0,0,54,100,0,0,0,0,0,0,0,100,0,0,0
39,Ohio/OH,3904105,"Columbus City (Central) PUMA, Ohio/OH",39049,"Franklin County, Ohio",1275333,26704,607,2094,48,1,299,0,0,0,0,0,299,0,0,0,0,0,299,100,0,0,0,0,0,0,0,100,0,0,0
39,Ohio/OH,3904106,"Columbus City (Northeast) PUMA, Ohio/OH",39049,"Franklin County, Ohio",1275333,26704,607,2094,48,1,175,0,31,0,28,177,175,28,208,205,31,236,411,43,0,50,8,7,0,43,8,43,57,7,51
39,Ohio/OH,3904107,"Columbus (East), Whitehall & Bexley Cities PUMA, Ohio/OH",39049,"Franklin County, Ohio",1275333,26704,607,2094,48,1,119,49,74,0,0,0,119,49,74,0,123,123,242,49,0,0,51,0,20,0,31,49,51,20,31
39,Ohio/OH,3904108,"Columbus (Southeast) & Reynoldsburg Cities PUMA, Ohio/OH",39049,"Franklin County, Ohio",1275333,26704,607,2094,48,1,67,0,61,26,0,0,93,0,61,0,61,61,154,44,17,0,40,0,0,0,40,60,40,0,40
39,Ohio/OH,3904109,"Franklin County (South)--Columbus (South), Grove Cities & Groveport Village PUMA, Ohio/OH",39049,"Franklin County, Ohio",1275333,26704,607,2094,48,1,138,0,0,0,17,0,138,17,0,17,0,17,155,89,0,11,0,11,0,0,0,89,11,11,0
39,Ohio/OH,3904110,"Columbus City (West) PUMA, Ohio/OH",39049,"Franklin County, Ohio",1275333,26704,607,2094,48,1,135,0,21,0,48,0,135,48,21,48,21,69,204,66,0,24,10,24,0,0,10,66,34,24,10
39,Ohio/OH,3904111,"Columbus (Far West) & Hilliard (South) Cities PUMA, Ohio/OH",39049,"Franklin County, Ohio",1275333,26704,607,2094,48,1,114,0,0,0,69,26,114,69,26,95,0,95,209,55,0,45,0,33,0,12,0,55,45,33,12
39,Ohio/OH,3904200,"Pickaway, Union & Madison Counties PUMA, Ohio/OH",39097,"Madison County, Ohio",43988,815,12,1853,27,0.278,131,0,26,0,0,0,131,0,26,0,26,26,157,83,0,0,17,0,0,0,17,83,17,0,17
39,Ohio/OH,3904200,"Pickaway, Union & Madison Counties PUMA, Ohio/OH",39129,"Pickaway County, Ohio",57420,2643,44,4603,77,0.368,174,0,35,0,0,0,174,0,35,0,35,35,209,83,0,0,17,0,0,0,17,83,17,0,17
39,Ohio/OH,3904200,"Pickaway, Union & Madison Counties PUMA, Ohio/OH",39159,"Union County, Ohio",55654,529,2,951,4,0.354,167,0,33,0,0,0,167,0,33,0,33,33,200,84,0,0,16,0,0,0,16,84,16,0,16
39,Ohio/OH,3904300,"Clark County PUMA, Ohio/OH",39023,"Clark County, Ohio",135198,1794,40,1327,30,1,492,3,43,6,0,0,498,3,43,0,46,46,544,90,1,0,8,0,1,0,8,92,8,1,8
39,Ohio/OH,3904400,"Miami County PUMA, Ohio/OH",39109,"Miami County, Ohio",104800,1428,51,1363,49,1,822,3,6,0,0,0,822,3,6,0,9,9,831,99,0,0,1,0,0,0,1,99,1,0,1
39,Ohio/OH,3904500,"Darke, Shelby & Preble Counties PUMA, Ohio/OH",39037,"Darke County, Ohio",51734,799,42,1544,81,0.366,553,0,1,5,0,0,558,0,1,0,1,1,559,99,1,0,0,0,0,0,0,100,0,0,0
39,Ohio/OH,3904500,"Darke, Shelby & Preble Counties PUMA, Ohio/OH",39135,"Preble County, Ohio",41207,433,15,1051,36,0.291,440,0,1,4,0,0,444,0,1,0,1,1,445,99,1,0,0,0,0,0,0,100,0,0,0
39,Ohio/OH,3904500,"Darke, Shelby & Preble Counties PUMA, Ohio/OH",39149,"Shelby County, Ohio",48797,625,10,1281,20,0.343,518,0,1,5,0,0,523,0,1,0,1,1,524,99,1,0,0,0,0,0,0,100,0,0,0
39,Ohio/OH,3904601,"Montgomery County (West)--Miamisburg & West Carrollton Cities PUMA, Ohio/OH",39113,"Montgomery County, Ohio",532034,7755,162,1458,30,1,224,0,0,0,0,0,224,0,0,0,0,0,224,100,0,0,0,0,0,0,0,100,0,0,0
39,Ohio/OH,3904602,"Montgomery County (Northeast)--Huber Heights, Trotwood, Vandalia & Englewood Cities PUMA, Ohio/OH",39113,"Montgomery County, Ohio",532034,7755,162,1458,30,1,285,0,0,0,16,22,285,16,22,38,0,38,323,88,0,12,0,5,0,7,0,88,12,5,7
39,Ohio/OH,3904603,"Montgomery County (East Central)--Dayton & Riverside Cities PUMA, Ohio/OH",39113,"Montgomery County, Ohio",532034,7755,162,1458,30,1,216,13,0,0,118,15,216,131,15,133,13,146,362,60,0,37,4,33,4,4,0,60,40,36,4
39,Ohio/OH,3904604,"Montgomery County (Southeast)--Kettering & Centerville Cities PUMA, Ohio/OH",39113,"Montgomery County, Ohio",532034,7755,162,1458,30,1,68,0,0,0,0,0,68,0,0,0,0,0,68,100,0,0,0,0,0,0,0,100,0,0,0
39,Ohio/OH,3904700,"Greene County PUMA, Ohio/OH",39057,"Greene County, Ohio",165811,1444,32,871,19,1,340,4,4,0,0,13,340,4,17,13,8,21,361,94,0,4,2,0,1,4,1,94,6,1,5
39,Ohio/OH,3904800,"Ross & Fayette Counties PUMA, Ohio/OH",39047,"Fayette County, Ohio",28645,230,6,803,21,0.271,127,6,6,0,7,0,127,13,6,7,12,19,146,87,0,5,8,5,4,0,4,87,13,9,4
39,Ohio/OH,3904800,"Ross & Fayette Counties PUMA, Ohio/OH",39141,"Ross County, Ohio",77051,879,24,1141,31,0.729,341,15,15,0,18,0,341,33,15,18,30,48,389,88,0,5,8,5,4,0,4,88,12,8,4
39,Ohio/OH,3904900,"Jackson, Hocking, Pike & Vinton Counties PUMA, Ohio/OH",39073,"Hocking County, Ohio",28495,163,9,572,32,0.278,334,0,0,9,0,0,343,0,0,0,0,0,343,97,3,0,0,0,0,0,0,100,0,0,0
39,Ohio/OH,3904900,"Jackson, Hocking, Pike & Vinton Counties PUMA, Ohio/OH",39079,"Jackson County, Ohio",32524,250,6,769,18,0.319,383,0,0,11,0,0,394,0,0,0,0,0,394,97,3,0,0,0,0,0,0,100,0,0,0
39,Ohio/OH,3904900,"Jackson, Hocking, Pike & Vinton Counties PUMA, Ohio/OH",39131,"Pike County, Ohio",28214,184,0,652,0,0.276,331,0,0,9,0,0,340,0,0,0,0,0,340,97,3,0,0,0,0,0,0,100,0,0,0
39,Ohio/OH,3904900,"Jackson, Hocking, Pike & Vinton Counties PUMA, Ohio/OH",39163,"Vinton County, Ohio",13111,47,3,358,23,0.127,152,0,0,4,0,0,156,0,0,0,0,0,156,97,3,0,0,0,0,0,0,100,0,0,0
39,Ohio/OH,3905000,"Athens, Gallia & Meigs Counties PUMA, Ohio/OH",39009,"Athens County, Ohio",65936,669,2,1015,3,0.555,297,0,0,0,0,0,297,0,0,0,0,0,297,100,0,0,0,0,0,0,0,100,0,0,0
39,Ohio/OH,3905000,"Athens, Gallia & Meigs Counties PUMA, Ohio/OH",39053,"Gallia County, Ohio",30195,189,13,626,43,0.252,135,0,0,0,0,0,135,0,0,0,0,0,135,100,0,0,0,0,0,0,0,100,0,0,0
39,Ohio/OH,3905000,"Athens, Gallia & Meigs Counties PUMA, Ohio/OH",39105,"Meigs County, Ohio",23160,174,10,751,43,0.194,104,0,0,0,0,0,104,0,0,0,0,0,104,100,0,0,0,0,0,0,0,100,0,0,0
39,Ohio/OH,3905100,"Scioto & Lawrence Counties PUMA, Ohio/OH",39087,"Lawrence County, Ohio",60622,653,22,1077,36,0.444,187,0,0,0,11,0,187,11,0,11,0,11,198,94,0,6,0,6,0,0,0,94,6,6,0
39,Ohio/OH,3905100,"Scioto & Lawrence Counties PUMA, Ohio/OH",39145,"Scioto County, Ohio",76377,498,6,652,8,0.556,234,0,0,0,14,0,234,14,0,14,0,14,248,94,0,6,0,6,0,0,0,94,6,6,0
39,Ohio/OH,3905200,"Highland, Clinton & Adams Counties PUMA, Ohio/OH",39001,"Adams County, Ohio",27878,129,4,463,14,0.247,256,0,3,0,0,0,256,0,3,0,3,3,259,99,0,0,1,0,0,0,1,99,1,0,1
39,Ohio/OH,3905200,"Highland, Clinton & Adams Counties PUMA, Ohio/OH",39027,"Clinton County, Ohio",41896,294,13,702,31,0.371,384,0,5,0,0,0,384,0,5,0,5,5,389,99,0,0,1,0,0,0,1,99,1,0,1
39,Ohio/OH,3905200,"Highland, Clinton & Adams Counties PUMA, Ohio/OH",39071,"Highland County, Ohio",43007,227,3,528,7,0.381,394,0,5,0,0,0,394,0,5,0,5,5,399,99,0,0,1,0,0,0,1,99,1,0,1
39,Ohio/OH,3905301,"Warren County (East)--Lebanon & Springboro (East) Cities PUMA, Ohio/OH",39165,"Warren County, Ohio",226564,3023,49,1334,22,1,399,0,0,0,0,0,399,0,0,0,0,0,399,100,0,0,0,0,0,0,0,100,0,0,0
39,Ohio/OH,3905302,"Warren County (West)--Mason, Franklin & Springboro (West) Cities PUMA, Ohio/OH",39165,"Warren County, Ohio",226564,3023,49,1334,22,1,246,0,0,0,0,0,246,0,0,0,0,0,246,100,0,0,0,0,0,0,0,100,0,0,0
39,Ohio/OH,3905401,"Butler County (Southeast)--Monroe City & Beckett Ridge PUMA, Ohio/OH",39017,"Butler County, Ohio",378294,5933,111,1568,29,1,264,35,31,57,45,10,321,80,41,55,66,121,442,60,13,12,15,10,8,2,7,73,27,18,9
39,Ohio/OH,3905402,"Butler County (South Central)--Hamilton & Fairfield Cities PUMA, Ohio/OH",39017,"Butler County, Ohio",378294,5933,111,1568,29,1,180,0,0,17,15,0,197,15,0,15,0,15,212,85,8,7,0,7,0,0,0,93,7,7,0
39,Ohio/OH,3905403,"Butler County (North & West)--Middletown, Oxford & Trenton Cities PUMA, Ohio/OH",39017,"Butler County, Ohio",378294,5933,111,1568,29,1,223,65,24,0,0,0,223,65,24,0,89,89,312,71,0,0,29,0,21,0,8,71,29,21,8
39,Ohio/OH,3905501,"Hamilton County (West)--Mack & Dent PUMA, Ohio/OH",39061,"Hamilton County, Ohio",812037,13036,315,1605,39,1,257,0,0,0,16,22,257,16,22,38,0,38,295,87,0,13,0,5,0,7,0,87,13,5,7
39,Ohio/OH,3905502,"Hamilton County (Central)--Forest Park City, White Oak, Bridgetown & Finneytown PUMA, Ohio/OH",39061,"Hamilton County, Ohio",812037,13036,315,1605,39,1,489,0,44,25,0,0,514,0,44,0,44,44,558,88,4,0,8,0,0,0,8,92,8,0,8
39,Ohio/OH,3905503,"Cincinnati City (West) PUMA, Ohio/OH",39061,"Hamilton County, Ohio",812037,13036,315,1605,39,1,474,0,0,0,0,11,474,0,11,11,0,11,485,98,0,2,0,0,0,2,0,98,2,0,2
39,Ohio/OH,3905504,"Cincinnati City (Central) PUMA, Ohio/OH",39061,"Hamilton County, Ohio",812037,13036,315,1605,39,1,374,0,0,0,22,10,374,22,10,32,0,32,406,92,0,8,0,5,0,2,0,92,8,5,2
39,Ohio/OH,3905505,"Cincinnati (East) & Norwood Cities PUMA, Ohio/OH",39061,"Hamilton County, Ohio",812037,13036,315,1605,39,1,249,0,0,0,8,32,249,8,32,40,0,40,289,86,0,14,0,3,0,11,0,86,14,3,11
39,Ohio/OH,3905506,"Hamilton County (North Central)--Sharonville, Blue Ash, Springdale & Reading Cities PUMA, Ohio/OH",39061,"Hamilton County, Ohio",812037,13036,315,1605,39,1,199,0,0,24,216,74,223,216,74,290,0,290,513,39,5,57,0,42,0,14,0,43,57,42,14
39,Ohio/OH,3905507,"Hamilton County (East)--Loveland, Montgomery Cities & Forestville PUMA, Ohio/OH",39061,"Hamilton County, Ohio",812037,13036,315,1605,39,1,179,0,0,0,0,0,179,0,0,0,0,0,179,100,0,0,0,0,0,0,0,100,0,0,0
39,Ohio/OH,3905600,"Clermont County (West) PUMA, Ohio/OH",39025,"Clermont County, Ohio",203216,1707,23,840,11,1,275,0,0,0,0,0,275,0,0,0,0,0,275,100,0,0,0,0,0,0,0,100,0,0,0
39,Ohio/OH,3905700,"Clermont (East) & Brown Counties PUMA, Ohio/OH",39015,"Brown County, Ohio",43679,288,2,659,5,0.381,133,0,0,0,0,0,133,0,0,0,0,0,133,100,0,0,0,0,0,0,0,100,0,0,0
39,Ohio/OH,3905700,"Clermont (East) & Brown Counties PUMA, Ohio/OH",39025,"Clermont County, Ohio",203216,1707,23,840,11,0.619,217,0,0,0,0,0,217,0,0,0,0,0,217,100,0,0,0,0,0,0,0,100,0,0,0
40,Oklahoma/OK,4000100,"Northeast Oklahoma PUMA, Oklahoma/OK",40035,"Craig County, Oklahoma",14493,500,1,3450,7,0.087,112,2,14,8,1,12,120,3,26,13,16,29,149,75,5,9,11,1,1,8,9,81,19,2,17
40,Oklahoma/OK,4000100,"Northeast Oklahoma PUMA, Oklahoma/OK",40041,"Delaware County, Oklahoma",42112,736,25,1748,59,0.248,318,6,40,23,2,34,341,8,74,36,46,82,423,75,5,9,11,0,1,8,9,81,19,2,17
40,Oklahoma/OK,4000100,"Northeast Oklahoma PUMA, Oklahoma/OK",40097,"Mayes County, Oklahoma",40980,601,11,1467,27,0.244,313,6,39,22,2,33,335,8,72,35,45,80,415,75,5,8,11,0,1,8,9,81,19,2,17
40,Oklahoma/OK,4000100,"Northeast Oklahoma PUMA, Oklahoma/OK",40105,"Nowata County, Oklahoma",10383,142,4,1368,39,0.062,80,1,10,6,1,8,86,2,18,9,11,20,106,75,6,8,10,1,1,8,9,81,19,2,17
40,Oklahoma/OK,4000100,"Northeast Oklahoma PUMA, Oklahoma/OK",40115,"Ottawa County, Oklahoma",31566,843,6,2671,19,0.189,243,4,30,17,2,26,260,6,56,28,34,62,322,75,5,9,11,1,1,8,9,81,19,2,17
40,Oklahoma/OK,4000100,"Northeast Oklahoma PUMA, Oklahoma/OK",40131,"Rogers County, Oklahoma",90814,1816,49,2000,54,0.168,216,4,27,15,2,23,231,6,50,25,31,56,287,75,5,9,11,1,1,8,9,80,20,2,17
40,Oklahoma/OK,4000200,"Cherokee, Sequoyah & Adair Counties PUMA, Oklahoma/OK",40001,"Adair County, Oklahoma",22113,609,10,2754,45,0.197,236,3,50,16,8,4,252,11,54,12,53,65,317,74,5,4,17,3,1,1,16,79,21,3,17
40,Oklahoma/OK,4000200,"Cherokee, Sequoyah & Adair Counties PUMA, Oklahoma/OK",40021,"Cherokee County, Oklahoma",48599,1060,8,2181,16,0.434,519,6,111,36,18,9,555,24,120,27,117,144,699,74,5,4,17,3,1,1,16,79,21,3,17
40,Oklahoma/OK,4000200,"Cherokee, Sequoyah & Adair Counties PUMA, Oklahoma/OK",40135,"Sequoyah County, Oklahoma",41359,857,11,2072,27,0.368,440,5,94,31,15,8,471,20,102,23,99,122,593,74,5,4,17,3,1,1,16,79,21,3,17
40,Oklahoma/OK,4000300,"Southeast Oklahoma PUMA, Oklahoma/OK",40023,"Choctaw County, Oklahoma",14886,317,2,2130,13,0.085,144,6,10,10,2,8,154,8,18,10,16,26,180,80,6,6,9,1,3,4,6,86,14,4,10
40,Oklahoma/OK,4000300,"Southeast Oklahoma PUMA, Oklahoma/OK",40061,"Haskell County, Oklahoma",12704,278,4,2188,31,0.072,122,5,9,8,1,7,130,6,16,8,14,22,152,80,5,5,9,1,3,5,6,86,14,4,11
40,Oklahoma/OK,4000300,"Southeast Oklahoma PUMA, Oklahoma/OK",40077,"Latimer County, Oklahoma",10495,136,2,1296,19,0.059,100,4,7,7,1,6,107,5,13,7,11,18,125,80,6,6,9,1,3,5,6,86,14,4,10
40,Oklahoma/OK,4000300,"Southeast Oklahoma PUMA, Oklahoma/OK",40079,"Le Flore County, Oklahoma",49909,1093,17,2190,34,0.283,479,19,35,33,5,27,512,24,62,32,54,86,598,80,6,5,9,1,3,5,6,86,14,4,10
40,Oklahoma/OK,4000300,"Southeast Oklahoma PUMA, Oklahoma/OK",40089,"McCurtain County, Oklahoma",32966,1269,34,3849,103,0.187,317,13,23,22,4,18,339,17,41,22,36,58,397,80,6,6,9,1,3,5,6,85,15,4,10
40,Oklahoma/OK,4000300,"Southeast Oklahoma PUMA, Oklahoma/OK",40121,"Pittsburg County, Oklahoma",44382,920,19,2073,43,0.251,425,17,31,29,5,24,454,22,55,29,48,77,531,80,5,5,9,1,3,5,6,85,15,4,10
40,Oklahoma/OK,4000300,"Southeast Oklahoma PUMA, Oklahoma/OK",40127,"Pushmataha County, Oklahoma",11119,154,2,1385,18,0.063,107,4,8,7,1,6,114,5,14,7,12,19,133,80,5,5,9,1,3,5,6,86,14,4,11
40,Oklahoma/OK,4000400,"Southwest Oklahoma PUMA, Oklahoma/OK",40009,"Beckham County, Oklahoma",22621,375,1,1658,4,0.204,228,28,11,110,0,0,338,28,11,0,39,39,377,60,29,0,10,0,7,0,3,90,10,7,3
40,Oklahoma/OK,4000400,"Southwest Oklahoma PUMA, Oklahoma/OK",40039,"Custer County, Oklahoma",29209,655,0,2242,0,0.266,297,37,15,144,0,0,441,37,15,0,52,52,493,60,29,0,11,0,8,0,3,89,11,8,3
40,Oklahoma/OK,4000400,"Southwest Oklahoma PUMA, Oklahoma/OK",40055,"Greer County, Oklahoma",5943,108,8,1817,135,0.054,60,7,3,29,0,0,89,7,3,0,10,10,99,61,29,0,10,0,7,0,3,90,10,7,3
40,Oklahoma/OK,4000400,"Southwest Oklahoma PUMA, Oklahoma/OK",40057,"Harmon County, Oklahoma",2721,43,0,1580,0,0.025,28,3,1,14,0,0,42,3,1,0,4,4,46,61,30,0,9,0,7,0,2,91,9,7,2
40,Oklahoma/OK,4000400,"Southwest Oklahoma PUMA, Oklahoma/OK",40065,"Jackson County, Oklahoma",25384,747,10,2943,39,0.231,258,32,13,125,0,0,383,32,13,0,45,45,428,60,29,0,11,0,7,0,3,89,11,7,3
40,Oklahoma/OK,4000400,"Southwest Oklahoma PUMA, Oklahoma/OK",40075,"Kiowa County, Oklahoma",9001,75,2,833,22,0.082,92,11,5,44,0,0,136,11,5,0,16,16,152,61,29,0,11,0,7,0,3,89,11,7,3
40,Oklahoma/OK,4000400,"Southwest Oklahoma PUMA, Oklahoma/OK",40129,"Roger Mills County, Oklahoma",3708,46,1,1241,27,0.033,37,5,2,18,0,0,55,5,2,0,7,7,62,60,29,0,11,0,8,0,3,89,11,8,3
40,Oklahoma/OK,4000400,"Southwest Oklahoma PUMA, Oklahoma/OK",40149,"Washita County, Oklahoma",11432,76,0,665,0,0.104,116,14,6,56,0,0,172,14,6,0,20,20,192,60,29,0,10,0,7,0,3,90,10,7,3
40,Oklahoma/OK,4000500,"Panhandle & Northwest Oklahoma PUMA, Oklahoma/OK",40003,"Alfalfa County, Oklahoma",5857,63,0,1076,0,0.051,72,3,93,24,0,7,96,3,100,7,96,103,199,36,12,4,48,0,2,4,47,48,52,2,50
40,Oklahoma/OK,4000500,"Panhandle & Northwest Oklahoma PUMA, Oklahoma/OK",40007,"Beaver County, Oklahoma",5415,53,0,979,0,0.047,66,3,85,22,0,7,88,3,92,7,88,95,183,36,12,4,48,0,2,4,46,48,52,2,50
40,Oklahoma/OK,4000500,"Panhandle & Northwest Oklahoma PUMA, Oklahoma/OK",40011,"Blaine County, Oklahoma",9634,125,1,1297,10,0.084,118,5,153,40,0,12,158,5,165,12,158,170,328,36,12,4,48,0,2,4,47,48,52,2,50
40,Oklahoma/OK,4000500,"Panhandle & Northwest Oklahoma PUMA, Oklahoma/OK",40025,"Cimarron County, Oklahoma",2189,24,0,1096,0,0.019,27,1,35,9,0,3,36,1,38,3,36,39,75,36,12,4,48,0,1,4,47,48,52,1,51
40,Oklahoma/OK,4000500,"Panhandle & Northwest Oklahoma PUMA, Oklahoma/OK",40043,"Dewey County, Oklahoma",4918,66,1,1342,20,0.042,59,2,76,20,0,6,79,2,82,6,78,84,163,36,12,4,48,0,1,4,47,48,52,1,50
40,Oklahoma/OK,4000500,"Panhandle & Northwest Oklahoma PUMA, Oklahoma/OK",40045,"Ellis County, Oklahoma",4072,10,0,246,0,0.036,51,2,65,17,0,5,68,2,70,5,67,72,140,36,12,4,48,0,1,4,46,49,51,1,50
40,Oklahoma/OK,4000500,"Panhandle & Northwest Oklahoma PUMA, Oklahoma/OK",40053,"Grant County, Oklahoma",4418,46,0,1041,0,0.039,55,2,71,19,0,5,74,2,76,5,73,78,152,36,12,3,48,0,1,3,47,49,51,1,50
40,Oklahoma/OK,4000500,"Panhandle & Northwest Oklahoma PUMA, Oklahoma/OK",40059,"Harper County, Oklahoma",3847,29,1,754,26,0.032,45,2,58,15,0,4,60,2,62,4,60,64,124,36,12,3,48,0,2,3,47,48,52,2,50
40,Oklahoma/OK,4000500,"Panhandle & Northwest Oklahoma PUMA, Oklahoma/OK",40073,"Kingfisher County, Oklahoma",15618,339,2,2171,13,0.136,191,8,247,65,1,19,256,9,266,20,255,275,531,36,12,4,48,0,2,4,47,48,52,2,50
40,Oklahoma/OK,4000500,"Panhandle & Northwest Oklahoma PUMA, Oklahoma/OK",40093,"Major County, Oklahoma",7718,88,1,1140,13,0.068,96,4,124,33,0,10,129,4,134,10,128,138,267,36,12,4,48,0,1,4,46,48,52,1,50
40,Oklahoma/OK,4000500,"Panhandle & Northwest Oklahoma PUMA, Oklahoma/OK",40139,"Texas County, Oklahoma",21121,1491,8,7059,38,0.184,259,11,335,88,1,26,347,12,361,27,346,373,720,36,12,4,48,0,2,4,47,48,52,2,50
40,Oklahoma/OK,4000500,"Panhandle & Northwest Oklahoma PUMA, Oklahoma/OK",40151,"Woods County, Oklahoma",9127,106,0,1161,0,0.08,113,5,145,38,0,11,151,5,156,11,150,161,312,36,12,4,48,0,2,4,46,48,52,2,50
40,Oklahoma/OK,4000500,"Panhandle & Northwest Oklahoma PUMA, Oklahoma/OK",40153,"Woodward County, Oklahoma",20967,1028,1,4903,5,0.182,256,11,331,87,1,25,343,12,356,26,342,368,711,36,12,4,48,0,2,4,47,48,52,2,50
40,Oklahoma/OK,4000601,"Comanche County (Central)--Lawton City PUMA, Oklahoma/OK",40031,"Comanche County, Oklahoma",122561,1563,13,1275,11,1,146,0,48,68,0,0,214,0,48,0,48,48,262,56,26,0,18,0,0,0,18,82,18,0,18
40,Oklahoma/OK,4000602,"Stephens, Caddo, Comanche (North), Tillman, Jefferson & Cotton Counties PUMA, Oklahoma/OK",40015,"Caddo County, Oklahoma",29342,748,20,2549,68,0.267,143,1,38,33,0,2,176,1,40,2,39,41,217,66,15,1,18,0,0,1,18,81,19,0,18
40,Oklahoma/OK,4000602,"Stephens, Caddo, Comanche (North), Tillman, Jefferson & Cotton Counties PUMA, Oklahoma/OK",40031,"Comanche County, Oklahoma",122561,1563,13,1275,11,0.158,85,1,23,19,0,1,104,1,24,1,24,25,129,66,15,1,19,0,1,1,18,81,19,1,19
40,Oklahoma/OK,4000602,"Stephens, Caddo, Comanche (North), Tillman, Jefferson & Cotton Counties PUMA, Oklahoma/OK",40033,"Cotton County, Oklahoma",5929,68,3,1147,51,0.054,29,0,8,7,0,0,36,0,8,0,8,8,44,66,16,0,18,0,0,0,18,82,18,0,18
40,Oklahoma/OK,4000602,"Stephens, Caddo, Comanche (North), Tillman, Jefferson & Cotton Counties PUMA, Oklahoma/OK",40067,"Jefferson County, Oklahoma",6223,41,0,659,0,0.056,30,0,8,7,0,0,37,0,8,0,8,8,45,67,16,0,18,0,0,0,18,82,18,0,18
40,Oklahoma/OK,4000602,"Stephens, Caddo, Comanche (North), Tillman, Jefferson & Cotton Counties PUMA, Oklahoma/OK",40137,"Stephens County, Oklahoma",43983,416,5,946,11,0.398,213,2,57,49,0,3,262,2,60,3,59,62,324,66,15,1,18,0,1,1,18,81,19,1,19
40,Oklahoma/OK,4000602,"Stephens, Caddo, Comanche (North), Tillman, Jefferson & Cotton Counties PUMA, Oklahoma/OK",40141,"Tillman County, Oklahoma",7515,90,2,1198,27,0.067,36,0,10,8,0,0,44,0,10,0,10,10,54,67,15,0,19,0,0,0,19,81,19,0,19
40,Oklahoma/OK,4000701,"Carter, Garvin, Murray, Love & Pontotoc (West) Counties PUMA, Oklahoma/OK",40019,"Carter County, Oklahoma",48406,546,8,1128,17,0.453,237,4,8,34,0,0,271,4,8,0,12,12,283,84,12,0,4,0,1,0,3,96,4,1,3
40,Oklahoma/OK,4000701,"Carter, Garvin, Murray, Love & Pontotoc (West) Counties PUMA, Oklahoma/OK",40049,"Garvin County, Oklahoma",27823,364,5,1308,18,0.26,136,2,5,19,0,0,155,2,5,0,7,7,162,84,12,0,4,0,1,0,3,96,4,1,3
40,Oklahoma/OK,4000701,"Carter, Garvin, Murray, Love & Pontotoc (West) Counties PUMA, Oklahoma/OK",40085,"Love County, Oklahoma",9933,172,1,1732,10,0.093,49,1,2,7,0,0,56,1,2,0,3,3,59,83,12,0,5,0,2,0,3,95,5,2,3
40,Oklahoma/OK,4000701,"Carter, Garvin, Murray, Love & Pontotoc (West) Counties PUMA, Oklahoma/OK",40099,"Murray County, Oklahoma",13875,136,1,980,7,0.13,68,1,2,10,0,0,78,1,2,0,3,3,81,84,12,0,4,0,1,0,2,96,4,1,2
40,Oklahoma/OK,4000701,"Carter, Garvin, Murray, Love & Pontotoc (West) Counties PUMA, Oklahoma/OK",40123,"Pontotoc County, Oklahoma",38358,400,3,1043,8,0.065,34,1,1,5,0,0,39,1,1,0,2,2,41,83,12,0,5,0,2,0,2,95,5,2,2
40,Oklahoma/OK,4000702,"Bryan, Pontotoc (East), Marshall, Atoka, Johnston & Coal Counties--Ada City PUMA, Oklahoma/OK",40005,"Atoka County, Oklahoma",13874,292,1,2105,7,0.112,48,2,1,4,0,2,52,2,3,2,3,5,57,84,7,4,5,0,4,4,2,91,9,4,5
40,Oklahoma/OK,4000702,"Bryan, Pontotoc (East), Marshall, Atoka, Johnston & Coal Counties--Ada City PUMA, Oklahoma/OK",40013,"Bryan County, Oklahoma",45759,925,4,2021,9,0.368,159,8,3,13,0,6,172,8,9,6,11,17,189,84,7,3,6,0,4,3,2,91,9,4,5
40,Oklahoma/OK,4000702,"Bryan, Pontotoc (East), Marshall, Atoka, Johnston & Coal Counties--Ada City PUMA, Oklahoma/OK",40029,"Coal County, Oklahoma",5618,70,0,1246,0,0.046,20,1,0,2,0,1,22,1,1,1,1,2,24,83,8,4,4,0,4,4,0,92,8,4,4
40,Oklahoma/OK,4000702,"Bryan, Pontotoc (East), Marshall, Atoka, Johnston & Coal Counties--Ada City PUMA, Oklahoma/OK",40069,"Johnston County, Oklahoma",11041,164,4,1485,36,0.09,39,2,1,3,0,2,42,2,3,2,3,5,47,83,6,4,6,0,4,4,2,89,11,4,6
40,Oklahoma/OK,4000702,"Bryan, Pontotoc (East), Marshall, Atoka, Johnston & Coal Counties--Ada City PUMA, Oklahoma/OK",40095,"Marshall County, Oklahoma",16376,180,2,1099,12,0.131,56,3,1,4,0,2,60,3,3,2,4,6,66,85,6,3,6,0,5,3,2,91,9,5,5
40,Oklahoma/OK,4000702,"Bryan, Pontotoc (East), Marshall, Atoka, Johnston & Coal Counties--Ada City PUMA, Oklahoma/OK",40123,"Pontotoc County, Oklahoma",38358,400,3,1043,8,0.254,109,6,2,9,0,4,118,6,6,4,8,12,130,84,7,3,6,0,5,3,2,91,9,5,5
40,Oklahoma/OK,4000800,"Canadian County--Oklahoma City (West) PUMA, Oklahoma/OK",40017,"Canadian County, Oklahoma",136710,2178,17,1593,12,1,559,0,12,13,282,0,572,282,12,282,12,294,866,65,2,33,1,33,0,0,1,66,34,33,1
40,Oklahoma/OK,4000900,"Cleveland County--Norman, Oklahoma City (South) & Moore Cities PUMA, Oklahoma/OK",40027,"Cleveland County, Oklahoma",276733,5908,70,2135,25,1,239,0,64,54,23,0,293,23,64,23,64,87,380,63,14,6,17,6,0,0,17,77,23,6,17
40,Oklahoma/OK,4001001,"Oklahoma County (Southwest)--Oklahoma City (West Central) PUMA, Oklahoma/OK",40109,"Oklahoma County, Oklahoma",782051,17556,190,2245,24,1,80,19,60,292,0,0,372,19,60,0,79,79,451,18,65,0,18,0,4,0,13,82,18,4,13
40,Oklahoma/OK,4001002,"Oklahoma County (Northwest)--Oklahoma City (Northwest Central) & Bethany Cities PUMA, Oklahoma/OK",40109,"Oklahoma County, Oklahoma",782051,17556,190,2245,24,1,254,0,0,81,0,0,335,0,0,0,0,0,335,76,24,0,0,0,0,0,0,100,0,0,0
40,Oklahoma/OK,4001003,"Oklahoma County (Northeast)--Edmond & Oklahoma City (North Central) Cities PUMA, Oklahoma/OK",40109,"Oklahoma County, Oklahoma",782051,17556,190,2245,24,1,253,52,161,0,0,0,253,52,161,0,213,213,466,54,0,0,46,0,11,0,35,54,46,11,35
40,Oklahoma/OK,4001004,"Oklahoma County (East)--Midwest, Del & Oklahoma City (Northeast) Cities PUMA, Oklahoma/OK",40109,"Oklahoma County, Oklahoma",782051,17556,190,2245,24,1,177,0,0,0,0,0,177,0,0,0,0,0,177,100,0,0,0,0,0,0,0,100,0,0,0
40,Oklahoma/OK,4001005,"Oklahoma County (Southeast)--Oklahoma City (East Central) PUMA, Oklahoma/OK",40109,"Oklahoma County, Oklahoma",782051,17556,190,2245,24,1,127,56,154,0,0,0,127,56,154,0,210,210,337,38,0,0,62,0,17,0,46,38,62,17,46
40,Oklahoma/OK,4001006,"Oklahoma County (Central)--Oklahoma City (Central) PUMA, Oklahoma/OK",40109,"Oklahoma County, Oklahoma",782051,17556,190,2245,24,1,70,0,43,0,13,0,70,13,43,13,43,56,126,56,0,10,34,10,0,0,34,56,44,10,34
40,Oklahoma/OK,4001101,"Grady, McClain & Pottawatomie (South) Counties PUMA, Oklahoma/OK",40051,"Grady County, Oklahoma",54733,1034,11,1889,20,0.486,201,0,37,7,26,0,208,26,37,26,37,63,271,74,3,10,14,10,0,0,14,77,23,10,14
40,Oklahoma/OK,4001101,"Grady, McClain & Pottawatomie (South) Counties PUMA, Oklahoma/OK",40087,"McClain County, Oklahoma",38634,846,7,2190,18,0.344,142,0,26,5,18,0,147,18,26,18,26,44,191,74,3,9,14,9,0,0,14,77,23,9,14
40,Oklahoma/OK,4001101,"Grady, McClain & Pottawatomie (South) Counties PUMA, Oklahoma/OK",40125,"Pottawatomie County, Oklahoma",72000,1313,10,1824,14,0.17,70,0,13,3,9,0,73,9,13,9,13,22,95,74,3,9,14,9,0,0,14,77,23,9,14
40,Oklahoma/OK,4001102,"Pottawatomie (North), Logan & Lincoln Counties--Shawnee City PUMA, Oklahoma/OK",40081,"Lincoln County, Oklahoma",34854,435,10,1248,29,0.26,167,0,16,15,11,0,182,11,16,11,16,27,209,80,7,5,8,5,0,0,8,87,13,5,8
40,Oklahoma/OK,4001102,"Pottawatomie (North), Logan & Lincoln Counties--Shawnee City PUMA, Oklahoma/OK",40083,"Logan County, Oklahoma",46044,456,1,990,2,0.345,222,0,22,20,15,0,242,15,22,15,22,37,279,80,7,5,8,5,0,0,8,87,13,5,8
40,Oklahoma/OK,4001102,"Pottawatomie (North), Logan & Lincoln Counties--Shawnee City PUMA, Oklahoma/OK",40125,"Pottawatomie County, Oklahoma",72000,1313,10,1824,14,0.394,254,0,25,23,17,0,277,17,25,17,25,42,319,80,7,5,8,5,0,0,8,87,13,5,8
40,Oklahoma/OK,4001201,"Tulsa County (Central)--Tulsa City (Central) PUMA, Oklahoma/OK",40143,"Tulsa County, Oklahoma",642781,16683,159,2595,25,1,233,54,229,66,0,47,299,54,276,47,283,330,629,37,10,7,45,0,9,7,36,48,52,9,44
40,Oklahoma/OK,4001202,"Tulsa County (Southeast)--Tulsa (Southeast) & Broken Arrow (West) Cities PUMA, Oklahoma/OK",40143,"Tulsa County, Oklahoma",642781,16683,159,2595,25,1,180,69,79,0,16,22,180,85,101,38,148,186,366,49,0,10,40,4,19,6,22,49,51,23,28
40,Oklahoma/OK,4001203,"Tulsa County (North)--Tulsa (North) & Owasso Cities PUMA, Oklahoma/OK",40143,"Tulsa County, Oklahoma",642781,16683,159,2595,25,1,255,0,42,0,0,17,255,0,59,17,42,59,314,81,0,5,13,0,0,5,13,81,19,0,19
40,Oklahoma/OK,4001204,"Tulsa (West), Creek (Northeast) & Osage (Southeast) Counties--Tulsa City (West) PUMA, Oklahoma/OK",40037,"Creek County, Oklahoma",71160,1121,33,1575,46,0.239,92,0,5,0,0,0,92,0,5,0,5,5,97,95,0,0,5,0,0,0,5,95,5,0,5
40,Oklahoma/OK,4001204,"Tulsa (West), Creek (Northeast) & Osage (Southeast) Counties--Tulsa City (West) PUMA, Oklahoma/OK",40113,"Osage County, Oklahoma",47311,836,13,1767,27,0.146,56,0,3,0,0,0,56,0,3,0,3,3,59,95,0,0,5,0,0,0,5,95,5,0,5
40,Oklahoma/OK,4001204,"Tulsa (West), Creek (Northeast) & Osage (Southeast) Counties--Tulsa City (West) PUMA, Oklahoma/OK",40143,"Tulsa County, Oklahoma",642781,16683,159,2595,25,0.616,237,0,12,0,0,0,237,0,12,0,12,12,249,95,0,0,5,0,0,0,5,95,5,0,5
40,Oklahoma/OK,4001301,"Rogers (Central) & Wagoner (West) Counties--Claremore City PUMA, Oklahoma/OK",40131,"Rogers County, Oklahoma",90814,1816,49,2000,54,0.532,58,0,0,0,0,0,58,0,0,0,0,0,58,100,0,0,0,0,0,0,0,100,0,0,0
40,Oklahoma/OK,4001301,"Rogers (Central) & Wagoner (West) Counties--Claremore City PUMA, Oklahoma/OK",40145,"Wagoner County, Oklahoma",77850,1455,26,1869,33,0.468,51,0,0,0,0,0,51,0,0,0,0,0,51,100,0,0,0,0,0,0,0,100,0,0,0
40,Oklahoma/OK,4001302,"Muskogee, Okmulgee, Wagoner (East) & McIntosh Counties PUMA, Oklahoma/OK",40091,"McIntosh County, Oklahoma",19819,310,5,1564,25,0.132,37,0,4,8,0,0,45,0,4,0,4,4,49,76,16,0,8,0,0,0,8,92,8,0,8
40,Oklahoma/OK,4001302,"Muskogee, Okmulgee, Wagoner (East) & McIntosh Counties PUMA, Oklahoma/OK",40101,"Muskogee County, Oklahoma",69084,1792,22,2594,32,0.463,129,0,13,26,0,0,155,0,13,0,13,13,168,77,15,0,8,0,0,0,8,92,8,0,8
40,Oklahoma/OK,4001302,"Muskogee, Okmulgee, Wagoner (East) & McIntosh Counties PUMA, Oklahoma/OK",40111,"Okmulgee County, Oklahoma",38889,823,7,2116,18,0.261,73,0,7,15,0,0,88,0,7,0,7,7,95,77,16,0,7,0,0,0,7,93,7,0,7
40,Oklahoma/OK,4001302,"Muskogee, Okmulgee, Wagoner (East) & McIntosh Counties PUMA, Oklahoma/OK",40145,"Wagoner County, Oklahoma",77850,1455,26,1869,33,0.144,40,0,4,8,0,0,48,0,4,0,4,4,52,77,15,0,8,0,0,0,8,92,8,0,8
40,Oklahoma/OK,4001400,"Garfield, Kay & Noble Counties--Enid City PUMA, Oklahoma/OK",40047,"Garfield County, Oklahoma",62190,1604,20,2579,32,0.526,408,56,89,76,18,3,484,74,92,21,145,166,650,63,12,3,22,3,9,0,14,74,26,11,14
40,Oklahoma/OK,4001400,"Garfield, Kay & Noble Counties--Enid City PUMA, Oklahoma/OK",40071,"Kay County, Oklahoma",44880,570,13,1270,29,0.378,293,40,64,54,13,2,347,53,66,15,104,119,466,63,12,3,22,3,9,0,14,74,26,11,14
40,Oklahoma/OK,4001400,"Garfield, Kay & Noble Counties--Enid City PUMA, Oklahoma/OK",40103,"Noble County, Oklahoma",11411,151,2,1323,18,0.096,74,10,16,14,3,1,88,13,17,4,26,30,118,63,12,3,22,3,8,1,14,75,25,11,14
40,Oklahoma/OK,4001501,"Payne, Seminole, Creek (Southwest), Hughes & Okfuskee Counties--Stillwater City PUMA, Oklahoma/OK",40037,"Creek County, Oklahoma",71160,1121,33,1575,46,0.137,96,2,12,23,2,0,119,4,12,2,14,16,135,71,17,1,10,1,1,0,9,88,12,3,9
40,Oklahoma/OK,4001501,"Payne, Seminole, Creek (Southwest), Hughes & Okfuskee Counties--Stillwater City PUMA, Oklahoma/OK",40063,"Hughes County, Oklahoma",13460,293,4,2177,30,0.089,63,1,8,15,1,0,78,2,8,1,9,10,88,72,17,1,10,1,1,0,9,89,11,2,9
40,Oklahoma/OK,4001501,"Payne, Seminole, Creek (Southwest), Hughes & Okfuskee Counties--Stillwater City PUMA, Oklahoma/OK",40107,"Okfuskee County, Oklahoma",12115,136,4,1123,33,0.079,56,1,7,13,1,0,69,2,7,1,8,9,78,72,17,1,10,1,1,0,9,88,12,3,9
40,Oklahoma/OK,4001501,"Payne, Seminole, Creek (Southwest), Hughes & Okfuskee Counties--Stillwater City PUMA, Oklahoma/OK",40119,"Payne County, Oklahoma",81512,2181,6,2676,7,0.53,373,7,47,89,8,0,462,15,47,8,54,62,524,71,17,2,10,2,1,0,9,88,12,3,9
40,Oklahoma/OK,4001501,"Payne, Seminole, Creek (Southwest), Hughes & Okfuskee Counties--Stillwater City PUMA, Oklahoma/OK",40133,"Seminole County, Oklahoma",25071,443,6,1767,24,0.165,116,2,15,28,2,0,144,4,15,2,17,19,163,71,17,1,10,1,1,0,9,88,12,2,9
40,Oklahoma/OK,4001601,"Washington, Osage (North & West), Pawnee & Creek (Northwest) Counties PUMA, Oklahoma/OK",40037,"Creek County, Oklahoma",71160,1121,33,1575,46,0.097,26,0,0,0,1,0,26,1,0,1,0,1,27,96,0,4,0,4,0,0,0,96,4,4,0
40,Oklahoma/OK,4001601,"Washington, Osage (North & West), Pawnee & Creek (Northwest) Counties PUMA, Oklahoma/OK",40113,"Osage County, Oklahoma",47311,836,13,1767,27,0.228,60,0,0,0,1,0,60,1,0,1,0,1,61,98,0,2,0,2,0,0,0,98,2,2,0
40,Oklahoma/OK,4001601,"Washington, Osage (North & West), Pawnee & Creek (Northwest) Counties PUMA, Oklahoma/OK",40117,"Pawnee County, Oklahoma",16428,252,3,1534,18,0.162,43,0,0,0,1,0,43,1,0,1,0,1,44,98,0,2,0,2,0,0,0,98,2,2,0
40,Oklahoma/OK,4001601,"Washington, Osage (North & West), Pawnee & Creek (Northwest) Counties PUMA, Oklahoma/OK",40147,"Washington County, Oklahoma",52001,983,40,1890,77,0.513,136,0,0,0,3,0,136,3,0,3,0,3,139,98,0,2,0,2,0,0,0,98,2,2,0
41,Oregon/OR,4100100,"Umatilla, Union, Baker & Wallowa Counties PUMA, Oregon/OR",41001,"Baker County, Oregon",15984,92,2,576,13,0.128,198,24,230,44,3,0,242,27,230,3,254,257,499,40,9,1,51,1,5,0,46,48,52,5,46
41,Oregon/OR,4100100,"Umatilla, Union, Baker & Wallowa Counties PUMA, Oregon/OR",41059,"Umatilla County, Oregon",76898,2962,41,3852,53,0.609,941,113,1096,210,14,0,1151,127,1096,14,1209,1223,2374,40,9,1,51,1,5,0,46,48,52,5,46
41,Oregon/OR,4100100,"Umatilla, Union, Baker & Wallowa Counties PUMA, Oregon/OR",41061,"Union County, Oregon",26028,443,2,1702,8,0.208,321,38,374,72,5,0,393,43,374,5,412,417,810,40,9,1,51,1,5,0,46,49,51,5,46
41,Oregon/OR,4100100,"Umatilla, Union, Baker & Wallowa Counties PUMA, Oregon/OR",41063,"Wallowa County, Oregon",6924,28,1,404,14,0.055,85,10,99,19,1,0,104,11,99,1,109,110,214,40,9,0,51,0,5,0,46,49,51,5,46
41,Oregon/OR,4100200,"North Central Oregon--The Dalles City PUMA, Oregon/OR",41013,"Crook County, Oregon",22337,61,1,273,4,0.191,207,76,415,68,0,1,275,76,416,1,491,492,767,27,9,0,64,0,10,0,54,36,64,10,54
41,Oregon/OR,4100200,"North Central Oregon--The Dalles City PUMA, Oregon/OR",41021,"Gilliam County, Oregon",1907,8,0,420,0,0.016,17,6,35,6,0,0,23,6,35,0,41,41,64,27,9,0,64,0,9,0,55,36,64,9,55
41,Oregon/OR,4100200,"North Central Oregon--The Dalles City PUMA, Oregon/OR",41023,"Grant County, Oregon",7183,9,0,125,0,0.06,65,24,130,21,0,0,86,24,130,0,154,154,240,27,9,0,64,0,10,0,54,36,64,10,54
41,Oregon/OR,4100200,"North Central Oregon--The Dalles City PUMA, Oregon/OR",41027,"Hood River County, Oregon",23131,248,0,1072,0,0.196,212,78,426,70,0,1,282,78,427,1,504,505,787,27,9,0,64,0,10,0,54,36,64,10,54
41,Oregon/OR,4100200,"North Central Oregon--The Dalles City PUMA, Oregon/OR",41031,"Jefferson County, Oregon",23143,524,8,2264,35,0.195,211,78,424,69,0,1,280,78,425,1,502,503,783,27,9,0,64,0,10,0,54,36,64,10,54
41,Oregon/OR,4100200,"North Central Oregon--The Dalles City PUMA, Oregon/OR",41049,"Morrow County, Oregon",11215,498,6,4440,53,0.095,103,38,207,34,0,1,137,38,208,1,245,246,383,27,9,0,64,0,10,0,54,36,64,10,54
41,Oregon/OR,4100200,"North Central Oregon--The Dalles City PUMA, Oregon/OR",41055,"Sherman County, Oregon",1605,18,0,1121,0,0.014,15,6,30,5,0,0,20,6,30,0,36,36,56,27,9,0,64,0,11,0,54,36,64,11,54
41,Oregon/OR,4100200,"North Central Oregon--The Dalles City PUMA, Oregon/OR",41065,"Wasco County, Oregon",25866,282,3,1090,12,0.221,239,88,480,78,0,2,317,88,482,2,568,570,887,27,9,0,64,0,10,0,54,36,64,10,54
41,Oregon/OR,4100200,"North Central Oregon--The Dalles City PUMA, Oregon/OR",41069,"Wheeler County, Oregon",1426,NA,NA,NA,NA,0.011,12,4,24,4,0,0,16,4,24,0,28,28,44,27,9,0,64,0,9,0,55,36,64,9,55
41,Oregon/OR,4100300,"Klamath, Malheur, Lake & Harney Counties PUMA, Oregon/OR",41025,"Harney County, Oregon",7228,12,0,166,0,0.065,76,6,51,13,4,0,89,10,51,4,57,61,150,51,9,3,38,3,4,0,34,59,41,7,34
41,Oregon/OR,4100300,"Klamath, Malheur, Lake & Harney Counties PUMA, Oregon/OR",41035,"Klamath County, Oregon",66310,280,2,422,3,0.593,695,54,468,117,34,0,812,88,468,34,522,556,1368,51,9,2,38,2,4,0,34,59,41,6,34
41,Oregon/OR,4100300,"Klamath, Malheur, Lake & Harney Counties PUMA, Oregon/OR",41037,"Lake County, Oregon",7843,32,0,408,0,0.07,82,6,55,14,4,0,96,10,55,4,61,65,161,51,9,2,38,2,4,0,34,60,40,6,34
41,Oregon/OR,4100300,"Klamath, Malheur, Lake & Harney Counties PUMA, Oregon/OR",41045,"Malheur County, Oregon",30431,1609,26,5287,85,0.272,319,25,215,54,16,0,373,41,215,16,240,256,629,51,9,3,38,3,4,0,34,59,41,7,34
41,Oregon/OR,4100400,"Deschutes County PUMA, Oregon/OR",41017,"Deschutes County, Oregon",180640,810,12,448,7,1,320,0,264,56,40,0,376,40,264,40,264,304,680,47,8,6,39,6,0,0,39,55,45,6,39
41,Oregon/OR,4100500,"Columbia, Lincoln, Clatsop & Tillamook Counties PUMA, Oregon/OR",41007,"Clatsop County, Oregon",38562,205,0,532,0,0.236,161,2,115,8,0,8,169,2,123,8,117,125,294,55,3,3,40,0,1,3,39,57,43,1,42
41,Oregon/OR,4100500,"Columbia, Lincoln, Clatsop & Tillamook Counties PUMA, Oregon/OR",41009,"Columbia County, Oregon",50851,162,1,319,2,0.311,212,3,151,11,0,10,223,3,161,10,154,164,387,55,3,3,40,0,1,3,39,58,42,1,42
41,Oregon/OR,4100500,"Columbia, Lincoln, Clatsop & Tillamook Counties PUMA, Oregon/OR",41041,"Lincoln County, Oregon",47881,478,13,998,27,0.293,200,3,142,11,0,10,211,3,152,10,145,155,366,55,3,3,40,0,1,3,39,58,42,1,42
41,Oregon/OR,4100500,"Columbia, Lincoln, Clatsop & Tillamook Counties PUMA, Oregon/OR",41057,"Tillamook County, Oregon",26076,52,0,199,0,0.16,109,1,78,6,0,5,115,1,83,5,79,84,199,55,3,3,40,0,1,3,39,58,42,1,42
41,Oregon/OR,4100600,"Linn & Benton Counties PUMA, Oregon/OR",41003,"Benton County, Oregon",89780,307,6,342,7,0.421,612,48,252,44,10,24,656,58,276,34,300,334,990,62,4,3,30,1,5,2,25,66,34,6,28
41,Oregon/OR,4100600,"Linn & Benton Counties PUMA, Oregon/OR",41043,"Linn County, Oregon",122870,508,13,413,11,0.579,841,67,347,60,13,33,901,80,380,46,414,460,1361,62,4,3,30,1,5,2,25,66,34,6,28
41,Oregon/OR,4100703,"Lane County (West Central)--Eugene City (West & South) PUMA, Oregon/OR",41039,"Lane County, Oregon",368882,1143,17,310,5,1,669,25,135,148,0,0,817,25,135,0,160,160,977,68,15,0,16,0,3,0,14,84,16,3,14
41,Oregon/OR,4100704,"Lane County (East Central)--Eugene (Northeast) & Springfield Cities PUMA, Oregon/OR",41039,"Lane County, Oregon",368882,1143,17,310,5,1,637,0,187,44,0,0,681,0,187,0,187,187,868,73,5,0,22,0,0,0,22,78,22,0,22
41,Oregon/OR,4100705,"Lane County (Outside Eugene & Springfield Cities) PUMA, Oregon/OR",41039,"Lane County, Oregon",368882,1143,17,310,5,1,350,19,73,47,18,0,397,37,73,18,92,110,507,69,9,4,18,4,4,0,14,78,22,7,14
41,Oregon/OR,4100800,"Josephine, Coos & Curry Counties PUMA, Oregon/OR",41011,"Coos County, Oregon",63308,152,0,240,0,0.37,384,16,87,37,0,0,421,16,87,0,103,103,524,73,7,0,20,0,3,0,17,80,20,3,17
41,Oregon/OR,4100800,"Josephine, Coos & Curry Counties PUMA, Oregon/OR",41015,"Curry County, Oregon",22507,31,0,138,0,0.132,137,6,31,13,0,0,150,6,31,0,37,37,187,73,7,0,20,0,3,0,17,80,20,3,17
41,Oregon/OR,4100800,"Josephine, Coos & Curry Counties PUMA, Oregon/OR",41033,"Josephine County, Oregon",85481,197,2,230,2,0.498,516,21,117,49,0,0,565,21,117,0,138,138,703,73,7,0,20,0,3,0,17,80,20,3,17
41,Oregon/OR,4100901,"Jackson County (Central)--Medford & Central Point Cities PUMA, Oregon/OR",41029,"Jackson County, Oregon",214267,1123,5,524,2,1,364,75,508,130,0,13,494,75,521,13,583,596,1090,33,12,1,53,0,7,1,47,45,55,7,48
41,Oregon/OR,4100902,"Jackson County (Outside Medford & Central Point Cities)--Ashland City PUMA, Oregon/OR",41029,"Jackson County, Oregon",214267,1123,5,524,2,1,271,0,220,73,0,0,344,0,220,0,220,220,564,48,13,0,39,0,0,0,39,61,39,0,39
41,Oregon/OR,4101000,"Douglas County PUMA, Oregon/OR",41019,"Douglas County, Oregon",108323,223,4,206,4,1,376,10,98,0,0,0,376,10,98,0,108,108,484,78,0,0,22,0,2,0,20,78,22,2,20
41,Oregon/OR,4101103,"Marion County (West Central)--Salem (North), Keizer Cities & Hayesville PUMA, Oregon/OR",41047,"Marion County, Oregon",335553,4627,92,1379,27,1,382,478,2336,490,78,0,872,556,2336,78,2814,2892,3764,10,13,2,75,2,13,0,62,23,77,15,62
41,Oregon/OR,4101104,"Marion County (West Central)--Salem City (South) & Four Corners PUMA, Oregon/OR",41047,"Marion County, Oregon",335553,4627,92,1379,27,1,307,0,687,58,51,8,365,51,695,59,687,746,1111,28,5,5,62,5,0,1,62,33,67,5,63
41,Oregon/OR,4101105,"Marion County (Outside Salem & Keizer Cities)--Woodburn & Silverton Cities PUMA, Oregon/OR",41047,"Marion County, Oregon",335553,4627,92,1379,27,1,688,263,1669,341,0,32,1029,263,1701,32,1932,1964,2993,23,11,1,65,0,9,1,56,34,66,9,57
41,Oregon/OR,4101200,"Yamhill & Polk Counties PUMA, Oregon/OR",41053,"Polk County, Oregon",81427,523,15,642,18,0.438,444,235,948,115,0,0,559,235,948,0,1183,1183,1742,25,7,0,68,0,13,0,54,32,68,13,54
41,Oregon/OR,4101200,"Yamhill & Polk Counties PUMA, Oregon/OR",41071,"Yamhill County, Oregon",103820,755,13,727,13,0.562,570,301,1216,148,0,0,718,301,1216,0,1517,1517,2235,26,7,0,68,0,13,0,54,32,68,13,54
41,Oregon/OR,4101301,"Portland City (North & Northeast) PUMA, Oregon/OR",41051,"Multnomah County, Oregon",798647,7081,138,887,17,1,298,65,74,127,33,0,425,98,74,33,139,172,597,50,21,6,23,6,11,0,12,71,29,16,12
41,Oregon/OR,4101302,"Portland City (East) PUMA, Oregon/OR",41051,"Multnomah County, Oregon",798647,7081,138,887,17,1,253,0,339,0,48,20,253,48,359,68,339,407,660,38,0,10,51,7,0,3,51,38,62,7,54
41,Oregon/OR,4101303,"Portland City (Southeast) PUMA, Oregon/OR",41051,"Multnomah County, Oregon",798647,7081,138,887,17,1,256,18,114,30,59,42,286,77,156,101,132,233,519,49,6,19,25,11,3,8,22,55,45,15,30
41,Oregon/OR,4101305,"Portland City (Central East) PUMA, Oregon/OR",41051,"Multnomah County, Oregon",798647,7081,138,887,17,1,231,20,53,95,0,35,326,20,88,35,73,108,434,53,22,8,17,0,5,8,12,75,25,5,20
41,Oregon/OR,4101314,"Portland City (Northwest & Southwest) PUMA, Oregon/OR",41051,"Multnomah County, Oregon",798647,7081,138,887,17,1,177,0,0,3,0,44,180,0,44,44,0,44,224,79,1,20,0,0,0,20,0,80,20,0,20
41,Oregon/OR,4101316,"Multnomah County (East)--Gresham & Troutdale Cities PUMA, Oregon/OR",41051,"Multnomah County, Oregon",798647,7081,138,887,17,1,302,158,643,96,68,98,398,226,741,166,801,967,1365,22,7,12,59,5,12,7,47,29,71,17,54
41,Oregon/OR,4101317,"Clackamas County (South & East)--Damascus City PUMA, Oregon/OR",41005,"Clackamas County, Oregon",405788,2377,63,586,16,1,267,42,408,184,0,14,451,42,422,14,450,464,915,29,20,2,49,0,5,2,45,49,51,5,46
41,Oregon/OR,4101318,"Clackamas County (Northwest)--Oregon City, Milwaukie & Happy Valley Cities PUMA, Oregon/OR",41005,"Clackamas County, Oregon",405788,2377,63,586,16,1,586,91,25,130,27,14,716,118,39,41,116,157,873,67,15,5,13,3,10,2,3,82,18,14,4
41,Oregon/OR,4101319,"Clackamas County (Northwest)--Lake Oswego, West Linn, Wilsonville & Canby Cities PUMA, Oregon/OR",41005,"Clackamas County, Oregon",405788,2377,63,586,16,1,99,77,400,27,0,0,126,77,400,0,477,477,603,16,4,0,79,0,13,0,66,21,79,13,66
41,Oregon/OR,4101320,"Washington County (Southeast)--Tigard, Tualatin & Sherwood Cities PUMA, Oregon/OR",41067,"Washington County, Oregon",581821,4468,59,768,10,1,295,95,112,52,24,0,347,119,112,24,207,231,578,51,9,4,36,4,16,0,19,60,40,21,19
41,Oregon/OR,4101321,"Washington County (West)--Forest Grove, Cornelius Cities, Bethany & Oak Hills PUMA, Oregon/OR",41067,"Washington County, Oregon",581821,4468,59,768,10,1,188,45,765,380,0,27,568,45,792,27,810,837,1405,13,27,2,58,0,3,2,54,40,60,3,56
41,Oregon/OR,4101322,"Washington County (Central)--Hillsboro City PUMA, Oregon/OR",41067,"Washington County, Oregon",581821,4468,59,768,10,1,214,112,649,232,39,0,446,151,649,39,761,800,1246,17,19,3,61,3,9,0,52,36,64,12,52
41,Oregon/OR,4101323,"Washington County (Central)--Beaverton City (West) & Aloha PUMA, Oregon/OR",41067,"Washington County, Oregon",581821,4468,59,768,10,1,96,77,49,30,13,0,126,90,49,13,126,139,265,36,11,5,48,5,29,0,18,48,52,34,18
41,Oregon/OR,4101324,"Washington County (Northeast)--Beaverton City (East & Central) & Cedar Mill PUMA, Oregon/OR",41067,"Washington County, Oregon",581821,4468,59,768,10,1,311,69,286,29,0,0,340,69,286,0,355,355,695,45,4,0,51,0,10,0,41,49,51,10,41
42,Pennsylvania/PA,4200101,"Erie City, Lawrence Park Township & Wesleyville Borough PUMA, Pennsylvania/PA",42049,"Erie County, Pennsylvania",275972,1526,48,553,17,1,411,12,12,75,75,33,486,87,45,108,24,132,618,67,12,17,4,12,2,5,2,79,21,14,7
42,Pennsylvania/PA,4200102,"Erie County (Outer) PUMA, Pennsylvania/PA",42049,"Erie County, Pennsylvania",275972,1526,48,553,17,1,793,0,1,0,0,29,793,0,30,29,1,30,823,96,0,4,0,0,0,4,0,96,4,0,4
42,Pennsylvania/PA,4200200,"Crawford & Warren Counties PUMA, Pennsylvania/PA",42039,"Crawford County, Pennsylvania",86164,303,3,352,3,0.683,574,0,0,31,0,3,605,0,3,3,0,3,608,94,5,0,0,0,0,0,0,100,0,0,0
42,Pennsylvania/PA,4200200,"Crawford & Warren Counties PUMA, Pennsylvania/PA",42123,"Warren County, Pennsylvania",40035,42,1,105,2,0.317,266,0,0,15,0,2,281,0,2,2,0,2,283,94,5,1,0,0,0,1,0,99,1,0,1
42,Pennsylvania/PA,4200300,"Clearfield, McKean, Elk, Potter & Cameron Counties PUMA, Pennsylvania/PA",42023,"Cameron County, Pennsylvania",4686,8,0,171,0,0.027,12,0,0,0,0,0,12,0,0,0,0,0,12,100,0,0,0,0,0,0,0,100,0,0,0
42,Pennsylvania/PA,4200300,"Clearfield, McKean, Elk, Potter & Cameron Counties PUMA, Pennsylvania/PA",42033,"Clearfield County, Pennsylvania",80216,317,3,395,4,0.462,213,0,0,0,0,2,213,0,2,2,0,2,215,99,0,1,0,0,0,1,0,99,1,0,1
42,Pennsylvania/PA,4200300,"Clearfield, McKean, Elk, Potter & Cameron Counties PUMA, Pennsylvania/PA",42047,"Elk County, Pennsylvania",30608,72,2,235,7,0.175,81,0,0,0,0,1,81,0,1,1,0,1,82,99,0,1,0,0,0,1,0,99,1,0,1
42,Pennsylvania/PA,4200300,"Clearfield, McKean, Elk, Potter & Cameron Counties PUMA, Pennsylvania/PA",42083,"McKean County, Pennsylvania",41806,57,2,136,5,0.24,111,0,0,0,0,1,111,0,1,1,0,1,112,99,0,1,0,0,0,1,0,99,1,0,1
42,Pennsylvania/PA,4200300,"Clearfield, McKean, Elk, Potter & Cameron Counties PUMA, Pennsylvania/PA",42105,"Potter County, Pennsylvania",16937,28,0,165,0,0.097,45,0,0,0,0,0,45,0,0,0,0,0,45,100,0,0,0,0,0,0,0,100,0,0,0
42,Pennsylvania/PA,4200400,"Bradford, Tioga & Sullivan Counties PUMA, Pennsylvania/PA",42015,"Bradford County, Pennsylvania",61304,135,3,220,5,0.561,753,0,30,6,0,2,759,0,32,2,30,32,791,95,1,0,4,0,0,0,4,96,4,0,4
42,Pennsylvania/PA,4200400,"Bradford, Tioga & Sullivan Counties PUMA, Pennsylvania/PA",42113,"Sullivan County, Pennsylvania",6177,11,0,178,0,0.057,76,0,3,1,0,0,77,0,3,0,3,3,80,95,1,0,4,0,0,0,4,96,4,0,4
42,Pennsylvania/PA,4200400,"Bradford, Tioga & Sullivan Counties PUMA, Pennsylvania/PA",42117,"Tioga County, Pennsylvania",41226,67,3,163,7,0.383,514,0,21,4,0,1,518,0,22,1,21,22,540,95,1,0,4,0,0,0,4,96,4,0,4
42,Pennsylvania/PA,4200500,"Pike, Wayne & Susquehanna Counties PUMA, Pennsylvania/PA",42103,"Pike County, Pennsylvania",55498,572,22,1031,40,0.378,198,0,11,11,0,0,209,0,11,0,11,11,220,90,5,0,5,0,0,0,5,95,5,0,5
42,Pennsylvania/PA,4200500,"Pike, Wayne & Susquehanna Counties PUMA, Pennsylvania/PA",42115,"Susquehanna County, Pennsylvania",41340,293,28,709,68,0.278,145,0,8,8,0,0,153,0,8,0,8,8,161,90,5,0,5,0,0,0,5,95,5,0,5
42,Pennsylvania/PA,4200500,"Pike, Wayne & Susquehanna Counties PUMA, Pennsylvania/PA",42127,"Wayne County, Pennsylvania",51536,224,10,435,19,0.345,180,0,10,10,0,0,190,0,10,0,10,10,200,90,5,0,5,0,0,0,5,95,5,0,5
42,Pennsylvania/PA,4200600,"Monroe County PUMA, Pennsylvania/PA",42089,"Monroe County, Pennsylvania",167586,1787,133,1066,79,1,255,0,120,68,0,0,323,0,120,0,120,120,443,58,15,0,27,0,0,0,27,73,27,0,27
42,Pennsylvania/PA,4200701,"Lackawanna County--Scranton City, Dunmore, Old Forge, Taylor & Moosic Boroughs PUMA, Pennsylvania/PA",42069,"Lackawanna County, Pennsylvania",211454,2459,217,1163,103,1,241,0,135,499,20,102,740,20,237,122,135,257,997,24,50,12,14,2,0,10,14,74,26,2,24
42,Pennsylvania/PA,4200702,"Lackawanna (Outside Greater Scranton City) & Wyoming Counties PUMA, Pennsylvania/PA",42069,"Lackawanna County, Pennsylvania",211454,2459,217,1163,103,0.788,507,0,4,0,0,19,507,0,23,19,4,23,530,96,0,4,1,0,0,4,1,96,4,0,4
42,Pennsylvania/PA,4200702,"Lackawanna (Outside Greater Scranton City) & Wyoming Counties PUMA, Pennsylvania/PA",42131,"Wyoming County, Pennsylvania",27588,74,8,268,29,0.212,137,0,1,0,0,5,137,0,6,5,1,6,143,96,0,3,1,0,0,3,1,96,4,0,4
42,Pennsylvania/PA,4200801,"Luzerne County (East)--Kingston Borough PUMA, Pennsylvania/PA",42079,"Luzerne County, Pennsylvania",317884,4071,189,1281,59,1,421,0,171,0,12,38,421,12,209,50,171,221,642,66,0,8,27,2,0,6,27,66,34,2,33
42,Pennsylvania/PA,4200802,"Luzerne County (South Central)--Wilkes-Barre & Hazleton Cities PUMA, Pennsylvania/PA",42079,"Luzerne County, Pennsylvania",317884,4071,189,1281,59,1,827,177,548,160,40,0,987,217,548,40,725,765,1752,47,9,2,41,2,10,0,31,56,44,12,31
42,Pennsylvania/PA,4200803,"Columbia & Luzerne (West) Counties--Bloomsburg Town & Berwick Borough PUMA, Pennsylvania/PA",42037,"Columbia County, Pennsylvania",66220,883,35,1333,53,0.51,489,6,38,11,4,0,500,10,38,4,44,48,548,89,2,1,8,1,1,0,7,91,9,2,7
42,Pennsylvania/PA,4200803,"Columbia & Luzerne (West) Counties--Bloomsburg Town & Berwick Borough PUMA, Pennsylvania/PA",42079,"Luzerne County, Pennsylvania",317884,4071,189,1281,59,0.49,470,5,37,10,3,0,480,8,37,3,42,45,525,90,2,1,8,1,1,0,7,91,9,2,7
42,Pennsylvania/PA,4200900,"Lycoming & Clinton Counties PUMA, Pennsylvania/PA",42035,"Clinton County, Pennsylvania",39074,204,6,522,15,0.254,170,0,0,0,0,0,170,0,0,0,0,0,170,100,0,0,0,0,0,0,0,100,0,0,0
42,Pennsylvania/PA,4200900,"Lycoming & Clinton Counties PUMA, Pennsylvania/PA",42081,"Lycoming County, Pennsylvania",114859,658,25,573,22,0.746,498,0,0,0,0,0,498,0,0,0,0,0,498,100,0,0,0,0,0,0,0,100,0,0,0
42,Pennsylvania/PA,4201000,"Northumberland & Montour Counties PUMA, Pennsylvania/PA",42093,"Montour County, Pennsylvania",18294,168,5,918,27,0.165,178,0,0,3,2,0,181,2,0,2,0,2,183,97,2,1,0,1,0,0,0,99,1,1,0
42,Pennsylvania/PA,4201000,"Northumberland & Montour Counties PUMA, Pennsylvania/PA",42097,"Northumberland County, Pennsylvania",92325,963,51,1043,55,0.835,900,0,0,17,10,0,917,10,0,10,0,10,927,97,2,1,0,1,0,0,0,99,1,1,0
42,Pennsylvania/PA,4201100,"Mifflin, Union, Snyder & Juniata Counties PUMA, Pennsylvania/PA",42067,"Juniata County, Pennsylvania",24562,186,7,757,28,0.158,270,11,40,30,0,0,300,11,40,0,51,51,351,77,9,0,15,0,3,0,11,85,15,3,11
42,Pennsylvania/PA,4201100,"Mifflin, Union, Snyder & Juniata Counties PUMA, Pennsylvania/PA",42087,"Mifflin County, Pennsylvania",46362,221,2,477,4,0.295,505,21,76,56,0,0,561,21,76,0,97,97,658,77,9,0,15,0,3,0,12,85,15,3,12
42,Pennsylvania/PA,4201100,"Mifflin, Union, Snyder & Juniata Counties PUMA, Pennsylvania/PA",42109,"Snyder County, Pennsylvania",40466,298,4,736,10,0.257,440,18,66,49,0,0,489,18,66,0,84,84,573,77,9,0,15,0,3,0,12,85,15,3,12
42,Pennsylvania/PA,4201100,"Mifflin, Union, Snyder & Juniata Counties PUMA, Pennsylvania/PA",42119,"Union County, Pennsylvania",45114,464,6,1029,13,0.29,496,21,74,55,0,0,551,21,74,0,95,95,646,77,9,0,15,0,3,0,11,85,15,3,11
42,Pennsylvania/PA,4201200,"Centre County PUMA, Pennsylvania/PA",42027,"Centre County, Pennsylvania",161443,2231,11,1382,7,1,346,0,4,0,52,0,346,52,4,52,4,56,402,86,0,13,1,13,0,0,1,86,14,13,1
42,Pennsylvania/PA,4201300,"Venango, Jefferson, Clarion & Forest Counties PUMA, Pennsylvania/PA",42031,"Clarion County, Pennsylvania",38827,120,3,309,8,0.27,112,0,0,0,0,0,112,0,0,0,0,0,112,100,0,0,0,0,0,0,0,100,0,0,0
42,Pennsylvania/PA,4201300,"Venango, Jefferson, Clarion & Forest Counties PUMA, Pennsylvania/PA",42053,"Forest County, Pennsylvania",7351,15,0,204,0,0.051,21,0,0,0,0,0,21,0,0,0,0,0,21,100,0,0,0,0,0,0,0,100,0,0,0
42,Pennsylvania/PA,4201300,"Venango, Jefferson, Clarion & Forest Counties PUMA, Pennsylvania/PA",42065,"Jefferson County, Pennsylvania",44084,111,3,252,7,0.309,129,0,0,0,0,0,129,0,0,0,0,0,129,100,0,0,0,0,0,0,0,100,0,0,0
42,Pennsylvania/PA,4201300,"Venango, Jefferson, Clarion & Forest Counties PUMA, Pennsylvania/PA",42121,"Venango County, Pennsylvania",52376,84,1,160,2,0.369,154,0,0,0,0,0,154,0,0,0,0,0,154,100,0,0,0,0,0,0,0,100,0,0,0
42,Pennsylvania/PA,4201400,"Mercer County PUMA, Pennsylvania/PA",42085,"Mercer County, Pennsylvania",112630,720,16,639,14,1,911,0,6,29,44,38,940,44,44,82,6,88,1028,89,3,8,1,4,0,4,1,91,9,4,4
42,Pennsylvania/PA,4201501,"Lawrence & Beaver (North) Counties--New Castle City PUMA, Pennsylvania/PA",42007,"Beaver County, Pennsylvania",166896,1872,122,1122,73,0.157,35,0,1,6,0,0,41,0,1,0,1,1,42,83,14,0,2,0,0,0,2,98,2,0,2
42,Pennsylvania/PA,4201501,"Lawrence & Beaver (North) Counties--New Castle City PUMA, Pennsylvania/PA",42073,"Lawrence County, Pennsylvania",87382,510,23,584,26,0.843,188,0,4,30,0,0,218,0,4,0,4,4,222,85,14,0,2,0,0,0,2,98,2,0,2
42,Pennsylvania/PA,4201502,"Beaver County (South) PUMA, Pennsylvania/PA",42007,"Beaver County, Pennsylvania",166896,1872,122,1122,73,1,139,0,0,27,0,0,166,0,0,0,0,0,166,84,16,0,0,0,0,0,0,100,0,0,0
42,Pennsylvania/PA,4201600,"Butler County PUMA, Pennsylvania/PA",42019,"Butler County, Pennsylvania",186566,1034,23,554,12,1,295,0,13,0,0,0,295,0,13,0,13,13,308,96,0,0,4,0,0,0,4,96,4,0,4
42,Pennsylvania/PA,4201701,"Pittsburgh City (North) PUMA, Pennsylvania/PA",42003,"Allegheny County, Pennsylvania",1225561,11995,380,979,31,1,205,0,0,73,20,0,278,20,0,20,0,20,298,69,24,7,0,7,0,0,0,93,7,7,0
42,Pennsylvania/PA,4201702,"Pittsburgh City (South) PUMA, Pennsylvania/PA",42003,"Allegheny County, Pennsylvania",1225561,11995,380,979,31,1,87,0,24,0,18,0,87,18,24,18,24,42,129,67,0,14,19,14,0,0,19,67,33,14,19
42,Pennsylvania/PA,4201801,"Allegheny County (West) PUMA, Pennsylvania/PA",42003,"Allegheny County, Pennsylvania",1225561,11995,380,979,31,1,72,0,0,0,0,0,72,0,0,0,0,0,72,100,0,0,0,0,0,0,0,100,0,0,0
42,Pennsylvania/PA,4201802,"Allegheny County (North)--Franklin Park Borough & Allison Park PUMA, Pennsylvania/PA",42003,"Allegheny County, Pennsylvania",1225561,11995,380,979,31,1,131,0,0,58,0,0,189,0,0,0,0,0,189,69,31,0,0,0,0,0,0,100,0,0,0
42,Pennsylvania/PA,4201803,"Allegheny County (North Central) PUMA, Pennsylvania/PA",42003,"Allegheny County, Pennsylvania",1225561,11995,380,979,31,1,139,0,5,0,0,0,139,0,5,0,5,5,144,97,0,0,3,0,0,0,3,97,3,0,3
42,Pennsylvania/PA,4201804,"Allegheny County (East)--Monroeville Municipality, Plum & Wilkinsburg Boroughs PUMA, Pennsylvania/PA",42003,"Allegheny County, Pennsylvania",1225561,11995,380,979,31,1,207,0,0,0,18,0,207,18,0,18,0,18,225,92,0,8,0,8,0,0,0,92,8,8,0
42,Pennsylvania/PA,4201805,"Allegheny County (Southeast)--West Mifflin Borough, McKeesport City & Munhall Borough PUMA, Pennsylvania/PA",42003,"Allegheny County, Pennsylvania",1225561,11995,380,979,31,1,132,0,1,6,4,0,138,4,1,4,1,5,143,92,4,3,1,3,0,0,1,97,3,3,1
42,Pennsylvania/PA,4201806,"Allegheny County (South Central)--Baldwin & Whitehall Boroughs PUMA, Pennsylvania/PA",42003,"Allegheny County, Pennsylvania",1225561,11995,380,979,31,1,171,0,0,37,74,12,208,74,12,86,0,86,294,58,13,29,0,25,0,4,0,71,29,25,4
42,Pennsylvania/PA,4201807,"Allegheny County (South)--Bethel Park Municipality & Jefferson Hills Borough PUMA, Pennsylvania/PA",42003,"Allegheny County, Pennsylvania",1225561,11995,380,979,31,1,84,0,1,0,0,0,84,0,1,0,1,1,85,99,0,0,1,0,0,0,1,99,1,0,1
42,Pennsylvania/PA,4201900,"Indiana & Armstrong Counties PUMA, Pennsylvania/PA",42005,"Armstrong County, Pennsylvania",66331,428,18,645,27,0.435,205,0,2,0,0,0,205,0,2,0,2,2,207,99,0,0,1,0,0,0,1,99,1,0,1
42,Pennsylvania/PA,4201900,"Indiana & Armstrong Counties PUMA, Pennsylvania/PA",42063,"Indiana County, Pennsylvania",85755,692,12,807,14,0.565,267,0,2,0,0,0,267,0,2,0,2,2,269,99,0,0,1,0,0,0,1,99,1,0,1
42,Pennsylvania/PA,4202001,"Westmoreland County (Northwest)--Murrysville Municipality & New Kensington City PUMA, Pennsylvania/PA",42129,"Westmoreland County, Pennsylvania",354751,2184,52,616,15,1,271,0,3,0,0,0,271,0,3,0,3,3,274,99,0,0,1,0,0,0,1,99,1,0,1
42,Pennsylvania/PA,4202002,"Westmoreland County (Southwest)--Greensburg City PUMA, Pennsylvania/PA",42129,"Westmoreland County, Pennsylvania",354751,2184,52,616,15,1,129,4,0,0,0,0,129,4,0,0,4,4,133,97,0,0,3,0,3,0,0,97,3,3,0
42,Pennsylvania/PA,4202003,"Westmoreland County (East) PUMA, Pennsylvania/PA",42129,"Westmoreland County, Pennsylvania",354751,2184,52,616,15,1,252,0,78,0,0,0,252,0,78,0,78,78,330,76,0,0,24,0,0,0,24,76,24,0,24
42,Pennsylvania/PA,4202100,"Cambria County PUMA, Pennsylvania/PA",42021,"Cambria County, Pennsylvania",134550,560,7,416,5,1,277,0,7,0,0,0,277,0,7,0,7,7,284,98,0,0,2,0,0,0,2,98,2,0,2
42,Pennsylvania/PA,4202200,"Blair & Huntingdon Counties--Altoona City PUMA, Pennsylvania/PA",42013,"Blair County, Pennsylvania",123842,648,16,523,13,0.732,815,0,27,0,0,0,815,0,27,0,27,27,842,97,0,0,3,0,0,0,3,97,3,0,3
42,Pennsylvania/PA,4202200,"Blair & Huntingdon Counties--Altoona City PUMA, Pennsylvania/PA",42061,"Huntingdon County, Pennsylvania",45421,401,6,883,13,0.268,298,0,10,0,0,0,298,0,10,0,10,10,308,97,0,0,3,0,0,0,3,97,3,0,3
42,Pennsylvania/PA,4202301,"Cumberland (West) & Perry Counties--Carlisle Borough PUMA, Pennsylvania/PA",42041,"Cumberland County, Pennsylvania",247433,1814,77,733,31,0.678,873,0,41,42,0,3,915,0,44,3,41,44,959,91,4,0,4,0,0,0,4,95,5,0,5
42,Pennsylvania/PA,4202301,"Cumberland (West) & Perry Counties--Carlisle Borough PUMA, Pennsylvania/PA",42099,"Perry County, Pennsylvania",45924,217,6,473,13,0.322,415,0,19,20,0,2,435,0,21,2,19,21,456,91,4,0,4,0,0,0,4,95,5,0,5
42,Pennsylvania/PA,4202302,"Cumberland County (East) PUMA, Pennsylvania/PA",42041,"Cumberland County, Pennsylvania",247433,1814,77,733,31,1,390,0,0,54,49,35,444,49,35,84,0,84,528,74,10,16,0,9,0,7,0,84,16,9,7
42,Pennsylvania/PA,4202401,"Dauphin County (Central)--Harrisburg City & Colonial Park PUMA, Pennsylvania/PA",42043,"Dauphin County, Pennsylvania",274515,3767,180,1372,66,1,384,63,0,110,92,81,494,155,81,173,63,236,730,53,15,24,9,13,9,11,0,68,32,21,11
42,Pennsylvania/PA,4202402,"Dauphin County (Outer)--Hershey PUMA, Pennsylvania/PA",42043,"Dauphin County, Pennsylvania",274515,3767,180,1372,66,1,415,0,49,30,0,28,445,0,77,28,49,77,522,80,6,5,9,0,0,5,9,85,15,0,15
42,Pennsylvania/PA,4202500,"Lebanon County PUMA, Pennsylvania/PA",42075,"Lebanon County, Pennsylvania",138674,2001,59,1443,43,1,1343,0,59,427,58,110,1770,58,169,168,59,227,1997,67,21,8,3,3,0,6,3,89,11,3,8
42,Pennsylvania/PA,4202600,"Schuylkill County PUMA, Pennsylvania/PA",42107,"Schuylkill County, Pennsylvania",143555,1101,52,767,36,1,777,0,4,69,0,0,846,0,4,0,4,4,850,91,8,0,0,0,0,0,0,100,0,0,0
42,Pennsylvania/PA,4202701,"Berks County (Northwest)--Wyomissing Borough PUMA, Pennsylvania/PA",42011,"Berks County, Pennsylvania",416642,6979,393,1675,94,1,565,11,97,130,0,71,695,11,168,71,108,179,874,65,15,8,12,0,1,8,11,80,20,1,19
42,Pennsylvania/PA,4202702,"Berks County (Southwest)--Reading City PUMA, Pennsylvania/PA",42011,"Berks County, Pennsylvania",416642,6979,393,1675,94,1,353,134,1141,889,146,0,1242,280,1141,146,1275,1421,2663,13,33,5,48,5,5,0,43,47,53,11,43
42,Pennsylvania/PA,4202703,"Berks County (East) PUMA, Pennsylvania/PA",42011,"Berks County, Pennsylvania",416642,6979,393,1675,94,1,979,0,0,53,0,106,1032,0,106,106,0,106,1138,86,5,9,0,0,0,9,0,91,9,0,9
42,Pennsylvania/PA,4202801,"Carbon & Lehigh (North) Counties PUMA, Pennsylvania/PA",42025,"Carbon County, Pennsylvania",63931,462,28,723,44,0.499,376,0,19,18,5,0,394,5,19,5,19,24,418,90,4,1,5,1,0,0,5,94,6,1,5
42,Pennsylvania/PA,4202801,"Carbon & Lehigh (North) Counties PUMA, Pennsylvania/PA",42077,"Lehigh County, Pennsylvania",362613,5568,353,1536,97,0.501,377,0,19,19,5,0,396,5,19,5,19,24,420,90,5,1,5,1,0,0,5,94,6,1,5
42,Pennsylvania/PA,4202802,"Lehigh County (South--Outside Allentown & Bethlehem Cities)--Emmaus Borough PUMA, Pennsylvania/PA",42077,"Lehigh County, Pennsylvania",362613,5568,353,1536,97,1,383,0,139,86,0,5,469,0,144,5,139,144,613,62,14,1,23,0,0,1,23,77,23,0,23
42,Pennsylvania/PA,4202803,"Allentown City PUMA, Pennsylvania/PA",42077,"Lehigh County, Pennsylvania",362613,5568,353,1536,97,1,195,77,370,489,0,0,684,77,370,0,447,447,1131,17,43,0,40,0,7,0,33,60,40,7,33
42,Pennsylvania/PA,4202901,"Northampton (South) & Lehigh (East) Counties--Bethlehem (East) & Easton Cities PUMA, Pennsylvania/PA",42077,"Lehigh County, Pennsylvania",362613,5568,353,1536,97,0.115,40,4,53,20,0,2,60,4,55,2,57,59,119,34,17,2,48,0,3,2,45,50,50,3,46
42,Pennsylvania/PA,4202901,"Northampton (South) & Lehigh (East) Counties--Bethlehem (East) & Easton Cities PUMA, Pennsylvania/PA",42095,"Northampton County, Pennsylvania",301778,4457,305,1477,101,0.885,307,27,405,152,0,19,459,27,424,19,432,451,910,34,17,2,47,0,3,2,45,50,50,3,47
42,Pennsylvania/PA,4202902,"Northampton County (North) PUMA, Pennsylvania/PA",42095,"Northampton County, Pennsylvania",301778,4457,305,1477,101,1,460,0,0,0,29,0,460,29,0,29,0,29,489,94,0,6,0,6,0,0,0,94,6,6,0
42,Pennsylvania/PA,4203001,"Bucks County (North) PUMA, Pennsylvania/PA",42017,"Bucks County, Pennsylvania",626370,8704,607,1390,97,1,347,0,18,0,0,0,347,0,18,0,18,18,365,95,0,0,5,0,0,0,5,95,5,0,5
42,Pennsylvania/PA,4203002,"Bucks County (Central) PUMA, Pennsylvania/PA",42017,"Bucks County, Pennsylvania",626370,8704,607,1390,97,1,122,0,0,0,0,0,122,0,0,0,0,0,122,100,0,0,0,0,0,0,0,100,0,0,0
42,Pennsylvania/PA,4203003,"Bucks County (Southeast)--Levittown PUMA, Pennsylvania/PA",42017,"Bucks County, Pennsylvania",626370,8704,607,1390,97,1,68,0,0,101,25,0,169,25,0,25,0,25,194,35,52,13,0,13,0,0,0,87,13,13,0
42,Pennsylvania/PA,4203004,"Bucks County (Southwest) PUMA, Pennsylvania/PA",42017,"Bucks County, Pennsylvania",626370,8704,607,1390,97,1,174,0,40,162,13,0,336,13,40,13,40,53,389,45,42,3,10,3,0,0,10,86,14,3,10
42,Pennsylvania/PA,4203101,"Montgomery County (Northwest)--Pottstown Borough PUMA, Pennsylvania/PA",42091,"Montgomery County, Pennsylvania",821301,12084,878,1471,107,1,358,0,26,0,0,0,358,0,26,0,26,26,384,93,0,0,7,0,0,0,7,93,7,0,7
42,Pennsylvania/PA,4203102,"Montgomery County (Northeast)--Lansdale Borough PUMA, Pennsylvania/PA",42091,"Montgomery County, Pennsylvania",821301,12084,878,1471,107,1,335,0,223,103,130,112,438,130,335,242,223,465,903,37,11,27,25,14,0,12,25,49,51,14,37
42,Pennsylvania/PA,4203103,"Montgomery County (Southwest)--King of Prussia & Ardmore (East) PUMA, Pennsylvania/PA",42091,"Montgomery County, Pennsylvania",821301,12084,878,1471,107,1,102,0,8,0,0,0,102,0,8,0,8,8,110,93,0,0,7,0,0,0,7,93,7,0,7
42,Pennsylvania/PA,4203104,"Montgomery County (Central)--Norristown Borough PUMA, Pennsylvania/PA",42091,"Montgomery County, Pennsylvania",821301,12084,878,1471,107,1,315,0,12,24,0,25,339,0,37,25,12,37,376,84,6,7,3,0,0,7,3,90,10,0,10
42,Pennsylvania/PA,4203105,"Montgomery County (Southeast)--Willow Grove, Horsham & Montgomeryville PUMA, Pennsylvania/PA",42091,"Montgomery County, Pennsylvania",821301,12084,878,1471,107,1,81,0,53,0,0,0,81,0,53,0,53,53,134,60,0,0,40,0,0,0,40,60,40,0,40
42,Pennsylvania/PA,4203106,"Montgomery County (South Central) PUMA, Pennsylvania/PA",42091,"Montgomery County, Pennsylvania",821301,12084,878,1471,107,1,68,0,0,0,0,0,68,0,0,0,0,0,68,100,0,0,0,0,0,0,0,100,0,0,0
42,Pennsylvania/PA,4203201,"Philadelphia City (Far Northeast) PUMA, Pennsylvania/PA",42101,"Philadelphia County, Pennsylvania",1575522,36187,1818,2297,115,1,190,0,0,22,0,42,212,0,42,42,0,42,254,75,9,17,0,0,0,17,0,83,17,0,17
42,Pennsylvania/PA,4203202,"Philadelphia City (Near Northeast-West) PUMA, Pennsylvania/PA",42101,"Philadelphia County, Pennsylvania",1575522,36187,1818,2297,115,1,123,102,0,0,20,302,123,122,302,322,102,424,547,22,0,59,19,4,19,55,0,22,78,22,55
42,Pennsylvania/PA,4203203,"Philadelphia City (Near Northeast-East) PUMA, Pennsylvania/PA",42101,"Philadelphia County, Pennsylvania",1575522,36187,1818,2297,115,1,297,0,101,105,0,0,402,0,101,0,101,101,503,59,21,0,20,0,0,0,20,80,20,0,20
42,Pennsylvania/PA,4203204,"Philadelphia City (North) PUMA, Pennsylvania/PA",42101,"Philadelphia County, Pennsylvania",1575522,36187,1818,2297,115,1,212,0,55,0,39,177,212,39,232,216,55,271,483,44,0,45,11,8,0,37,11,44,56,8,48
42,Pennsylvania/PA,4203205,"Philadelphia City (East) PUMA, Pennsylvania/PA",42101,"Philadelphia County, Pennsylvania",1575522,36187,1818,2297,115,1,135,66,60,200,0,0,335,66,60,0,126,126,461,29,43,0,27,0,14,0,13,73,27,14,13
42,Pennsylvania/PA,4203206,"Philadelphia City (Northwest) PUMA, Pennsylvania/PA",42101,"Philadelphia County, Pennsylvania",1575522,36187,1818,2297,115,1,184,0,0,0,0,0,184,0,0,0,0,0,184,100,0,0,0,0,0,0,0,100,0,0,0
42,Pennsylvania/PA,4203207,"Philadelphia City (Central) PUMA, Pennsylvania/PA",42101,"Philadelphia County, Pennsylvania",1575522,36187,1818,2297,115,1,399,0,0,45,0,0,444,0,0,0,0,0,444,90,10,0,0,0,0,0,0,100,0,0,0
42,Pennsylvania/PA,4203208,"Philadelphia City (West) PUMA, Pennsylvania/PA",42101,"Philadelphia County, Pennsylvania",1575522,36187,1818,2297,115,1,219,0,0,0,0,0,219,0,0,0,0,0,219,100,0,0,0,0,0,0,0,100,0,0,0
42,Pennsylvania/PA,4203209,"Philadelphia City (Center City) PUMA, Pennsylvania/PA",42101,"Philadelphia County, Pennsylvania",1575522,36187,1818,2297,115,1,53,0,0,62,0,0,115,0,0,0,0,0,115,46,54,0,0,0,0,0,0,100,0,0,0
42,Pennsylvania/PA,4203210,"Philadelphia City (Southwest) PUMA, Pennsylvania/PA",42101,"Philadelphia County, Pennsylvania",1575522,36187,1818,2297,115,1,124,0,0,0,124,50,124,124,50,174,0,174,298,42,0,58,0,42,0,17,0,42,58,42,17
42,Pennsylvania/PA,4203211,"Philadelphia City (Southeast) PUMA, Pennsylvania/PA",42101,"Philadelphia County, Pennsylvania",1575522,36187,1818,2297,115,1,88,0,100,596,74,33,684,74,133,107,100,207,891,10,67,12,11,8,0,4,11,77,23,8,15
42,Pennsylvania/PA,4203301,"Delaware County (North)--Broomall & Ardmore (West) PUMA, Pennsylvania/PA",42045,"Delaware County, Pennsylvania",563527,11348,793,2014,141,1,72,0,4,0,0,0,72,0,4,0,4,4,76,95,0,0,5,0,0,0,5,95,5,0,5
42,Pennsylvania/PA,4203302,"Delaware County (East)--Yeadon, Darby, Lansdowne Boroughs & Drexel Hill PUMA, Pennsylvania/PA",42045,"Delaware County, Pennsylvania",563527,11348,793,2014,141,1,72,0,24,52,34,112,124,34,136,146,24,170,294,24,18,50,8,12,0,38,8,42,58,12,46
42,Pennsylvania/PA,4203303,"Delaware County (Southeast)--Chester City PUMA, Pennsylvania/PA",42045,"Delaware County, Pennsylvania",563527,11348,793,2014,141,1,282,26,62,16,0,0,298,26,62,0,88,88,386,73,4,0,23,0,7,0,16,77,23,7,16
42,Pennsylvania/PA,4203304,"Delaware County (West) PUMA, Pennsylvania/PA",42045,"Delaware County, Pennsylvania",563527,11348,793,2014,141,1,134,0,26,0,0,0,134,0,26,0,26,26,160,84,0,0,16,0,0,0,16,84,16,0,16
42,Pennsylvania/PA,4203401,"Chester County (North)--Phoenixville Borough PUMA, Pennsylvania/PA",42029,"Chester County, Pennsylvania",517156,6777,367,1310,71,1,194,0,128,0,0,0,194,0,128,0,128,128,322,60,0,0,40,0,0,0,40,60,40,0,40
42,Pennsylvania/PA,4203402,"Chester County (East Central)--West Chester Borough PUMA, Pennsylvania/PA",42029,"Chester County, Pennsylvania",517156,6777,367,1310,71,1,261,0,193,0,0,29,261,0,222,29,193,222,483,54,0,6,40,0,0,6,40,54,46,0,46
42,Pennsylvania/PA,4203403,"Chester County (West Central)--Coatesville City PUMA, Pennsylvania/PA",42029,"Chester County, Pennsylvania",517156,6777,367,1310,71,1,149,0,184,0,26,0,149,26,184,26,184,210,359,42,0,7,51,7,0,0,51,42,58,7,51
42,Pennsylvania/PA,4203404,"Chester County (South) PUMA, Pennsylvania/PA",42029,"Chester County, Pennsylvania",517156,6777,367,1310,71,1,913,208,2606,160,12,15,1073,220,2621,27,2814,2841,3914,23,4,1,72,0,5,0,67,27,73,6,67
42,Pennsylvania/PA,4203501,"Lancaster County--Lancaster City, East Lampeter, Lancaster & West Lampeter Townships PUMA, Pennsylvania/PA",42071,"Lancaster County, Pennsylvania",538347,7770,458,1443,85,1,548,82,66,394,21,225,942,103,291,246,148,394,1336,41,29,18,11,2,6,17,5,71,29,8,22
42,Pennsylvania/PA,4203502,"Lancaster County (Northwest)--Elizabethtown Borough PUMA, Pennsylvania/PA",42071,"Lancaster County, Pennsylvania",538347,7770,458,1443,85,1,922,0,83,26,0,3,948,0,86,3,83,86,1034,89,3,0,8,0,0,0,8,92,8,0,8
42,Pennsylvania/PA,4203503,"Lancaster County (East)--Ephrata Borough PUMA, Pennsylvania/PA",42071,"Lancaster County, Pennsylvania",538347,7770,458,1443,85,1,2581,0,27,133,76,47,2714,76,74,123,27,150,2864,90,5,4,1,3,0,2,1,95,5,3,3
42,Pennsylvania/PA,4203504,"Lancaster County (Southwest)--Columbia Borough PUMA, Pennsylvania/PA",42071,"Lancaster County, Pennsylvania",538347,7770,458,1443,85,1,928,0,92,30,138,0,958,138,92,138,92,230,1188,78,3,12,8,12,0,0,8,81,19,12,8
42,Pennsylvania/PA,4203601,"York County (Central)--York City & Shiloh PUMA, Pennsylvania/PA",42133,"York County, Pennsylvania",444014,4752,153,1070,34,1,430,0,172,51,0,0,481,0,172,0,172,172,653,66,8,0,26,0,0,0,26,74,26,0,26
42,Pennsylvania/PA,4203602,"York County (North)--Weigelstown PUMA, Pennsylvania/PA",42133,"York County, Pennsylvania",444014,4752,153,1070,34,1,630,0,3,0,0,0,630,0,3,0,3,3,633,100,0,0,0,0,0,0,0,100,0,0,0
42,Pennsylvania/PA,4203603,"York County (South) PUMA, Pennsylvania/PA",42133,"York County, Pennsylvania",444014,4752,153,1070,34,1,1113,0,29,0,14,0,1113,14,29,14,29,43,1156,96,0,1,3,1,0,0,3,96,4,1,3
42,Pennsylvania/PA,4203701,"Adams & Franklin (Southeast) Counties PUMA, Pennsylvania/PA",42001,"Adams County, Pennsylvania",102023,822,26,806,25,0.802,1260,148,466,79,0,4,1339,148,470,4,614,618,1957,64,4,0,31,0,8,0,24,68,32,8,24
42,Pennsylvania/PA,4203701,"Adams & Franklin (Southeast) Counties PUMA, Pennsylvania/PA",42055,"Franklin County, Pennsylvania",153751,1757,50,1143,33,0.198,311,37,115,20,0,1,331,37,116,1,152,153,484,64,4,0,31,0,8,0,24,68,32,8,24
42,Pennsylvania/PA,4203702,"Franklin County (Outside Washington Township & Waynesboro Borough) PUMA, Pennsylvania/PA",42055,"Franklin County, Pennsylvania",153751,1757,50,1143,33,1,1519,0,179,27,0,0,1546,0,179,0,179,179,1725,88,2,0,10,0,0,0,10,90,10,0,10
42,Pennsylvania/PA,4203800,"Somerset, Bedford & Fulton Counties PUMA, Pennsylvania/PA",42009,"Bedford County, Pennsylvania",48611,238,6,490,12,0.35,380,0,12,0,33,0,380,33,12,33,12,45,425,89,0,8,3,8,0,0,3,89,11,8,3
42,Pennsylvania/PA,4203800,"Somerset, Bedford & Fulton Counties PUMA, Pennsylvania/PA",42057,"Fulton County, Pennsylvania",14506,47,2,324,14,0.106,115,0,4,0,10,0,115,10,4,10,4,14,129,89,0,8,3,8,0,0,3,89,11,8,3
42,Pennsylvania/PA,4203800,"Somerset, Bedford & Fulton Counties PUMA, Pennsylvania/PA",42111,"Somerset County, Pennsylvania",74949,212,3,283,4,0.544,591,0,18,0,51,0,591,51,18,51,18,69,660,90,0,8,3,8,0,0,3,90,10,8,3
42,Pennsylvania/PA,4203900,"Fayette County PUMA, Pennsylvania/PA",42051,"Fayette County, Pennsylvania",132289,788,7,596,5,1,138,0,0,0,0,0,138,0,0,0,0,0,138,100,0,0,0,0,0,0,0,100,0,0,0
42,Pennsylvania/PA,4204001,"Washington County (North)--Washington City PUMA, Pennsylvania/PA",42125,"Washington County, Pennsylvania",207547,1320,29,636,14,1,344,0,12,0,0,0,344,0,12,0,12,12,356,97,0,0,3,0,0,0,3,97,3,0,3
42,Pennsylvania/PA,4204002,"Washington (South) & Greene Counties PUMA, Pennsylvania/PA",42059,"Greene County, Pennsylvania",37144,183,1,493,3,0.364,29,0,0,0,0,0,29,0,0,0,0,0,29,100,0,0,0,0,0,0,0,100,0,0,0
42,Pennsylvania/PA,4204002,"Washington (South) & Greene Counties PUMA, Pennsylvania/PA",42125,"Washington County, Pennsylvania",207547,1320,29,636,14,0.636,50,0,0,0,0,0,50,0,0,0,0,0,50,100,0,0,0,0,0,0,0,100,0,0,0
44,Rhode Island/RI,4400101,"Northwest Rhode Island--Providence County (West & Central)--Woonsocket City PUMA, Rhode Island/RI",44007,"Providence County, Rhode Island",634533,18437,882,2906,139,1,365,31,0,0,0,21,365,31,21,21,31,52,417,88,0,5,7,0,7,5,0,88,12,7,5
44,Rhode Island/RI,4400102,"Northeast Rhode Island--Providence County--Pawtucket & Central Falls Cities PUMA, Rhode Island/RI",44007,"Providence County, Rhode Island",634533,18437,882,2906,139,1,178,11,141,55,0,34,233,11,175,34,152,186,419,42,13,8,36,0,3,8,34,56,44,3,42
44,Rhode Island/RI,4400103,"Providence City PUMA, Rhode Island/RI",44007,"Providence County, Rhode Island",634533,18437,882,2906,139,1,83,66,297,72,124,15,155,190,312,139,363,502,657,13,11,21,55,19,10,2,45,24,76,29,47
44,Rhode Island/RI,4400104,"Providence County (Southeast)--Cranston & East Providence Cities PUMA, Rhode Island/RI",44007,"Providence County, Rhode Island",634533,18437,882,2906,139,1,135,0,38,0,11,32,135,11,70,43,38,81,216,62,0,20,18,5,0,15,18,62,38,5,32
44,Rhode Island/RI,4400201,"Central Rhode Island--Kent County--Warwick City PUMA, Rhode Island/RI",44003,"Kent County, Rhode Island",163861,1867,110,1139,67,1,42,9,12,0,0,18,42,9,30,18,21,39,81,52,0,22,26,0,11,22,15,52,48,11,37
44,Rhode Island/RI,4400300,"Southeast Rhode Island--Newport & Bristol Counties--Newport City PUMA, Rhode Island/RI",44001,"Bristol County, Rhode Island",48900,404,16,826,33,0.372,78,0,0,0,10,0,78,10,0,10,0,10,88,89,0,11,0,11,0,0,0,89,11,11,0
44,Rhode Island/RI,4400300,"Southeast Rhode Island--Newport & Bristol Counties--Newport City PUMA, Rhode Island/RI",44005,"Newport County, Rhode Island",83075,518,8,624,10,0.628,133,0,0,0,18,0,133,18,0,18,0,18,151,88,0,12,0,12,0,0,0,88,12,12,0
44,Rhode Island/RI,4400400,"South Rhode Island--Washington County PUMA, Rhode Island/RI",44009,"Washington County, Rhode Island",126242,803,71,636,56,1,77,0,0,0,0,20,77,0,20,20,0,20,97,79,0,21,0,0,0,21,0,79,21,0,21
45,South Carolina/SC,4500101,"Pickens & Oconee Counties--Easley & Clemson Cities PUMA, South Carolina/SC",45073,"Oconee County, South Carolina",76696,1387,26,1808,34,0.383,137,0,85,6,0,0,143,0,85,0,85,85,228,60,3,0,37,0,0,0,37,63,37,0,37
45,South Carolina/SC,4500101,"Pickens & Oconee Counties--Easley & Clemson Cities PUMA, South Carolina/SC",45077,"Pickens County, South Carolina",122746,2848,45,2320,37,0.617,222,0,136,10,0,0,232,0,136,0,136,136,368,60,3,0,37,0,0,0,37,63,37,0,37
45,South Carolina/SC,4500102,"Greenville County (North)--Greer City (North & West) & Taylors (Central & East) PUMA, South Carolina/SC",45045,"Greenville County, South Carolina",498402,14203,300,2850,60,1,128,27,66,0,0,0,128,27,66,0,93,93,221,58,0,0,42,0,12,0,30,58,42,12,30
45,South Carolina/SC,4500103,"Greenville County (North Central & Outside Greenville City)--Wade Hampton & Berea PUMA, South Carolina/SC",45045,"Greenville County, South Carolina",498402,14203,300,2850,60,1,283,23,175,0,21,10,283,44,185,31,198,229,512,55,0,6,39,4,4,2,34,55,45,9,36
45,South Carolina/SC,4500104,"Greenville County (Central)--Greenville & Mauldin Cities PUMA, South Carolina/SC",45045,"Greenville County, South Carolina",498402,14203,300,2850,60,1,156,0,6,0,0,0,156,0,6,0,6,6,162,96,0,0,4,0,0,0,4,96,4,0,4
45,South Carolina/SC,4500105,"Greenville (South) & Laurens Counties--Simpsonville, Laurens & Clinton Cities PUMA, South Carolina/SC",45045,"Greenville County, South Carolina",498402,14203,300,2850,60,0.586,161,0,39,0,0,0,161,0,39,0,39,39,200,80,0,0,20,0,0,0,20,80,20,0,20
45,South Carolina/SC,4500105,"Greenville (South) & Laurens Counties--Simpsonville, Laurens & Clinton Cities PUMA, South Carolina/SC",45059,"Laurens County, South Carolina",66710,1642,56,2461,84,0.414,114,0,27,0,0,0,114,0,27,0,27,27,141,81,0,0,19,0,0,0,19,81,19,0,19
45,South Carolina/SC,4500200,"Anderson County--Anderson City PUMA, South Carolina/SC",45007,"Anderson County, South Carolina",195995,4332,173,2210,88,1,461,0,2,0,0,0,461,0,2,0,2,2,463,100,0,0,0,0,0,0,0,100,0,0,0
45,South Carolina/SC,4500301,"Spartanburg County (Central)--Spartanburg City PUMA, South Carolina/SC",45083,"Spartanburg County, South Carolina",302195,6693,197,2215,65,1,333,0,6,26,15,17,359,15,23,32,6,38,397,84,7,8,2,4,0,4,2,90,10,4,6
45,South Carolina/SC,4500302,"Spartanburg County (Outside Spartanburg City)--Greer City (East) PUMA, South Carolina/SC",45083,"Spartanburg County, South Carolina",302195,6693,197,2215,65,1,240,82,23,5,0,0,245,82,23,0,105,105,350,69,1,0,30,0,23,0,7,70,30,23,7
45,South Carolina/SC,4500400,"Cherokee, Newberry, Chester & Union Counties PUMA, South Carolina/SC",45021,"Cherokee County, South Carolina",56711,1143,35,2015,62,0.366,384,16,58,4,0,0,388,16,58,0,74,74,462,83,1,0,16,0,3,0,13,84,16,3,13
45,South Carolina/SC,4500400,"Cherokee, Newberry, Chester & Union Counties PUMA, South Carolina/SC",45023,"Chester County, South Carolina",32326,1033,21,3196,65,0.208,218,9,33,2,0,0,220,9,33,0,42,42,262,83,1,0,16,0,3,0,13,84,16,3,13
45,South Carolina/SC,4500400,"Cherokee, Newberry, Chester & Union Counties PUMA, South Carolina/SC",45071,"Newberry County, South Carolina",38068,1230,24,3231,63,0.246,258,11,39,2,0,0,260,11,39,0,50,50,310,83,1,0,16,0,4,0,13,84,16,4,13
45,South Carolina/SC,4500400,"Cherokee, Newberry, Chester & Union Counties PUMA, South Carolina/SC",45087,"Union County, South Carolina",27644,562,12,2033,43,0.179,188,8,28,2,0,0,190,8,28,0,36,36,226,83,1,0,16,0,4,0,12,84,16,4,12
45,South Carolina/SC,4500501,"York County (West & Outside Rock Hill City) PUMA, South Carolina/SC",45091,"York County, South Carolina",258641,5270,70,2038,27,1,341,0,6,0,0,0,341,0,6,0,6,6,347,98,0,0,2,0,0,0,2,98,2,0,2
45,South Carolina/SC,4500502,"York County (East)--Rock Hill City & Fort Mill Town PUMA, South Carolina/SC",45091,"York County, South Carolina",258641,5270,70,2038,27,1,268,0,77,0,0,0,268,0,77,0,77,77,345,78,0,0,22,0,0,0,22,78,22,0,22
45,South Carolina/SC,4500601,"Lexington (South & West) & Saluda Counties--Lexington Town & Red Bank PUMA, South Carolina/SC",45063,"Lexington County, South Carolina",286316,7106,157,2482,55,0.885,659,77,487,76,9,35,735,86,522,44,564,608,1343,49,6,3,42,1,6,3,36,55,45,6,39
45,South Carolina/SC,4500601,"Lexington (South & West) & Saluda Counties--Lexington Town & Red Bank PUMA, South Carolina/SC",45081,"Saluda County, South Carolina",20299,689,21,3394,103,0.115,86,10,63,10,1,5,96,11,68,6,73,79,175,49,6,3,42,1,6,3,36,55,45,6,39
45,South Carolina/SC,4500602,"Lexington County (North & East)--West Columbia, Cayce Cities, Irmo Town & Seven Oaks PUMA, South Carolina/SC",45063,"Lexington County, South Carolina",286316,7106,157,2482,55,1,267,0,39,4,0,53,271,0,92,53,39,92,363,74,1,15,11,0,0,15,11,75,25,0,25
45,South Carolina/SC,4500603,"Richland (North) & Fairfield Counties--Forest Acres City & Dentsville PUMA, South Carolina/SC",45039,"Fairfield County, South Carolina",22712,761,34,3351,150,0.123,56,0,0,0,0,3,56,0,3,3,0,3,59,95,0,5,0,0,0,5,0,95,5,0,5
45,South Carolina/SC,4500603,"Richland (North) & Fairfield Counties--Forest Acres City & Dentsville PUMA, South Carolina/SC",45079,"Richland County, South Carolina",408263,15014,235,3678,58,0.877,402,0,1,0,0,18,402,0,19,18,1,19,421,95,0,4,0,0,0,4,0,95,5,0,5
45,South Carolina/SC,4500604,"Richland County (Central)--Columbia City PUMA, South Carolina/SC",45079,"Richland County, South Carolina",408263,15014,235,3678,58,1,470,0,31,0,19,28,470,19,59,47,31,78,548,86,0,9,6,3,0,5,6,86,14,3,11
45,South Carolina/SC,4500605,"Kershaw, Richland (South) & Calhoun Counties PUMA, South Carolina/SC",45017,"Calhoun County, South Carolina",14713,447,17,3038,116,0.134,53,0,9,0,0,0,53,0,9,0,9,9,62,85,0,0,15,0,0,0,15,85,15,0,15
45,South Carolina/SC,4500605,"Kershaw, Richland (South) & Calhoun Counties PUMA, South Carolina/SC",45055,"Kershaw County, South Carolina",64361,1951,37,3031,57,0.581,232,0,37,0,0,0,232,0,37,0,37,37,269,86,0,0,14,0,0,0,14,86,14,0,14
45,South Carolina/SC,4500605,"Kershaw, Richland (South) & Calhoun Counties PUMA, South Carolina/SC",45079,"Richland County, South Carolina",408263,15014,235,3678,58,0.285,114,0,18,0,0,0,114,0,18,0,18,18,132,86,0,0,14,0,0,0,14,86,14,0,14
45,South Carolina/SC,4500700,"Lancaster, Chesterfield & Marlboro Counties PUMA, South Carolina/SC",45025,"Chesterfield County, South Carolina",46024,1215,36,2640,78,0.283,294,0,76,0,0,0,294,0,76,0,76,76,370,79,0,0,21,0,0,0,21,79,21,0,21
45,South Carolina/SC,4500700,"Lancaster, Chesterfield & Marlboro Counties PUMA, South Carolina/SC",45057,"Lancaster County, South Carolina",89546,2134,52,2383,58,0.551,573,0,147,0,0,0,573,0,147,0,147,147,720,80,0,0,20,0,0,0,20,80,20,0,20
45,South Carolina/SC,4500700,"Lancaster, Chesterfield & Marlboro Counties PUMA, South Carolina/SC",45069,"Marlboro County, South Carolina",27131,906,11,3339,41,0.166,173,0,44,0,0,0,173,0,44,0,44,44,217,80,0,0,20,0,0,0,20,80,20,0,20
45,South Carolina/SC,4500800,"Sumter, Clarendon, Williamsburg & Lee Counties--Sumter City PUMA, South Carolina/SC",45027,"Clarendon County, South Carolina",34017,1092,66,3210,194,0.178,333,7,36,0,0,0,333,7,36,0,43,43,376,89,0,0,11,0,2,0,10,89,11,2,10
45,South Carolina/SC,4500800,"Sumter, Clarendon, Williamsburg & Lee Counties--Sumter City PUMA, South Carolina/SC",45061,"Lee County, South Carolina",17606,713,34,4050,193,0.092,172,3,19,0,0,0,172,3,19,0,22,22,194,89,0,0,11,0,2,0,10,89,11,2,10
45,South Carolina/SC,4500800,"Sumter, Clarendon, Williamsburg & Lee Counties--Sumter City PUMA, South Carolina/SC",45085,"Sumter County, South Carolina",106995,3192,77,2983,72,0.562,1052,21,115,0,0,0,1052,21,115,0,136,136,1188,89,0,0,11,0,2,0,10,89,11,2,10
45,South Carolina/SC,4500800,"Sumter, Clarendon, Williamsburg & Lee Counties--Sumter City PUMA, South Carolina/SC",45089,"Williamsburg County, South Carolina",31794,1326,44,4171,138,0.167,313,6,34,0,0,0,313,6,34,0,40,40,353,89,0,0,11,0,2,0,10,89,11,2,10
45,South Carolina/SC,4500900,"Florence & Darlington Counties--Florence City PUMA, South Carolina/SC",45031,"Darlington County, South Carolina",67253,2035,52,3026,77,0.326,262,10,25,0,0,13,262,10,38,13,35,48,310,85,0,4,11,0,3,4,8,85,15,3,12
45,South Carolina/SC,4500900,"Florence & Darlington Counties--Florence City PUMA, South Carolina/SC",45041,"Florence County, South Carolina",138561,4890,188,3529,136,0.674,541,20,51,0,0,27,541,20,78,27,71,98,639,85,0,4,11,0,3,4,8,85,15,3,12
45,South Carolina/SC,4501000,"Georgetown, Marion & Dillon Counties PUMA, South Carolina/SC",45033,"Dillon County, South Carolina",30871,1016,37,3291,120,0.249,358,0,5,0,0,0,358,0,5,0,5,5,363,99,0,0,1,0,0,0,1,99,1,0,1
45,South Carolina/SC,4501000,"Georgetown, Marion & Dillon Counties PUMA, South Carolina/SC",45043,"Georgetown County, South Carolina",61605,1885,45,3060,73,0.495,712,0,10,0,0,0,712,0,10,0,10,10,722,99,0,0,1,0,0,0,1,99,1,0,1
45,South Carolina/SC,4501000,"Georgetown, Marion & Dillon Counties PUMA, South Carolina/SC",45067,"Marion County, South Carolina",31562,860,24,2725,76,0.256,368,0,5,0,0,0,368,0,5,0,5,5,373,99,0,0,1,0,0,0,1,99,1,0,1
45,South Carolina/SC,4501101,"Horry County (West & North)--Conway City & Red Hill PUMA, South Carolina/SC",45051,"Horry County, South Carolina",320915,10292,196,3207,61,1,121,8,50,0,0,0,121,8,50,0,58,58,179,68,0,0,32,0,4,0,28,68,32,4,28
45,South Carolina/SC,4501102,"Horry County (Southeast)--Myrtle Beach, North Myrtle Beach Cities & Socastee (East) PUMA, South Carolina/SC",45051,"Horry County, South Carolina",320915,10292,196,3207,61,1,298,0,15,0,0,0,298,0,15,0,15,15,313,95,0,0,5,0,0,0,5,95,5,0,5
45,South Carolina/SC,4501201,"Dorchester (North & West) & Berkeley (Southwest) Counties--Summerville Town & Ladson PUMA, South Carolina/SC",45015,"Berkeley County, South Carolina",209065,5439,88,2602,42,0.277,72,0,1,0,0,0,72,0,1,0,1,1,73,99,0,0,1,0,0,0,1,99,1,0,1
45,South Carolina/SC,4501201,"Dorchester (North & West) & Berkeley (Southwest) Counties--Summerville Town & Ladson PUMA, South Carolina/SC",45019,"Charleston County, South Carolina",394708,15728,260,3985,66,0.042,11,0,0,0,0,0,11,0,0,0,0,0,11,100,0,0,0,0,0,0,0,100,0,0,0
45,South Carolina/SC,4501201,"Dorchester (North & West) & Berkeley (Southwest) Counties--Summerville Town & Ladson PUMA, South Carolina/SC",45035,"Dorchester County, South Carolina",155474,4112,89,2645,57,0.682,178,0,3,0,0,0,178,0,3,0,3,3,181,98,0,0,2,0,0,0,2,98,2,0,2
45,South Carolina/SC,4501202,"Charleston (South & West) & Berkeley (South) Counties--Charleston City PUMA, South Carolina/SC",45015,"Berkeley County, South Carolina",209065,5439,88,2602,42,0.07,9,0,3,0,0,1,9,0,4,1,3,4,13,69,0,8,23,0,0,8,23,69,31,0,31
45,South Carolina/SC,4501202,"Charleston (South & West) & Berkeley (South) Counties--Charleston City PUMA, South Carolina/SC",45019,"Charleston County, South Carolina",394708,15728,260,3985,66,0.93,125,0,45,0,0,7,125,0,52,7,45,52,177,71,0,4,25,0,0,4,25,71,29,0,29
45,South Carolina/SC,4501203,"Charleston (Northeast) & Berkeley (North & East) Counties--Mount Pleasant Town PUMA, South Carolina/SC",45015,"Berkeley County, South Carolina",209065,5439,88,2602,42,0.4,42,0,14,0,0,0,42,0,14,0,14,14,56,75,0,0,25,0,0,0,25,75,25,0,25
45,South Carolina/SC,4501203,"Charleston (Northeast) & Berkeley (North & East) Counties--Mount Pleasant Town PUMA, South Carolina/SC",45019,"Charleston County, South Carolina",394708,15728,260,3985,66,0.6,64,0,22,0,0,0,64,0,22,0,22,22,86,74,0,0,26,0,0,0,26,74,26,0,26
45,South Carolina/SC,4501204,"Charleston, Berkeley & Dorchester Counties--North Charleston City PUMA, South Carolina/SC",45015,"Berkeley County, South Carolina",209065,5439,88,2602,42,0.393,77,0,11,0,0,0,77,0,11,0,11,11,88,88,0,0,12,0,0,0,12,88,12,0,12
45,South Carolina/SC,4501204,"Charleston, Berkeley & Dorchester Counties--North Charleston City PUMA, South Carolina/SC",45019,"Charleston County, South Carolina",394708,15728,260,3985,66,0.411,80,0,11,0,0,0,80,0,11,0,11,11,91,88,0,0,12,0,0,0,12,88,12,0,12
45,South Carolina/SC,4501204,"Charleston, Berkeley & Dorchester Counties--North Charleston City PUMA, South Carolina/SC",45035,"Dorchester County, South Carolina",155474,4112,89,2645,57,0.195,38,0,5,0,0,0,38,0,5,0,5,5,43,88,0,0,12,0,0,0,12,88,12,0,12
45,South Carolina/SC,4501300,"Orangeburg, Colleton, Barnwell, Hampton, Bamberg & Allendale Counties PUMA, South Carolina/SC",45005,"Allendale County, South Carolina",9214,381,6,4135,65,0.047,48,0,6,1,2,0,49,2,6,2,6,8,57,84,2,4,11,4,0,0,11,86,14,4,11
45,South Carolina/SC,4501300,"Orangeburg, Colleton, Barnwell, Hampton, Bamberg & Allendale Counties PUMA, South Carolina/SC",45009,"Bamberg County, South Carolina",14600,640,33,4384,226,0.076,78,0,10,2,3,0,80,3,10,3,10,13,93,84,2,3,11,3,0,0,11,86,14,3,11
45,South Carolina/SC,4501300,"Orangeburg, Colleton, Barnwell, Hampton, Bamberg & Allendale Counties PUMA, South Carolina/SC",45011,"Barnwell County, South Carolina",21577,695,16,3221,74,0.113,115,0,14,2,4,0,117,4,14,4,14,18,135,85,1,3,10,3,0,0,10,87,13,3,10
45,South Carolina/SC,4501300,"Orangeburg, Colleton, Barnwell, Hampton, Bamberg & Allendale Counties PUMA, South Carolina/SC",45029,"Colleton County, South Carolina",37568,1013,42,2696,112,0.199,203,0,25,4,7,0,207,7,25,7,25,32,239,85,2,3,10,3,0,0,10,87,13,3,10
45,South Carolina/SC,4501300,"Orangeburg, Colleton, Barnwell, Hampton, Bamberg & Allendale Counties PUMA, South Carolina/SC",45049,"Hampton County, South Carolina",19807,637,25,3216,126,0.104,106,0,13,2,4,0,108,4,13,4,13,17,125,85,2,3,10,3,0,0,10,86,14,3,10
45,South Carolina/SC,4501300,"Orangeburg, Colleton, Barnwell, Hampton, Bamberg & Allendale Counties PUMA, South Carolina/SC",45075,"Orangeburg County, South Carolina",88454,3092,126,3496,142,0.461,470,0,59,9,17,0,479,17,59,17,59,76,555,85,2,3,11,3,0,0,11,86,14,3,11
45,South Carolina/SC,4501400,"Beaufort & Jasper Counties--Hilton Head Island, Bluffton Towns & Beaufort City PUMA, South Carolina/SC",45013,"Beaufort County, South Carolina",182658,5598,82,3065,45,0.865,266,119,217,0,10,0,266,129,217,10,336,346,612,43,0,2,55,2,19,0,35,43,57,21,35
45,South Carolina/SC,4501400,"Beaufort & Jasper Counties--Hilton Head Island, Bluffton Towns & Beaufort City PUMA, South Carolina/SC",45053,"Jasper County, South Carolina",27900,806,20,2889,72,0.135,41,18,34,0,2,0,41,20,34,2,52,54,95,43,0,2,55,2,19,0,36,43,57,21,36
45,South Carolina/SC,4501500,"Aiken & Edgefield Counties--Aiken & North Augusta Cities PUMA, South Carolina/SC",45003,"Aiken County, South Carolina",166926,4092,81,2451,49,0.864,648,92,327,16,25,60,664,117,387,85,419,504,1168,55,1,7,36,2,8,5,28,57,43,10,33
45,South Carolina/SC,4501500,"Aiken & Edgefield Counties--Aiken & North Augusta Cities PUMA, South Carolina/SC",45037,"Edgefield County, South Carolina",26769,806,17,3011,64,0.136,102,15,51,2,4,9,104,19,60,13,66,79,183,56,1,7,36,2,8,5,28,57,43,10,33
45,South Carolina/SC,4501600,"Greenwood, Abbeville & McCormick Counties PUMA, South Carolina/SC",45001,"Abbeville County, South Carolina",24657,569,12,2308,49,0.238,130,0,30,0,0,0,130,0,30,0,30,30,160,81,0,0,19,0,0,0,19,81,19,0,19
45,South Carolina/SC,4501600,"Greenwood, Abbeville & McCormick Counties PUMA, South Carolina/SC",45047,"Greenwood County, South Carolina",70264,2196,72,3125,102,0.67,365,0,83,0,1,0,365,1,83,1,83,84,449,81,0,0,18,0,0,0,18,81,19,0,18
45,South Carolina/SC,4501600,"Greenwood, Abbeville & McCormick Counties PUMA, South Carolina/SC",45065,"McCormick County, South Carolina",9606,231,6,2405,62,0.092,50,0,11,0,0,0,50,0,11,0,11,11,61,82,0,0,18,0,0,0,18,82,18,0,18
46,South Dakota/SD,4600100,"West South Dakota--Rapid City PUMA, South Dakota/SD",46019,"Butte County, South Dakota",10177,91,3,894,29,0.055,62,0,1,6,0,0,68,0,1,0,1,1,69,90,9,0,1,0,0,0,1,99,1,0,1
46,South Dakota/SD,4600100,"West South Dakota--Rapid City PUMA, South Dakota/SD",46033,"Custer County, South Dakota",8573,181,2,2111,23,0.046,51,0,1,5,0,0,56,0,1,0,1,1,57,89,9,0,2,0,0,0,2,98,2,0,2
46,South Dakota/SD,4600100,"West South Dakota--Rapid City PUMA, South Dakota/SD",46063,"Harding County, South Dakota",1311,5,0,381,0,0.007,8,0,0,1,0,0,9,0,0,0,0,0,9,89,11,0,0,0,0,0,0,100,0,0,0
46,South Dakota/SD,4600100,"West South Dakota--Rapid City PUMA, South Dakota/SD",46081,"Lawrence County, South Dakota",25234,380,4,1506,16,0.136,152,0,3,14,0,0,166,0,3,0,3,3,169,90,8,0,2,0,0,0,2,98,2,0,2
46,South Dakota/SD,4600100,"West South Dakota--Rapid City PUMA, South Dakota/SD",46093,"Meade County, South Dakota",27424,509,5,1856,18,0.149,167,0,3,15,0,0,182,0,3,0,3,3,185,90,8,0,2,0,0,0,2,98,2,0,2
46,South Dakota/SD,4600100,"West South Dakota--Rapid City PUMA, South Dakota/SD",46103,"Pennington County, South Dakota",109294,2198,36,2011,33,0.59,660,0,12,60,0,0,720,0,12,0,12,12,732,90,8,0,2,0,0,0,2,98,2,0,2
46,South Dakota/SD,4600100,"West South Dakota--Rapid City PUMA, South Dakota/SD",46105,"Perkins County, South Dakota",2907,37,0,1273,0,0.016,18,0,0,2,0,0,20,0,0,0,0,0,20,90,10,0,0,0,0,0,0,100,0,0,0
46,South Dakota/SD,4600200,"Lakota Region PUMA, South Dakota/SD",46007,"Bennett County, South Dakota",3437,63,1,1833,29,0.033,66,0,0,1,0,0,67,0,0,0,0,0,67,99,1,0,0,0,0,0,0,100,0,0,0
46,South Dakota/SD,4600200,"Lakota Region PUMA, South Dakota/SD",46017,"Buffalo County, South Dakota",2053,135,3,6576,146,0.02,40,0,0,1,0,0,41,0,0,0,0,0,41,98,2,0,0,0,0,0,0,100,0,0,0
46,South Dakota/SD,4600200,"Lakota Region PUMA, South Dakota/SD",46023,"Charles Mix County, South Dakota",9344,160,0,1712,0,0.09,180,0,0,4,0,0,184,0,0,0,0,0,184,98,2,0,0,0,0,0,0,100,0,0,0
46,South Dakota/SD,4600200,"Lakota Region PUMA, South Dakota/SD",46031,"Corson County, South Dakota",4168,91,1,2183,24,0.04,80,0,0,2,0,0,82,0,0,0,0,0,82,98,2,0,0,0,0,0,0,100,0,0,0
46,South Dakota/SD,4600200,"Lakota Region PUMA, South Dakota/SD",46041,"Dewey County, South Dakota",5779,143,0,2474,0,0.055,110,0,0,2,0,0,112,0,0,0,0,0,112,98,2,0,0,0,0,0,0,100,0,0,0
46,South Dakota/SD,4600200,"Lakota Region PUMA, South Dakota/SD",46047,"Fall River County, South Dakota",6774,92,3,1358,44,0.066,132,0,0,3,0,0,135,0,0,0,0,0,135,98,2,0,0,0,0,0,0,100,0,0,0
46,South Dakota/SD,4600200,"Lakota Region PUMA, South Dakota/SD",46053,"Gregory County, South Dakota",4201,118,3,2809,71,0.04,80,0,0,2,0,0,82,0,0,0,0,0,82,98,2,0,0,0,0,0,0,100,0,0,0
46,South Dakota/SD,4600200,"Lakota Region PUMA, South Dakota/SD",46055,"Haakon County, South Dakota",2082,22,0,1057,0,0.018,36,0,0,1,0,0,37,0,0,0,0,0,37,97,3,0,0,0,0,0,0,100,0,0,0
46,South Dakota/SD,4600200,"Lakota Region PUMA, South Dakota/SD",46065,"Hughes County, South Dakota",17617,384,5,2180,28,0.169,337,0,0,7,0,0,344,0,0,0,0,0,344,98,2,0,0,0,0,0,0,100,0,0,0
46,South Dakota/SD,4600200,"Lakota Region PUMA, South Dakota/SD",46069,"Hyde County, South Dakota",1331,19,0,1427,0,0.013,26,0,0,1,0,0,27,0,0,0,0,0,27,96,4,0,0,0,0,0,0,100,0,0,0
46,South Dakota/SD,4600200,"Lakota Region PUMA, South Dakota/SD",46071,"Jackson County, South Dakota",3287,32,1,974,30,0.032,64,0,0,1,0,0,65,0,0,0,0,0,65,98,2,0,0,0,0,0,0,100,0,0,0
46,South Dakota/SD,4600200,"Lakota Region PUMA, South Dakota/SD",46075,"Jones County, South Dakota",735,10,0,1361,0,0.009,18,0,0,0,0,0,18,0,0,0,0,0,18,100,0,0,0,0,0,0,0,100,0,0,0
46,South Dakota/SD,4600200,"Lakota Region PUMA, South Dakota/SD",46085,"Lyman County, South Dakota",3869,146,3,3774,78,0.037,74,0,0,2,0,0,76,0,0,0,0,0,76,97,3,0,0,0,0,0,0,100,0,0,0
46,South Dakota/SD,4600200,"Lakota Region PUMA, South Dakota/SD",46095,"Mellette County, South Dakota",2055,30,0,1460,0,0.02,40,0,0,1,0,0,41,0,0,0,0,0,41,98,2,0,0,0,0,0,0,100,0,0,0
46,South Dakota/SD,4600200,"Lakota Region PUMA, South Dakota/SD",46117,"Stanley County, South Dakota",2997,40,0,1335,0,0.029,58,0,0,1,0,0,59,0,0,0,0,0,59,98,2,0,0,0,0,0,0,100,0,0,0
46,South Dakota/SD,4600200,"Lakota Region PUMA, South Dakota/SD",46119,"Sully County, South Dakota",1331,10,0,751,0,0.014,28,0,0,1,0,0,29,0,0,0,0,0,29,97,3,0,0,0,0,0,0,100,0,0,0
46,South Dakota/SD,4600200,"Lakota Region PUMA, South Dakota/SD",46121,"Todd County, South Dakota",10146,122,5,1202,49,0.097,194,0,0,4,0,0,198,0,0,0,0,0,198,98,2,0,0,0,0,0,0,100,0,0,0
46,South Dakota/SD,4600200,"Lakota Region PUMA, South Dakota/SD",46123,"Tripp County, South Dakota",5468,135,0,2469,0,0.053,106,0,0,2,0,0,108,0,0,0,0,0,108,98,2,0,0,0,0,0,0,100,0,0,0
46,South Dakota/SD,4600200,"Lakota Region PUMA, South Dakota/SD",46137,"Ziebach County, South Dakota",2814,60,0,2132,0,0.027,54,0,0,1,0,0,55,0,0,0,0,0,55,98,2,0,0,0,0,0,0,100,0,0,0
46,South Dakota/SD,4600200,"Lakota Region PUMA, South Dakota/SD",46113,NA,NA,NA,NA,NA,NA,0.138,275,0,0,6,0,0,281,0,0,0,0,0,281,98,2,0,0,0,0,0,0,100,0,0,0
46,South Dakota/SD,4600300,"Northeast South Dakota PUMA, South Dakota/SD",46013,"Brown County, South Dakota",38840,1124,4,2894,10,0.293,633,4,56,58,9,77,691,13,133,86,60,146,837,76,7,10,7,1,0,9,7,83,17,2,16
46,South Dakota/SD,4600300,"Northeast South Dakota PUMA, South Dakota/SD",46021,"Campbell County, South Dakota",1435,23,0,1603,0,0.01,22,0,2,2,0,3,24,0,5,3,2,5,29,76,7,10,7,0,0,10,7,83,17,0,17
46,South Dakota/SD,4600300,"Northeast South Dakota PUMA, South Dakota/SD",46025,"Clark County, South Dakota",3673,37,0,1007,0,0.027,58,0,5,5,1,7,63,1,12,8,5,13,76,76,7,11,7,1,0,9,7,83,17,1,16
46,South Dakota/SD,4600300,"Northeast South Dakota PUMA, South Dakota/SD",46029,"Codington County, South Dakota",27993,805,3,2876,11,0.21,454,3,40,42,7,55,496,10,95,62,43,105,601,76,7,10,7,1,0,9,7,83,17,2,16
46,South Dakota/SD,4600300,"Northeast South Dakota PUMA, South Dakota/SD",46037,"Day County, South Dakota",5506,70,0,1271,0,0.042,91,1,8,8,1,11,99,2,19,12,9,21,120,76,7,10,8,1,1,9,7,82,18,2,16
46,South Dakota/SD,4600300,"Northeast South Dakota PUMA, South Dakota/SD",46039,"Deuel County, South Dakota",4306,82,0,1904,0,0.032,69,0,6,6,1,8,75,1,14,9,6,15,90,77,7,10,7,1,0,9,7,83,17,1,16
46,South Dakota/SD,4600300,"Northeast South Dakota PUMA, South Dakota/SD",46045,"Edmunds County, South Dakota",3940,91,0,2310,0,0.03,65,0,6,6,1,8,71,1,14,9,6,15,86,76,7,10,7,1,0,9,7,83,17,1,16
46,South Dakota/SD,4600300,"Northeast South Dakota PUMA, South Dakota/SD",46049,"Faulk County, South Dakota",2322,66,1,2842,43,0.018,39,0,3,4,1,5,43,1,8,6,3,9,52,75,8,12,6,2,0,10,6,83,17,2,15
46,South Dakota/SD,4600300,"Northeast South Dakota PUMA, South Dakota/SD",46051,"Grant County, South Dakota",7217,114,1,1580,14,0.054,117,1,10,11,2,14,128,3,24,16,11,27,155,75,7,10,7,1,1,9,6,83,17,2,15
46,South Dakota/SD,4600300,"Northeast South Dakota PUMA, South Dakota/SD",46057,"Hamlin County, South Dakota",6000,90,0,1500,0,0.045,97,1,9,9,1,12,106,2,21,13,10,23,129,75,7,10,8,1,1,9,7,82,18,2,16
46,South Dakota/SD,4600300,"Northeast South Dakota PUMA, South Dakota/SD",46089,"McPherson County, South Dakota",2364,31,0,1311,0,0.018,39,0,3,4,1,5,43,1,8,6,3,9,52,75,8,12,6,2,0,10,6,83,17,2,15
46,South Dakota/SD,4600300,"Northeast South Dakota PUMA, South Dakota/SD",46091,"Marshall County, South Dakota",4895,38,0,776,0,0.036,78,0,7,7,1,9,85,1,16,10,7,17,102,76,7,10,7,1,0,9,7,83,17,1,16
46,South Dakota/SD,4600300,"Northeast South Dakota PUMA, South Dakota/SD",46107,"Potter County, South Dakota",2326,42,0,1806,0,0.017,37,0,3,3,1,4,40,1,7,5,3,8,48,77,6,10,6,2,0,8,6,83,17,2,15
46,South Dakota/SD,4600300,"Northeast South Dakota PUMA, South Dakota/SD",46109,"Roberts County, South Dakota",10285,181,1,1760,10,0.077,166,1,15,15,2,20,181,3,35,22,16,38,219,76,7,10,7,1,0,9,7,83,17,1,16
46,South Dakota/SD,4600300,"Northeast South Dakota PUMA, South Dakota/SD",46115,"Spink County, South Dakota",6543,124,0,1895,0,0.048,104,1,9,10,2,13,114,3,22,15,10,25,139,75,7,11,7,1,1,9,6,82,18,2,16
46,South Dakota/SD,4600300,"Northeast South Dakota PUMA, South Dakota/SD",46129,"Walworth County, South Dakota",5510,115,1,2087,18,0.042,91,1,8,8,1,11,99,2,19,12,9,21,120,76,7,10,8,1,1,9,7,82,18,2,16
46,South Dakota/SD,4600400,"Jackrabbit Region PUMA, South Dakota/SD",46003,"Aurora County, South Dakota",2759,48,0,1740,0,0.02,46,0,8,2,3,9,48,3,17,12,8,20,68,68,3,18,12,4,0,13,12,71,29,4,25
46,South Dakota/SD,4600400,"Jackrabbit Region PUMA, South Dakota/SD",46005,"Beadle County, South Dakota",18374,758,9,4125,49,0.134,309,0,55,13,19,61,322,19,116,80,55,135,457,68,3,18,12,4,0,13,12,70,30,4,25
46,South Dakota/SD,4600400,"Jackrabbit Region PUMA, South Dakota/SD",46009,"Bon Homme County, South Dakota",6969,81,1,1162,14,0.052,120,0,21,5,7,24,125,7,45,31,21,52,177,68,3,18,12,4,0,14,12,71,29,4,25
46,South Dakota/SD,4600400,"Jackrabbit Region PUMA, South Dakota/SD",46011,"Brookings County, South Dakota",34239,731,2,2135,6,0.253,583,0,103,25,36,115,608,36,218,151,103,254,862,68,3,18,12,4,0,13,12,71,29,4,25
46,South Dakota/SD,4600400,"Jackrabbit Region PUMA, South Dakota/SD",46015,"Brule County, South Dakota",5256,110,0,2093,0,0.039,90,0,16,4,5,18,94,5,34,23,16,39,133,68,3,17,12,4,0,14,12,71,29,4,26
46,South Dakota/SD,4600400,"Jackrabbit Region PUMA, South Dakota/SD",46035,"Davison County, South Dakota",19901,258,2,1296,10,0.147,339,0,60,14,21,67,353,21,127,88,60,148,501,68,3,18,12,4,0,13,12,70,30,4,25
46,South Dakota/SD,4600400,"Jackrabbit Region PUMA, South Dakota/SD",46043,"Douglas County, South Dakota",2930,79,1,2696,34,0.022,51,0,9,2,3,10,53,3,19,13,9,22,75,68,3,17,12,4,0,13,12,71,29,4,25
46,South Dakota/SD,4600400,"Jackrabbit Region PUMA, South Dakota/SD",46059,"Hand County, South Dakota",3301,35,0,1060,0,0.025,58,0,10,2,4,11,60,4,21,15,10,25,85,68,2,18,12,5,0,13,12,71,29,5,25
46,South Dakota/SD,4600400,"Jackrabbit Region PUMA, South Dakota/SD",46061,"Hanson County, South Dakota",3397,35,0,1030,0,0.025,58,0,10,2,4,11,60,4,21,15,10,25,85,68,2,18,12,5,0,13,12,71,29,5,25
46,South Dakota/SD,4600400,"Jackrabbit Region PUMA, South Dakota/SD",46067,"Hutchinson County, South Dakota",7315,88,2,1203,27,0.055,127,0,22,5,8,25,132,8,47,33,22,55,187,68,3,18,12,4,0,13,12,71,29,4,25
46,South Dakota/SD,4600400,"Jackrabbit Region PUMA, South Dakota/SD",46073,"Jerauld County, South Dakota",2029,81,1,3992,49,0.015,35,0,6,1,2,7,36,2,13,9,6,15,51,69,2,18,12,4,0,14,12,71,29,4,25
46,South Dakota/SD,4600400,"Jackrabbit Region PUMA, South Dakota/SD",46077,"Kingsbury County, South Dakota",4967,52,0,1047,0,0.037,85,0,15,4,5,17,89,5,32,22,15,37,126,67,3,17,12,4,0,13,12,71,29,4,25
46,South Dakota/SD,4600400,"Jackrabbit Region PUMA, South Dakota/SD",46079,"Lake County, South Dakota",12574,188,7,1495,56,0.095,219,0,39,9,13,43,228,13,82,56,39,95,323,68,3,17,12,4,0,13,12,71,29,4,25
46,South Dakota/SD,4600400,"Jackrabbit Region PUMA, South Dakota/SD",46097,"Miner County, South Dakota",2229,20,0,897,0,0.017,39,0,7,2,2,8,41,2,15,10,7,17,58,67,3,17,12,3,0,14,12,71,29,3,26
46,South Dakota/SD,4600400,"Jackrabbit Region PUMA, South Dakota/SD",46101,"Moody County, South Dakota",6506,85,0,1306,0,0.048,111,0,20,5,7,22,116,7,42,29,20,49,165,67,3,18,12,4,0,13,12,70,30,4,25
46,South Dakota/SD,4600400,"Jackrabbit Region PUMA, South Dakota/SD",46111,"Sanborn County, South Dakota",2388,27,0,1131,0,0.018,41,0,7,2,3,8,43,3,15,11,7,18,61,67,3,18,11,5,0,13,11,70,30,5,25
46,South Dakota/SD,4600500,"Southeast South Dakota (Outside Sioux Falls City) PUMA, South Dakota/SD",46027,"Clay County, South Dakota",13925,554,5,3978,36,0.105,113,7,24,2,0,3,115,7,27,3,31,34,149,76,1,2,21,0,5,2,16,77,23,5,18
46,South Dakota/SD,4600500,"Southeast South Dakota (Outside Sioux Falls City) PUMA, South Dakota/SD",46083,"Lincoln County, South Dakota",54914,1296,2,2360,4,0.212,229,14,49,5,0,5,234,14,54,5,63,68,302,76,2,2,21,0,5,2,16,77,23,5,18
46,South Dakota/SD,4600500,"Southeast South Dakota (Outside Sioux Falls City) PUMA, South Dakota/SD",46087,"McCook County, South Dakota",5511,92,1,1669,18,0.042,45,3,10,1,0,1,46,3,11,1,13,14,60,75,2,2,22,0,5,2,17,77,23,5,18
46,South Dakota/SD,4600500,"Southeast South Dakota (Outside Sioux Falls City) PUMA, South Dakota/SD",46099,"Minnehaha County, South Dakota",186749,6508,81,3485,43,0.298,322,20,69,7,0,7,329,20,76,7,89,96,425,76,2,2,21,0,5,2,16,77,23,5,18
46,South Dakota/SD,4600500,"Southeast South Dakota (Outside Sioux Falls City) PUMA, South Dakota/SD",46125,"Turner County, South Dakota",8264,153,2,1851,24,0.062,67,4,14,1,0,2,68,4,16,2,18,20,88,76,1,2,20,0,5,2,16,77,23,5,18
46,South Dakota/SD,4600500,"Southeast South Dakota (Outside Sioux Falls City) PUMA, South Dakota/SD",46127,"Union County, South Dakota",15177,384,7,2530,46,0.112,121,8,26,3,0,3,124,8,29,3,34,37,161,75,2,2,21,0,5,2,16,77,23,5,18
46,South Dakota/SD,4600500,"Southeast South Dakota (Outside Sioux Falls City) PUMA, South Dakota/SD",46135,"Yankton County, South Dakota",22717,393,4,1730,18,0.169,183,11,39,4,0,4,187,11,43,4,50,54,241,76,2,2,21,0,5,2,16,78,22,5,18
46,South Dakota/SD,4600600,"Sioux Falls City PUMA, South Dakota/SD",46083,"Lincoln County, South Dakota",54914,1296,2,2360,4,0.151,138,33,44,3,177,186,141,210,230,363,77,440,581,24,1,62,13,30,6,32,8,24,76,36,40
46,South Dakota/SD,4600600,"Sioux Falls City PUMA, South Dakota/SD",46099,"Minnehaha County, South Dakota",186749,6508,81,3485,43,0.849,776,188,247,14,993,1046,790,1181,1293,2039,435,2474,3264,24,0,62,13,30,6,32,8,24,76,36,40
47,Tennessee/TN,4700100,"Northwest Tennessee--Gibson, Dyer, Obion, Crockett & Lake Counties PUMA, Tennessee/TN",47033,"Crockett County, Tennessee",14499,536,19,3697,131,0.103,188,10,12,5,0,0,193,10,12,0,22,22,215,87,2,0,10,0,5,0,6,90,10,5,6
47,Tennessee/TN,4700100,"Northwest Tennessee--Gibson, Dyer, Obion, Crockett & Lake Counties PUMA, Tennessee/TN",47045,"Dyer County, Tennessee",37576,1350,14,3593,37,0.27,492,26,32,14,0,0,506,26,32,0,58,58,564,87,2,0,10,0,5,0,6,90,10,5,6
47,Tennessee/TN,4700100,"Northwest Tennessee--Gibson, Dyer, Obion, Crockett & Lake Counties PUMA, Tennessee/TN",47053,"Gibson County, Tennessee",49175,1636,22,3327,45,0.354,645,34,42,18,0,0,663,34,42,0,76,76,739,87,2,0,10,0,5,0,6,90,10,5,6
47,Tennessee/TN,4700100,"Northwest Tennessee--Gibson, Dyer, Obion, Crockett & Lake Counties PUMA, Tennessee/TN",47095,"Lake County, Tennessee",7526,918,2,12198,27,0.054,98,5,6,3,0,0,101,5,6,0,11,11,112,88,3,0,10,0,4,0,5,90,10,4,5
47,Tennessee/TN,4700100,"Northwest Tennessee--Gibson, Dyer, Obion, Crockett & Lake Counties PUMA, Tennessee/TN",47131,"Obion County, Tennessee",30520,1156,10,3788,33,0.219,399,21,26,11,0,0,410,21,26,0,47,47,457,87,2,0,10,0,5,0,6,90,10,5,6
47,Tennessee/TN,4700200,"Land Between the Lakes--Weakley, Henry, Carroll, Humphreys, Benton & Houston Counties PUMA, Tennessee/TN",47005,"Benton County, Tennessee",16112,336,9,2085,56,0.117,90,0,3,3,1,0,93,1,3,1,3,4,97,93,3,1,3,1,0,0,3,96,4,1,3
47,Tennessee/TN,4700200,"Land Between the Lakes--Weakley, Henry, Carroll, Humphreys, Benton & Houston Counties PUMA, Tennessee/TN",47017,"Carroll County, Tennessee",28018,874,20,3119,71,0.206,158,0,5,6,1,0,164,1,5,1,5,6,170,93,4,1,3,1,0,0,3,96,4,1,3
47,Tennessee/TN,4700200,"Land Between the Lakes--Weakley, Henry, Carroll, Humphreys, Benton & Houston Counties PUMA, Tennessee/TN",47079,"Henry County, Tennessee",32279,618,9,1915,28,0.237,182,0,5,7,2,0,189,2,5,2,5,7,196,93,4,1,3,1,0,0,3,96,4,1,3
47,Tennessee/TN,4700200,"Land Between the Lakes--Weakley, Henry, Carroll, Humphreys, Benton & Houston Counties PUMA, Tennessee/TN",47083,"Houston County, Tennessee",8176,214,3,2617,37,0.06,46,0,1,2,0,0,48,0,1,0,1,1,49,94,4,0,2,0,0,0,2,98,2,0,2
47,Tennessee/TN,4700200,"Land Between the Lakes--Weakley, Henry, Carroll, Humphreys, Benton & Houston Counties PUMA, Tennessee/TN",47085,"Humphreys County, Tennessee",18318,246,3,1343,16,0.135,103,0,3,4,1,0,107,1,3,1,3,4,111,93,4,1,3,1,0,0,3,96,4,1,3
47,Tennessee/TN,4700200,"Land Between the Lakes--Weakley, Henry, Carroll, Humphreys, Benton & Houston Counties PUMA, Tennessee/TN",47183,"Weakley County, Tennessee",33626,1176,19,3497,57,0.246,188,0,6,7,2,0,195,2,6,2,6,8,203,93,3,1,3,1,0,0,3,96,4,1,3
47,Tennessee/TN,4700300,"Montgomery & Stewart Counties--Clarksville City PUMA, Tennessee/TN",47125,"Montgomery County, Tennessee",196387,3045,44,1551,22,0.937,271,0,5,0,0,0,271,0,5,0,5,5,276,98,0,0,2,0,0,0,2,98,2,0,2
47,Tennessee/TN,4700300,"Montgomery & Stewart Counties--Clarksville City PUMA, Tennessee/TN",47161,"Stewart County, Tennessee",13301,198,2,1489,15,0.063,18,0,0,0,0,0,18,0,0,0,0,0,18,100,0,0,0,0,0,0,0,100,0,0,0
47,Tennessee/TN,4700400,"Robertson, Dickson, Cheatham & Hickman Counties PUMA, Tennessee/TN",47021,"Cheatham County, Tennessee",39929,805,10,2016,25,0.215,149,0,27,0,0,0,149,0,27,0,27,27,176,85,0,0,15,0,0,0,15,85,15,0,15
47,Tennessee/TN,4700400,"Robertson, Dickson, Cheatham & Hickman Counties PUMA, Tennessee/TN",47043,"Dickson County, Tennessee",51988,1250,15,2404,29,0.281,194,0,35,0,0,0,194,0,35,0,35,35,229,85,0,0,15,0,0,0,15,85,15,0,15
47,Tennessee/TN,4700400,"Robertson, Dickson, Cheatham & Hickman Counties PUMA, Tennessee/TN",47081,"Hickman County, Tennessee",24678,573,8,2322,32,0.131,91,0,16,0,0,0,91,0,16,0,16,16,107,85,0,0,15,0,0,0,15,85,15,0,15
47,Tennessee/TN,4700400,"Robertson, Dickson, Cheatham & Hickman Counties PUMA, Tennessee/TN",47147,"Robertson County, Tennessee",69344,2203,35,3177,50,0.373,258,0,47,0,0,0,258,0,47,0,47,47,305,85,0,0,15,0,0,0,15,85,15,0,15
47,Tennessee/TN,4700500,"Sumner County--Hendersonville City PUMA, Tennessee/TN",47165,"Sumner County, Tennessee",179473,4794,97,2671,54,1,293,13,14,33,17,0,326,30,14,17,27,44,370,79,9,5,7,5,4,0,4,88,12,8,4
47,Tennessee/TN,4700600,"Warren, Macon, Smith, DeKalb, Cannon & Trousdale Counties PUMA, Tennessee/TN",47015,"Cannon County, Tennessee",13976,283,0,2025,0,0.112,85,5,40,0,0,13,85,5,53,13,45,58,143,59,0,9,31,0,3,9,28,59,41,3,37
47,Tennessee/TN,4700600,"Warren, Macon, Smith, DeKalb, Cannon & Trousdale Counties PUMA, Tennessee/TN",47041,"DeKalb County, Tennessee",19601,561,14,2862,71,0.155,117,7,55,0,0,18,117,7,73,18,62,80,197,59,0,9,31,0,4,9,28,59,41,4,37
47,Tennessee/TN,4700600,"Warren, Macon, Smith, DeKalb, Cannon & Trousdale Counties PUMA, Tennessee/TN",47111,"Macon County, Tennessee",23487,1046,20,4454,85,0.187,141,8,66,0,0,21,141,8,87,21,74,95,236,60,0,9,31,0,3,9,28,60,40,3,37
47,Tennessee/TN,4700600,"Warren, Macon, Smith, DeKalb, Cannon & Trousdale Counties PUMA, Tennessee/TN",47159,"Smith County, Tennessee",19458,713,11,3664,57,0.155,117,7,55,0,0,18,117,7,73,18,62,80,197,59,0,9,31,0,4,9,28,59,41,4,37
47,Tennessee/TN,4700600,"Warren, Macon, Smith, DeKalb, Cannon & Trousdale Counties PUMA, Tennessee/TN",47169,"Trousdale County, Tennessee",9573,1653,7,17267,73,0.066,50,3,23,0,0,8,50,3,31,8,26,34,84,60,0,10,31,0,4,10,27,60,40,4,37
47,Tennessee/TN,4700600,"Warren, Macon, Smith, DeKalb, Cannon & Trousdale Counties PUMA, Tennessee/TN",47177,"Warren County, Tennessee",40454,1047,7,2588,17,0.324,245,14,115,0,0,37,245,14,152,37,129,166,411,60,0,9,31,0,3,9,28,60,40,3,37
47,Tennessee/TN,4700700,"Putnam, Overton, Jackson, Clay & Pickett Counties PUMA, Tennessee/TN",47027,"Clay County, Tennessee",7686,224,5,2914,65,0.063,29,0,7,0,0,0,29,0,7,0,7,7,36,81,0,0,19,0,0,0,19,81,19,0,19
47,Tennessee/TN,4700700,"Putnam, Overton, Jackson, Clay & Pickett Counties PUMA, Tennessee/TN",47087,"Jackson County, Tennessee",11615,324,5,2789,43,0.094,43,1,11,0,0,0,43,1,11,0,12,12,55,78,0,0,22,0,2,0,20,78,22,2,20
47,Tennessee/TN,4700700,"Putnam, Overton, Jackson, Clay & Pickett Counties PUMA, Tennessee/TN",47133,"Overton County, Tennessee",22004,735,5,3340,23,0.18,82,1,20,0,0,0,82,1,20,0,21,21,103,80,0,0,20,0,1,0,19,80,20,1,19
47,Tennessee/TN,4700700,"Putnam, Overton, Jackson, Clay & Pickett Counties PUMA, Tennessee/TN",47137,"Pickett County, Tennessee",5088,114,2,2241,39,0.042,19,0,5,0,0,0,19,0,5,0,5,5,24,79,0,0,21,0,0,0,21,79,21,0,21
47,Tennessee/TN,4700700,"Putnam, Overton, Jackson, Clay & Pickett Counties PUMA, Tennessee/TN",47141,"Putnam County, Tennessee",76440,3277,40,4287,52,0.62,281,4,69,0,0,0,281,4,69,0,73,73,354,79,0,0,21,0,1,0,19,79,21,1,19
47,Tennessee/TN,4700800,"Cumberland, White, Fentress & Van Buren Counties PUMA, Tennessee/TN",47035,"Cumberland County, Tennessee",58634,1192,18,2033,31,0.538,577,0,0,56,0,0,633,0,0,0,0,0,633,91,9,0,0,0,0,0,0,100,0,0,0
47,Tennessee/TN,4700800,"Cumberland, White, Fentress & Van Buren Counties PUMA, Tennessee/TN",47049,"Fentress County, Tennessee",17994,493,3,2740,17,0.165,177,0,0,17,0,0,194,0,0,0,0,0,194,91,9,0,0,0,0,0,0,100,0,0,0
47,Tennessee/TN,4700800,"Cumberland, White, Fentress & Van Buren Counties PUMA, Tennessee/TN",47175,"Van Buren County, Tennessee",5704,164,0,2875,0,0.052,56,0,0,5,0,0,61,0,0,0,0,0,61,92,8,0,0,0,0,0,0,100,0,0,0
47,Tennessee/TN,4700800,"Cumberland, White, Fentress & Van Buren Counties PUMA, Tennessee/TN",47185,"White County, Tennessee",26580,830,9,3123,34,0.244,262,0,0,25,0,0,287,0,0,0,0,0,287,91,9,0,0,0,0,0,0,100,0,0,0
47,Tennessee/TN,4700900,"Campbell, Claiborne, Scott, Morgan & Hancock Counties PUMA, Tennessee/TN",47013,"Campbell County, Tennessee",39687,439,4,1106,10,0.327,175,4,5,0,0,0,175,4,5,0,9,9,184,95,0,0,5,0,2,0,3,95,5,2,3
47,Tennessee/TN,4700900,"Campbell, Claiborne, Scott, Morgan & Hancock Counties PUMA, Tennessee/TN",47025,"Claiborne County, Tennessee",31613,441,5,1395,16,0.261,140,3,4,0,0,0,140,3,4,0,7,7,147,95,0,0,5,0,2,0,3,95,5,2,3
47,Tennessee/TN,4700900,"Campbell, Claiborne, Scott, Morgan & Hancock Counties PUMA, Tennessee/TN",47067,"Hancock County, Tennessee",6585,106,3,1610,46,0.054,29,1,1,0,0,0,29,1,1,0,2,2,31,94,0,0,6,0,3,0,3,94,6,3,3
47,Tennessee/TN,4700900,"Campbell, Claiborne, Scott, Morgan & Hancock Counties PUMA, Tennessee/TN",47129,"Morgan County, Tennessee",21596,315,3,1459,14,0.177,95,2,3,0,0,0,95,2,3,0,5,5,100,95,0,0,5,0,2,0,3,95,5,2,3
47,Tennessee/TN,4700900,"Campbell, Claiborne, Scott, Morgan & Hancock Counties PUMA, Tennessee/TN",47151,"Scott County, Tennessee",21954,213,2,970,9,0.181,97,2,3,0,0,0,97,2,3,0,5,5,102,95,0,0,5,0,2,0,3,95,5,2,3
47,Tennessee/TN,4701000,"Hawkins & Sullivan (Northwest) Counties--Kingsport City PUMA, Tennessee/TN",47073,"Hawkins County, Tennessee",56402,796,18,1411,32,0.529,126,0,0,0,0,0,126,0,0,0,0,0,126,100,0,0,0,0,0,0,0,100,0,0,0
47,Tennessee/TN,4701000,"Hawkins & Sullivan (Northwest) Counties--Kingsport City PUMA, Tennessee/TN",47163,"Sullivan County, Tennessee",156734,2148,33,1370,21,0.471,113,0,0,0,0,0,113,0,0,0,0,0,113,100,0,0,0,0,0,0,0,100,0,0,0
47,Tennessee/TN,4701100,"Sullivan County (Southeast)--Bristol City PUMA, Tennessee/TN",47163,"Sullivan County, Tennessee",156734,2148,33,1370,21,1,142,0,25,0,0,0,142,0,25,0,25,25,167,85,0,0,15,0,0,0,15,85,15,0,15
47,Tennessee/TN,4701200,"Greene, Carter, Unicoi & Johnson Counties PUMA, Tennessee/TN",47019,"Carter County, Tennessee",56391,1158,28,2054,50,0.352,138,8,42,0,0,0,138,8,42,0,50,50,188,73,0,0,27,0,4,0,22,73,27,4,22
47,Tennessee/TN,4701200,"Greene, Carter, Unicoi & Johnson Counties PUMA, Tennessee/TN",47059,"Greene County, Tennessee",68669,1142,44,1663,64,0.427,167,10,50,0,0,0,167,10,50,0,60,60,227,74,0,0,26,0,4,0,22,74,26,4,22
47,Tennessee/TN,4701200,"Greene, Carter, Unicoi & Johnson Counties PUMA, Tennessee/TN",47091,"Johnson County, Tennessee",17789,696,2,3913,11,0.111,43,3,13,0,0,0,43,3,13,0,16,16,59,73,0,0,27,0,5,0,22,73,27,5,22
47,Tennessee/TN,4701200,"Greene, Carter, Unicoi & Johnson Counties PUMA, Tennessee/TN",47171,"Unicoi County, Tennessee",17780,285,1,1603,6,0.11,43,3,13,0,0,0,43,3,13,0,16,16,59,73,0,0,27,0,5,0,22,73,27,5,22
47,Tennessee/TN,4701300,"Washington County--Johnson City PUMA, Tennessee/TN",47179,"Washington County, Tennessee",127055,2276,35,1791,28,1,103,0,135,22,17,0,125,17,135,17,135,152,277,37,8,6,49,6,0,0,49,45,55,6,49
47,Tennessee/TN,4701400,"Hamblen, Cocke & Grainger Counties PUMA, Tennessee/TN",47029,"Cocke County, Tennessee",35336,743,9,2103,25,0.289,227,16,41,32,0,0,259,16,41,0,57,57,316,72,10,0,18,0,5,0,13,82,18,5,13
47,Tennessee/TN,4701400,"Hamblen, Cocke & Grainger Counties PUMA, Tennessee/TN",47057,"Grainger County, Tennessee",23013,372,3,1616,13,0.189,148,10,27,21,0,0,169,10,27,0,37,37,206,72,10,0,18,0,5,0,13,82,18,5,13
47,Tennessee/TN,4701400,"Hamblen, Cocke & Grainger Counties PUMA, Tennessee/TN",47063,"Hamblen County, Tennessee",63740,1899,26,2979,41,0.523,411,29,74,58,0,0,469,29,74,0,103,103,572,72,10,0,18,0,5,0,13,82,18,5,13
47,Tennessee/TN,4701500,"Sevier & Jefferson Counties PUMA, Tennessee/TN",47089,"Jefferson County, Tennessee",53247,1110,14,2085,26,0.356,204,0,21,15,0,0,219,0,21,0,21,21,240,85,6,0,9,0,0,0,9,91,9,0,9
47,Tennessee/TN,4701500,"Sevier & Jefferson Counties PUMA, Tennessee/TN",47155,"Sevier County, Tennessee",96287,2596,15,2696,16,0.644,370,0,38,26,0,0,396,0,38,0,38,38,434,85,6,0,9,0,0,0,9,91,9,0,9
47,Tennessee/TN,4701601,"Anderson, Union & Knox (North) Counties--Oak Ridge (East) & Clinton Cities PUMA, Tennessee/TN",47001,"Anderson County, Tennessee",75775,1165,13,1537,17,0.708,76,0,0,0,0,0,76,0,0,0,0,0,76,100,0,0,0,0,0,0,0,100,0,0,0
47,Tennessee/TN,4701601,"Anderson, Union & Knox (North) Counties--Oak Ridge (East) & Clinton Cities PUMA, Tennessee/TN",47093,"Knox County, Tennessee",456185,9893,78,2169,17,0.114,12,0,0,0,0,0,12,0,0,0,0,0,12,100,0,0,0,0,0,0,0,100,0,0,0
47,Tennessee/TN,4701601,"Anderson, Union & Knox (North) Counties--Oak Ridge (East) & Clinton Cities PUMA, Tennessee/TN",47173,"Union County, Tennessee",19293,353,1,1830,5,0.178,19,0,0,0,0,0,19,0,0,0,0,0,19,100,0,0,0,0,0,0,0,100,0,0,0
47,Tennessee/TN,4701602,"Knox County (East) PUMA, Tennessee/TN",47093,"Knox County, Tennessee",456185,9893,78,2169,17,1,213,120,4,0,7,0,213,127,4,7,124,131,344,62,0,2,36,2,35,0,1,62,38,37,1
47,Tennessee/TN,4701603,"Knoxville City PUMA, Tennessee/TN",47093,"Knox County, Tennessee",456185,9893,78,2169,17,1,279,0,0,0,0,65,279,0,65,65,0,65,344,81,0,19,0,0,0,19,0,81,19,0,19
47,Tennessee/TN,4701604,"Knox County (West)--Farragut Town PUMA, Tennessee/TN",47093,"Knox County, Tennessee",456185,9893,78,2169,17,1,133,14,1,0,0,0,133,14,1,0,15,15,148,90,0,0,10,0,9,0,1,90,10,9,1
47,Tennessee/TN,4701700,"Blount County PUMA, Tennessee/TN",47009,"Blount County, Tennessee",128443,2504,24,1950,19,1,196,0,0,0,14,0,196,14,0,14,0,14,210,93,0,7,0,7,0,0,0,93,7,7,0
47,Tennessee/TN,4701800,"Roane, Loudon & Monroe Counties--Oak Ridge City (West) PUMA, Tennessee/TN",47105,"Loudon County, Tennessee",51610,1154,6,2236,12,0.342,136,29,49,5,0,0,141,29,49,0,78,78,219,62,2,0,36,0,13,0,22,64,36,13,22
47,Tennessee/TN,4701800,"Roane, Loudon & Monroe Counties--Oak Ridge City (West) PUMA, Tennessee/TN",47123,"Monroe County, Tennessee",45876,1030,18,2245,39,0.306,122,26,43,4,0,0,126,26,43,0,69,69,195,63,2,0,35,0,13,0,22,65,35,13,22
47,Tennessee/TN,4701800,"Roane, Loudon & Monroe Counties--Oak Ridge City (West) PUMA, Tennessee/TN",47145,"Roane County, Tennessee",52897,885,4,1673,8,0.352,140,30,50,5,0,0,145,30,50,0,80,80,225,62,2,0,36,0,13,0,22,64,36,13,22
47,Tennessee/TN,4701900,"Bradley, McMinn & Polk Counties--Cleveland City PUMA, Tennessee/TN",47011,"Bradley County, Tennessee",104557,2914,17,2787,16,0.6,718,7,43,10,0,4,728,7,47,4,50,54,782,92,1,1,6,0,1,1,5,93,7,1,6
47,Tennessee/TN,4701900,"Bradley, McMinn & Polk Counties--Cleveland City PUMA, Tennessee/TN",47107,"McMinn County, Tennessee",52773,1113,25,2109,47,0.304,364,4,22,5,0,2,369,4,24,2,26,28,397,92,1,1,7,0,1,1,6,93,7,1,6
47,Tennessee/TN,4701900,"Bradley, McMinn & Polk Counties--Cleveland City PUMA, Tennessee/TN",47139,"Polk County, Tennessee",16782,388,10,2312,60,0.096,115,1,7,2,0,1,117,1,8,1,8,9,126,91,2,1,6,0,1,1,6,93,7,1,6
47,Tennessee/TN,4702001,"Chattanooga City (South & Central) PUMA, Tennessee/TN",47065,"Hamilton County, Tennessee",357546,9542,94,2669,26,1,543,0,161,50,22,0,593,22,161,22,161,183,776,70,6,3,21,3,0,0,21,76,24,3,21
47,Tennessee/TN,4702002,"Hamilton County (South)--Chattanooga (North) & Red Bank Cities PUMA, Tennessee/TN",47065,"Hamilton County, Tennessee",357546,9542,94,2669,26,1,392,0,7,23,27,0,415,27,7,27,7,34,449,87,5,6,2,6,0,0,2,92,8,6,2
47,Tennessee/TN,4702003,"Hamilton County (North)--Soddy-Daisy City PUMA, Tennessee/TN",47065,"Hamilton County, Tennessee",357546,9542,94,2669,26,1,497,0,0,0,0,11,497,0,11,11,0,11,508,98,0,2,0,0,0,2,0,98,2,0,2
47,Tennessee/TN,4702100,"Rhea, Marion, Sequatchie, Grundy, Bledsoe & Meigs Counties PUMA, Tennessee/TN",47007,"Bledsoe County, Tennessee",14602,854,4,5849,27,0.127,65,4,42,0,0,12,65,4,54,12,46,58,123,53,0,10,37,0,3,10,34,53,47,3,44
47,Tennessee/TN,4702100,"Rhea, Marion, Sequatchie, Grundy, Bledsoe & Meigs Counties PUMA, Tennessee/TN",47061,"Grundy County, Tennessee",13331,283,5,2123,38,0.116,60,3,38,0,0,11,60,3,49,11,41,52,112,54,0,10,37,0,3,10,34,54,46,3,44
47,Tennessee/TN,4702100,"Rhea, Marion, Sequatchie, Grundy, Bledsoe & Meigs Counties PUMA, Tennessee/TN",47115,"Marion County, Tennessee",28417,525,8,1847,28,0.246,126,7,81,0,0,24,126,7,105,24,88,112,238,53,0,10,37,0,3,10,34,53,47,3,44
47,Tennessee/TN,4702100,"Rhea, Marion, Sequatchie, Grundy, Bledsoe & Meigs Counties PUMA, Tennessee/TN",47121,"Meigs County, Tennessee",11962,226,3,1889,25,0.104,53,3,34,0,0,10,53,3,44,10,37,47,100,53,0,10,37,0,3,10,34,53,47,3,44
47,Tennessee/TN,4702100,"Rhea, Marion, Sequatchie, Grundy, Bledsoe & Meigs Counties PUMA, Tennessee/TN",47143,"Rhea County, Tennessee",32628,821,12,2516,37,0.28,144,8,92,0,0,27,144,8,119,27,100,127,271,53,0,10,37,0,3,10,34,53,47,3,44
47,Tennessee/TN,4702100,"Rhea, Marion, Sequatchie, Grundy, Bledsoe & Meigs Counties PUMA, Tennessee/TN",47153,"Sequatchie County, Tennessee",14730,231,2,1568,14,0.129,66,4,42,0,0,13,66,4,55,13,46,59,125,53,0,10,37,0,3,10,34,53,47,3,44
47,Tennessee/TN,4702200,"Coffee, Franklin, Lincoln & Moore Counties PUMA, Tennessee/TN",47031,"Coffee County, Tennessee",54531,1210,13,2219,24,0.401,341,0,35,24,0,0,365,0,35,0,35,35,400,85,6,0,9,0,0,0,9,91,9,0,9
47,Tennessee/TN,4702200,"Coffee, Franklin, Lincoln & Moore Counties PUMA, Tennessee/TN",47051,"Franklin County, Tennessee",41512,963,9,2320,22,0.306,260,0,27,19,0,0,279,0,27,0,27,27,306,85,6,0,9,0,0,0,9,91,9,0,9
47,Tennessee/TN,4702200,"Coffee, Franklin, Lincoln & Moore Counties PUMA, Tennessee/TN",47103,"Lincoln County, Tennessee",33711,611,1,1812,3,0.247,210,0,22,15,0,0,225,0,22,0,22,22,247,85,6,0,9,0,0,0,9,91,9,0,9
47,Tennessee/TN,4702200,"Coffee, Franklin, Lincoln & Moore Counties PUMA, Tennessee/TN",47127,"Moore County, Tennessee",6322,169,1,2673,16,0.046,39,0,4,3,0,0,42,0,4,0,4,4,46,85,7,0,9,0,0,0,9,91,9,0,9
47,Tennessee/TN,4702300,"Wilson County--Lebanon & Mount Juliet Cities PUMA, Tennessee/TN",47189,"Wilson County, Tennessee",132663,3453,44,2603,33,1,133,0,0,8,0,0,141,0,0,0,0,0,141,94,6,0,0,0,0,0,0,100,0,0,0
47,Tennessee/TN,4702401,"Rutherford County (North)--Smyrna Town & La Vergne City PUMA, Tennessee/TN",47149,"Rutherford County, Tennessee",307128,9240,89,3009,29,1,246,58,0,0,24,153,246,82,153,177,58,235,481,51,0,37,12,5,12,32,0,51,49,17,32
47,Tennessee/TN,4702402,"Rutherford County (South)--Murfreesboro City PUMA, Tennessee/TN",47149,"Rutherford County, Tennessee",307128,9240,89,3009,29,1,811,0,23,0,0,0,811,0,23,0,23,23,834,97,0,0,3,0,0,0,3,97,3,0,3
47,Tennessee/TN,4702501,"Nashville-Davidson (East) PUMA, Tennessee/TN",47037,"Davidson County, Tennessee",684017,28415,303,4154,44,1,114,27,143,0,76,350,114,103,493,426,170,596,710,16,0,60,24,11,4,49,20,16,84,15,69
47,Tennessee/TN,4702502,"Nashville-Davidson (North) PUMA, Tennessee/TN",47037,"Davidson County, Tennessee",684017,28415,303,4154,44,1,523,0,84,34,0,68,557,0,152,68,84,152,709,74,5,10,12,0,0,10,12,79,21,0,21
47,Tennessee/TN,4702503,"Nashville-Davidson (Central) PUMA, Tennessee/TN",47037,"Davidson County, Tennessee",684017,28415,303,4154,44,1,152,0,120,9,66,246,161,66,366,312,120,432,593,26,2,53,20,11,0,41,20,27,73,11,62
47,Tennessee/TN,4702504,"Nashville-Davidson (Southeast) PUMA, Tennessee/TN",47037,"Davidson County, Tennessee",684017,28415,303,4154,44,1,185,0,36,0,102,547,185,102,583,649,36,685,870,21,0,75,4,12,0,63,4,21,79,12,67
47,Tennessee/TN,4702505,"Nashville-Davidson (Southwest) PUMA, Tennessee/TN",47037,"Davidson County, Tennessee",684017,28415,303,4154,44,1,111,0,20,0,18,0,111,18,20,18,20,38,149,74,0,12,13,12,0,0,13,74,26,12,13
47,Tennessee/TN,4702600,"Williamson County--Franklin & Brentwood Cities PUMA, Tennessee/TN",47187,"Williamson County, Tennessee",218648,5198,36,2377,16,1,155,0,0,9,0,0,164,0,0,0,0,0,164,95,5,0,0,0,0,0,0,100,0,0,0
47,Tennessee/TN,4702700,"Maury, Bedford & Marshall Counties PUMA, Tennessee/TN",47003,"Bedford County, Tennessee",47558,1328,17,2792,36,0.28,277,3,21,33,5,20,310,8,41,25,24,49,359,77,9,7,7,1,1,6,6,86,14,2,11
47,Tennessee/TN,4702700,"Maury, Bedford & Marshall Counties PUMA, Tennessee/TN",47117,"Marshall County, Tennessee",32269,749,5,2321,15,0.188,186,2,14,22,3,13,208,5,27,16,16,32,240,78,9,7,7,1,1,5,6,87,13,2,11
47,Tennessee/TN,4702700,"Maury, Bedford & Marshall Counties PUMA, Tennessee/TN",47119,"Maury County, Tennessee",89776,2329,23,2594,26,0.531,526,6,40,63,10,38,589,16,78,48,46,94,683,77,9,7,7,1,1,6,6,86,14,2,11
47,Tennessee/TN,4702800,"Lawrence, Giles, Wayne, Lewis & Perry Counties PUMA, Tennessee/TN",47055,"Giles County, Tennessee",29167,591,17,2026,58,0.269,135,0,22,0,0,0,135,0,22,0,22,22,157,86,0,0,14,0,0,0,14,86,14,0,14
47,Tennessee/TN,4702800,"Lawrence, Giles, Wayne, Lewis & Perry Counties PUMA, Tennessee/TN",47099,"Lawrence County, Tennessee",42937,1023,12,2383,28,0.395,198,0,32,0,0,0,198,0,32,0,32,32,230,86,0,0,14,0,0,0,14,86,14,0,14
47,Tennessee/TN,4702800,"Lawrence, Giles, Wayne, Lewis & Perry Counties PUMA, Tennessee/TN",47101,"Lewis County, Tennessee",11956,196,1,1639,8,0.109,55,0,9,0,0,0,55,0,9,0,9,9,64,86,0,0,14,0,0,0,14,86,14,0,14
47,Tennessee/TN,4702800,"Lawrence, Giles, Wayne, Lewis & Perry Counties PUMA, Tennessee/TN",47135,"Perry County, Tennessee",7912,150,0,1896,0,0.073,37,0,6,0,0,0,37,0,6,0,6,6,43,86,0,0,14,0,0,0,14,86,14,0,14
47,Tennessee/TN,4702800,"Lawrence, Giles, Wayne, Lewis & Perry Counties PUMA, Tennessee/TN",47181,"Wayne County, Tennessee",16649,1495,5,8980,30,0.153,77,0,12,0,0,0,77,0,12,0,12,12,89,87,0,0,13,0,0,0,13,87,13,0,13
47,Tennessee/TN,4702900,"Henderson, Hardeman, McNairy, Hardin, Haywood & Decatur Counties PUMA, Tennessee/TN",47039,"Decatur County, Tennessee",11683,512,7,4382,60,0.088,58,0,3,1,0,0,59,0,3,0,3,3,62,94,2,0,5,0,0,0,5,95,5,0,5
47,Tennessee/TN,4702900,"Henderson, Hardeman, McNairy, Hardin, Haywood & Decatur Counties PUMA, Tennessee/TN",47069,"Hardeman County, Tennessee",25562,1558,26,6095,102,0.189,124,0,6,3,0,0,127,0,6,0,6,6,133,93,2,0,5,0,0,0,5,95,5,0,5
47,Tennessee/TN,4702900,"Henderson, Hardeman, McNairy, Hardin, Haywood & Decatur Counties PUMA, Tennessee/TN",47071,"Hardin County, Tennessee",25771,1022,16,3966,62,0.191,125,0,6,3,0,0,128,0,6,0,6,6,134,93,2,0,4,0,0,0,4,96,4,0,4
47,Tennessee/TN,4702900,"Henderson, Hardeman, McNairy, Hardin, Haywood & Decatur Counties PUMA, Tennessee/TN",47075,"Haywood County, Tennessee",17779,968,19,5445,107,0.133,87,0,4,2,0,0,89,0,4,0,4,4,93,94,2,0,4,0,0,0,4,96,4,0,4
47,Tennessee/TN,4702900,"Henderson, Hardeman, McNairy, Hardin, Haywood & Decatur Counties PUMA, Tennessee/TN",47077,"Henderson County, Tennessee",27859,1169,24,4196,86,0.207,135,0,6,3,0,0,138,0,6,0,6,6,144,94,2,0,4,0,0,0,4,96,4,0,4
47,Tennessee/TN,4702900,"Henderson, Hardeman, McNairy, Hardin, Haywood & Decatur Counties PUMA, Tennessee/TN",47109,"McNairy County, Tennessee",25903,876,18,3382,69,0.193,126,0,6,3,0,0,129,0,6,0,6,6,135,93,2,0,4,0,0,0,4,96,4,0,4
47,Tennessee/TN,4703000,"Madison & Chester Counties--Jackson City PUMA, Tennessee/TN",47023,"Chester County, Tennessee",17150,623,10,3633,58,0.152,86,0,5,0,0,0,86,0,5,0,5,5,91,95,0,0,5,0,0,0,5,95,5,0,5
47,Tennessee/TN,4703000,"Madison & Chester Counties--Jackson City PUMA, Tennessee/TN",47113,"Madison County, Tennessee",97682,2832,64,2899,66,0.848,477,0,28,0,0,0,477,0,28,0,28,28,505,94,0,0,6,0,0,0,6,94,6,0,6
47,Tennessee/TN,4703100,"Tipton, Fayette & Lauderdale Counties PUMA, Tennessee/TN",47047,"Fayette County, Tennessee",39692,1183,19,2980,48,0.31,294,9,45,16,0,0,310,9,45,0,54,54,364,81,4,0,15,0,2,0,12,85,15,2,12
47,Tennessee/TN,4703100,"Tipton, Fayette & Lauderdale Counties PUMA, Tennessee/TN",47097,"Lauderdale County, Tennessee",26297,979,16,3723,61,0.21,199,6,30,11,0,0,210,6,30,0,36,36,246,81,4,0,15,0,2,0,12,85,15,2,12
47,Tennessee/TN,4703100,"Tipton, Fayette & Lauderdale Counties PUMA, Tennessee/TN",47167,"Tipton County, Tennessee",61446,1805,19,2938,31,0.48,455,14,70,24,0,0,479,14,70,0,84,84,563,81,4,0,15,0,2,0,12,85,15,2,12
47,Tennessee/TN,4703201,"Memphis City (Central Riverside) PUMA, Tennessee/TN",47157,"Shelby County, Tennessee",937005,30922,455,3300,49,1,277,0,26,0,0,30,277,0,56,30,26,56,333,83,0,9,8,0,0,9,8,83,17,0,17
47,Tennessee/TN,4703202,"Memphis City (Central Midtown) PUMA, Tennessee/TN",47157,"Shelby County, Tennessee",937005,30922,455,3300,49,1,54,14,84,32,0,0,86,14,84,0,98,98,184,29,17,0,53,0,8,0,46,47,53,8,46
47,Tennessee/TN,4703203,"Memphis (North) & Bartlett (Southwest) Cities PUMA, Tennessee/TN",47157,"Shelby County, Tennessee",937005,30922,455,3300,49,1,145,0,176,0,0,0,145,0,176,0,176,176,321,45,0,0,55,0,0,0,55,45,55,0,55
47,Tennessee/TN,4703204,"Shelby County (North)--Bartlett (North & East) & Millington Cities PUMA, Tennessee/TN",47157,"Shelby County, Tennessee",937005,30922,455,3300,49,1,141,0,71,0,0,0,141,0,71,0,71,71,212,67,0,0,33,0,0,0,33,67,33,0,33
47,Tennessee/TN,4703205,"Memphis (East), Lakeland Cities & Arlington Town (South) PUMA, Tennessee/TN",47157,"Shelby County, Tennessee",937005,30922,455,3300,49,1,75,0,0,26,0,0,101,0,0,0,0,0,101,74,26,0,0,0,0,0,0,100,0,0,0
47,Tennessee/TN,4703206,"Shelby County (Southeast)--Collierville Town & Germantown City PUMA, Tennessee/TN",47157,"Shelby County, Tennessee",937005,30922,455,3300,49,1,129,0,0,0,0,0,129,0,0,0,0,0,129,100,0,0,0,0,0,0,0,100,0,0,0
47,Tennessee/TN,4703207,"Memphis City (Southeast) PUMA, Tennessee/TN",47157,"Shelby County, Tennessee",937005,30922,455,3300,49,1,148,37,11,0,8,0,148,45,11,8,48,56,204,73,0,4,24,4,18,0,5,73,27,22,5
47,Tennessee/TN,4703208,"Memphis City (Southwest) PUMA, Tennessee/TN",47157,"Shelby County, Tennessee",937005,30922,455,3300,49,1,210,0,0,0,0,0,210,0,0,0,0,0,210,100,0,0,0,0,0,0,0,100,0,0,0
48,Texas/TX,4800100,"Panhandle Regional Planning Commission (Outside Potter & Randall Counties) PUMA, Texas/TX",48011,"Armstrong County, Texas",1916,13,1,678,52,0.01,19,7,31,19,0,2,38,7,33,2,38,40,78,24,24,3,49,0,9,3,40,49,51,9,42
48,Texas/TX,4800100,"Panhandle Regional Planning Commission (Outside Potter & Randall Counties) PUMA, Texas/TX",48045,"Briscoe County, Texas",1546,12,1,776,65,0.008,15,5,25,15,0,1,30,5,26,1,30,31,61,25,25,2,49,0,8,2,41,49,51,8,43
48,Texas/TX,4800100,"Panhandle Regional Planning Commission (Outside Potter & Randall Counties) PUMA, Texas/TX",48065,"Carson County, Texas",6032,21,0,348,0,0.033,63,23,103,63,2,6,126,25,109,8,126,134,260,24,24,3,48,1,9,2,40,48,52,10,42
48,Texas/TX,4800100,"Panhandle Regional Planning Commission (Outside Potter & Randall Counties) PUMA, Texas/TX",48069,"Castro County, Texas",7787,251,5,3223,64,0.042,81,29,132,80,2,7,161,31,139,9,161,170,331,24,24,3,49,1,9,2,40,49,51,9,42
48,Texas/TX,4800100,"Panhandle Regional Planning Commission (Outside Potter & Randall Counties) PUMA, Texas/TX",48075,"Childress County, Texas",7226,68,0,941,0,0.038,73,26,119,72,2,7,145,28,126,9,145,154,299,24,24,3,48,1,9,2,40,48,52,9,42
48,Texas/TX,4800100,"Panhandle Regional Planning Commission (Outside Potter & Randall Counties) PUMA, Texas/TX",48087,"Collingsworth County, Texas",2996,18,0,601,0,0.016,31,11,50,30,1,3,61,12,53,4,61,65,126,25,24,3,48,1,9,2,40,48,52,10,42
48,Texas/TX,4800100,"Panhandle Regional Planning Commission (Outside Potter & Randall Counties) PUMA, Texas/TX",48111,"Dallam County, Texas",7243,246,9,3396,124,0.038,73,26,119,72,2,7,145,28,126,9,145,154,299,24,24,3,48,1,9,2,40,48,52,9,42
48,Texas/TX,4800100,"Panhandle Regional Planning Commission (Outside Potter & Randall Counties) PUMA, Texas/TX",48117,"Deaf Smith County, Texas",18899,1059,21,5603,111,0.102,196,70,320,193,5,18,389,75,338,23,390,413,802,24,24,3,49,1,9,2,40,49,51,9,42
48,Texas/TX,4800100,"Panhandle Regional Planning Commission (Outside Potter & Randall Counties) PUMA, Texas/TX",48129,"Donley County, Texas",3387,61,1,1801,30,0.019,36,13,60,36,1,3,72,14,63,4,73,77,149,24,24,3,49,1,9,2,40,48,52,9,42
48,Texas/TX,4800100,"Panhandle Regional Planning Commission (Outside Potter & Randall Counties) PUMA, Texas/TX",48179,"Gray County, Texas",22685,295,6,1300,26,0.124,238,85,389,235,6,22,473,91,411,28,474,502,975,24,24,3,49,1,9,2,40,49,51,9,42
48,Texas/TX,4800100,"Panhandle Regional Planning Commission (Outside Potter & Randall Counties) PUMA, Texas/TX",48191,"Hall County, Texas",3074,28,1,911,33,0.017,33,12,53,32,1,3,65,13,56,4,65,69,134,25,24,3,49,1,9,2,40,49,51,10,42
48,Texas/TX,4800100,"Panhandle Regional Planning Commission (Outside Potter & Randall Counties) PUMA, Texas/TX",48195,"Hansford County, Texas",5547,112,4,2019,72,0.03,58,21,94,57,1,5,115,22,99,6,115,121,236,25,24,3,49,0,9,2,40,49,51,9,42
48,Texas/TX,4800100,"Panhandle Regional Planning Commission (Outside Potter & Randall Counties) PUMA, Texas/TX",48205,"Hartley County, Texas",5767,129,2,2237,35,0.031,60,21,97,59,1,5,119,22,102,6,118,124,243,25,24,2,49,0,9,2,40,49,51,9,42
48,Texas/TX,4800100,"Panhandle Regional Planning Commission (Outside Potter & Randall Counties) PUMA, Texas/TX",48211,"Hemphill County, Texas",4061,73,0,1798,0,0.022,42,15,69,42,1,4,84,16,73,5,84,89,173,24,24,3,49,1,9,2,40,49,51,9,42
48,Texas/TX,4800100,"Panhandle Regional Planning Commission (Outside Potter & Randall Counties) PUMA, Texas/TX",48233,"Hutchinson County, Texas",21571,202,4,936,19,0.117,225,80,367,222,5,20,447,85,387,25,447,472,919,24,24,3,49,1,9,2,40,49,51,9,42
48,Texas/TX,4800100,"Panhandle Regional Planning Commission (Outside Potter & Randall Counties) PUMA, Texas/TX",48295,"Lipscomb County, Texas",3469,32,0,922,0,0.019,36,13,60,36,1,3,72,14,63,4,73,77,149,24,24,3,49,1,9,2,40,48,52,9,42
48,Texas/TX,4800100,"Panhandle Regional Planning Commission (Outside Potter & Randall Counties) PUMA, Texas/TX",48341,"Moore County, Texas",21801,1159,20,5316,92,0.12,230,82,376,228,6,21,458,88,397,27,458,485,943,24,24,3,49,1,9,2,40,49,51,9,42
48,Texas/TX,4800100,"Panhandle Regional Planning Commission (Outside Potter & Randall Counties) PUMA, Texas/TX",48357,"Ochiltree County, Texas",10348,133,5,1285,48,0.056,108,38,176,106,3,10,214,41,186,13,214,227,441,24,24,3,49,1,9,2,40,49,51,9,42
48,Texas/TX,4800100,"Panhandle Regional Planning Commission (Outside Potter & Randall Counties) PUMA, Texas/TX",48359,"Oldham County, Texas",2090,17,1,813,48,0.011,21,8,34,21,1,2,42,9,36,3,42,45,87,24,24,3,48,1,9,2,39,48,52,10,41
48,Texas/TX,4800100,"Panhandle Regional Planning Commission (Outside Potter & Randall Counties) PUMA, Texas/TX",48369,"Parmer County, Texas",9852,422,7,4283,71,0.053,102,36,166,101,2,9,203,38,175,11,202,213,416,25,24,3,49,0,9,2,40,49,51,9,42
48,Texas/TX,4800100,"Panhandle Regional Planning Commission (Outside Potter & Randall Counties) PUMA, Texas/TX",48393,"Roberts County, Texas",885,9,0,1017,0,0.005,10,3,16,9,0,1,19,3,17,1,19,20,39,26,23,3,49,0,8,3,41,49,51,8,44
48,Texas/TX,4800100,"Panhandle Regional Planning Commission (Outside Potter & Randall Counties) PUMA, Texas/TX",48421,"Sherman County, Texas",3058,62,0,2027,0,0.017,33,12,53,32,1,3,65,13,56,4,65,69,134,25,24,3,49,1,9,2,40,49,51,10,42
48,Texas/TX,4800100,"Panhandle Regional Planning Commission (Outside Potter & Randall Counties) PUMA, Texas/TX",48437,"Swisher County, Texas",7484,104,3,1390,40,0.041,79,28,128,78,2,7,157,30,135,9,156,165,322,25,24,3,48,1,9,2,40,49,51,9,42
48,Texas/TX,4800100,"Panhandle Regional Planning Commission (Outside Potter & Randall Counties) PUMA, Texas/TX",48483,"Wheeler County, Texas",5482,47,0,857,0,0.03,58,21,94,57,1,5,115,22,99,6,115,121,236,25,24,3,49,0,9,2,40,49,51,9,42
48,Texas/TX,4800200,"Panhandle Regional Planning Commission--Potter County--Amarillo City (North) PUMA, Texas/TX",48375,"Potter County, Texas",120899,4780,63,3954,52,1,387,159,442,664,431,1448,1051,590,1890,1879,601,2480,3531,11,19,53,17,12,5,41,13,30,70,17,54
48,Texas/TX,4800300,"Panhandle Regional Planning Commission--Randall County--Amarillo City (South) PUMA, Texas/TX",48381,"Randall County, Texas",132475,2833,40,2139,30,1,260,0,26,301,73,63,561,73,89,136,26,162,723,36,42,19,4,10,0,9,4,78,22,10,12
48,Texas/TX,4800400,"South Plains Association of Governments (Outside Lubbock County) PUMA, Texas/TX",48017,"Bailey County, Texas",7092,217,5,3060,71,0.055,43,19,82,76,2,10,119,21,92,12,101,113,232,19,33,5,44,1,8,4,35,51,49,9,40
48,Texas/TX,4800400,"South Plains Association of Governments (Outside Lubbock County) PUMA, Texas/TX",48079,"Cochran County, Texas",2904,50,1,1722,34,0.022,17,7,33,31,1,4,48,8,37,5,40,45,93,18,33,5,43,1,8,4,35,52,48,9,40
48,Texas/TX,4800400,"South Plains Association of Governments (Outside Lubbock County) PUMA, Texas/TX",48107,"Crosby County, Texas",5861,86,3,1467,51,0.046,36,16,69,64,2,8,100,18,77,10,85,95,195,18,33,5,44,1,8,4,35,51,49,9,39
48,Texas/TX,4800400,"South Plains Association of Governments (Outside Lubbock County) PUMA, Texas/TX",48125,"Dickens County, Texas",2216,48,2,2166,90,0.017,13,6,25,24,1,3,37,7,28,4,31,35,72,18,33,6,43,1,8,4,35,51,49,10,39
48,Texas/TX,4800400,"South Plains Association of Governments (Outside Lubbock County) PUMA, Texas/TX",48153,"Floyd County, Texas",5872,106,9,1805,153,0.046,36,16,69,64,2,8,100,18,77,10,85,95,195,18,33,5,44,1,8,4,35,51,49,9,39
48,Texas/TX,4800400,"South Plains Association of Governments (Outside Lubbock County) PUMA, Texas/TX",48169,"Garza County, Texas",6288,103,4,1638,64,0.05,39,17,75,69,2,9,108,19,84,11,92,103,211,18,33,5,44,1,8,4,36,51,49,9,40
48,Texas/TX,4800400,"South Plains Association of Governments (Outside Lubbock County) PUMA, Texas/TX",48189,"Hale County, Texas",34113,1865,58,5467,170,0.264,205,89,394,367,10,46,572,99,440,56,483,539,1111,18,33,5,43,1,8,4,35,51,49,9,40
48,Texas/TX,4800400,"South Plains Association of Governments (Outside Lubbock County) PUMA, Texas/TX",48219,"Hockley County, Texas",23162,342,8,1477,35,0.179,139,61,267,249,6,31,388,67,298,37,328,365,753,18,33,5,44,1,8,4,35,52,48,9,40
48,Texas/TX,4800400,"South Plains Association of Governments (Outside Lubbock County) PUMA, Texas/TX",48279,"Lamb County, Texas",13262,333,21,2511,158,0.102,79,34,152,142,4,18,221,38,170,22,186,208,429,18,33,5,43,1,8,4,35,52,48,9,40
48,Texas/TX,4800400,"South Plains Association of Governments (Outside Lubbock County) PUMA, Texas/TX",48305,"Lynn County, Texas",5808,93,5,1601,86,0.044,34,15,66,61,2,8,95,17,74,10,81,91,186,18,33,5,44,1,8,4,35,51,49,9,40
48,Texas/TX,4800400,"South Plains Association of Governments (Outside Lubbock County) PUMA, Texas/TX",48345,"Motley County, Texas",1156,8,0,692,0,0.009,7,3,13,13,0,2,20,3,15,2,16,18,38,18,34,5,42,0,8,5,34,53,47,8,39
48,Texas/TX,4800400,"South Plains Association of Governments (Outside Lubbock County) PUMA, Texas/TX",48445,"Terry County, Texas",12615,237,4,1879,32,0.099,77,33,148,138,4,17,215,37,165,21,181,202,417,18,33,5,43,1,8,4,35,52,48,9,40
48,Texas/TX,4800400,"South Plains Association of Governments (Outside Lubbock County) PUMA, Texas/TX",48501,"Yoakum County, Texas",8571,213,5,2485,58,0.065,51,22,97,90,2,11,141,24,108,13,119,132,273,19,33,5,44,1,8,4,36,52,48,9,40
48,Texas/TX,4800400,"South Plains Association of Governments (Outside Lubbock County) PUMA, Texas/TX",48269,"King County, Texas",228,NA,NA,NA,NA,0.002,2,1,3,3,0,0,5,1,3,0,4,4,9,22,33,0,44,0,11,0,33,56,44,11,33
48,Texas/TX,4800501,"South Plains Association of Governments--Lubbock County--Lubbock City (Central) PUMA, Texas/TX",48303,"Lubbock County, Texas",301454,11241,124,3729,41,1,147,0,61,274,31,0,421,31,61,31,61,92,513,29,53,6,12,6,0,0,12,82,18,6,12
48,Texas/TX,4800502,"South Plains Association of Governments--Lubbock County--Lubbock City (Outer) PUMA, Texas/TX",48303,"Lubbock County, Texas",301454,11241,124,3729,41,1,388,0,70,102,0,29,490,0,99,29,70,99,589,66,17,5,12,0,0,5,12,83,17,0,17
48,Texas/TX,4800600,"North Texas Regional Planning Commission (Outside Wichita County) & Wise County PUMA, Texas/TX",48009,"Archer County, Texas",8789,82,1,933,11,0.057,39,6,15,11,0,3,50,6,18,3,21,24,74,53,15,4,28,0,8,4,20,68,32,8,24
48,Texas/TX,4800600,"North Texas Regional Planning Commission (Outside Wichita County) & Wise County PUMA, Texas/TX",48023,"Baylor County, Texas",3591,17,1,473,28,0.024,16,3,6,5,0,1,21,3,7,1,9,10,31,52,16,3,29,0,10,3,19,68,32,10,23
48,Texas/TX,4800600,"North Texas Regional Planning Commission (Outside Wichita County) & Wise County PUMA, Texas/TX",48077,"Clay County, Texas",10387,86,2,828,19,0.067,46,7,17,13,0,4,59,7,21,4,24,28,87,53,15,5,28,0,8,5,20,68,32,8,24
48,Texas/TX,4800600,"North Texas Regional Planning Commission (Outside Wichita County) & Wise County PUMA, Texas/TX",48101,"Cottle County, Texas",1623,25,3,1540,185,0.009,6,1,2,2,0,0,8,1,2,0,3,3,11,55,18,0,27,0,9,0,18,73,27,9,18
48,Texas/TX,4800600,"North Texas Regional Planning Commission (Outside Wichita County) & Wise County PUMA, Texas/TX",48155,"Foard County, Texas",1408,9,0,639,0,0.008,5,1,2,2,0,0,7,1,2,0,3,3,10,50,20,0,30,0,10,0,20,70,30,10,20
48,Texas/TX,4800600,"North Texas Regional Planning Commission (Outside Wichita County) & Wise County PUMA, Texas/TX",48197,"Hardeman County, Texas",3952,25,0,633,0,0.026,18,3,7,5,0,1,23,3,8,1,10,11,34,53,15,3,29,0,9,3,21,68,32,9,24
48,Texas/TX,4800600,"North Texas Regional Planning Commission (Outside Wichita County) & Wise County PUMA, Texas/TX",48237,"Jack County, Texas",8842,131,2,1482,23,0.057,39,6,15,11,0,3,50,6,18,3,21,24,74,53,15,4,28,0,8,4,20,68,32,8,24
48,Texas/TX,4800600,"North Texas Regional Planning Commission (Outside Wichita County) & Wise County PUMA, Texas/TX",48337,"Montague County, Texas",19409,173,4,891,21,0.127,87,14,33,25,0,7,112,14,40,7,47,54,166,52,15,4,28,0,8,4,20,67,33,8,24
48,Texas/TX,4800600,"North Texas Regional Planning Commission (Outside Wichita County) & Wise County PUMA, Texas/TX",48487,"Wilbarger County, Texas",12906,183,2,1418,15,0.084,58,9,22,17,0,5,75,9,27,5,31,36,111,52,15,5,28,0,8,5,20,68,32,8,24
48,Texas/TX,4800600,"North Texas Regional Planning Commission (Outside Wichita County) & Wise County PUMA, Texas/TX",48497,"Wise County, Texas",64639,763,14,1180,22,0.422,289,45,109,84,0,23,373,45,132,23,154,177,550,53,15,4,28,0,8,4,20,68,32,8,24
48,Texas/TX,4800600,"North Texas Regional Planning Commission (Outside Wichita County) & Wise County PUMA, Texas/TX",48503,"Young County, Texas",18114,301,6,1662,33,0.119,82,13,31,24,0,7,106,13,38,7,44,51,157,52,15,4,28,0,8,4,20,68,32,8,24
48,Texas/TX,4800700,"North Texas Regional Planning Commission--Wichita County--Wichita Falls City PUMA, Texas/TX",48485,"Wichita County, Texas",131818,1741,22,1321,17,1,98,35,0,62,0,14,160,35,14,14,35,49,209,47,30,7,17,0,17,7,0,77,23,17,7
48,Texas/TX,4800800,"Texoma COG--Grayson, Cooke & Fannin Counties PUMA, Texas/TX",48097,"Cooke County, Texas",39571,425,5,1074,13,0.195,219,13,47,43,14,48,262,27,95,62,60,122,384,57,11,16,16,4,3,12,12,68,32,7,25
48,Texas/TX,4800800,"Texoma COG--Grayson, Cooke & Fannin Counties PUMA, Texas/TX",48147,"Fannin County, Texas",34175,674,15,1972,44,0.169,189,11,41,37,12,41,226,23,82,53,52,105,331,57,11,16,16,4,3,12,12,68,32,7,25
48,Texas/TX,4800800,"Texoma COG--Grayson, Cooke & Fannin Counties PUMA, Texas/TX",48181,"Grayson County, Texas",128560,1838,39,1430,30,0.636,713,43,153,141,46,155,854,89,308,201,196,397,1251,57,11,16,16,4,3,12,12,68,32,7,25
48,Texas/TX,4800900,"Hunt & Rockwall Counties--Rockwall, Greenville & Dallas (Far Northeast) Cities PUMA, Texas/TX",48231,"Hunt County, Texas",92152,1599,36,1735,39,0.495,127,9,78,26,0,0,153,9,78,0,87,87,240,53,11,0,36,0,4,0,32,64,36,4,32
48,Texas/TX,4800900,"Hunt & Rockwall Counties--Rockwall, Greenville & Dallas (Far Northeast) Cities PUMA, Texas/TX",48397,"Rockwall County, Texas",93642,1610,25,1719,27,0.505,130,9,79,27,0,0,157,9,79,0,88,88,245,53,11,0,36,0,4,0,32,64,36,4,32
48,Texas/TX,4801000,"Ark-Tex COG (West) PUMA, Texas/TX",48119,"Delta County, Texas",5215,24,0,460,0,0.033,62,6,32,9,0,0,71,6,32,0,38,38,109,57,8,0,35,0,6,0,29,65,35,6,29
48,Texas/TX,4801000,"Ark-Tex COG (West) PUMA, Texas/TX",48159,"Franklin County, Texas",10679,134,6,1255,56,0.067,125,12,64,19,1,0,144,13,64,1,76,77,221,57,9,0,34,0,5,0,29,65,35,6,29
48,Texas/TX,4801000,"Ark-Tex COG (West) PUMA, Texas/TX",48223,"Hopkins County, Texas",36240,339,8,935,22,0.228,425,40,218,63,3,1,488,43,219,4,258,262,750,57,8,1,34,0,5,0,29,65,35,6,29
48,Texas/TX,4801000,"Ark-Tex COG (West) PUMA, Texas/TX",48277,"Lamar County, Texas",49532,1118,33,2257,67,0.312,582,55,299,86,4,2,668,59,301,6,354,360,1028,57,8,1,34,0,5,0,29,65,35,6,29
48,Texas/TX,4801000,"Ark-Tex COG (West) PUMA, Texas/TX",48343,"Morris County, Texas",12424,184,3,1481,24,0.079,147,14,76,22,1,0,169,15,76,1,90,91,260,57,8,0,35,0,5,0,29,65,35,6,29
48,Texas/TX,4801000,"Ark-Tex COG (West) PUMA, Texas/TX",48387,"Red River County, Texas",12275,160,14,1303,114,0.077,144,14,74,21,1,0,165,15,74,1,88,89,254,57,8,0,35,0,6,0,29,65,35,6,29
48,Texas/TX,4801000,"Ark-Tex COG (West) PUMA, Texas/TX",48449,"Titus County, Texas",32730,1454,28,4442,86,0.204,380,36,195,57,3,1,437,39,196,4,231,235,672,57,8,1,34,0,5,0,29,65,35,6,29
48,Texas/TX,4801100,"Ark-Tex COG (East)--Bowie & Cass Counties PUMA, Texas/TX",48037,"Bowie County, Texas",93858,1330,71,1417,76,0.756,212,0,2,0,3,0,212,3,2,3,2,5,217,98,0,1,1,1,0,0,1,98,2,1,1
48,Texas/TX,4801100,"Ark-Tex COG (East)--Bowie & Cass Counties PUMA, Texas/TX",48067,"Cass County, Texas",30087,338,15,1123,50,0.244,69,0,1,0,1,0,69,1,1,1,1,2,71,97,0,1,1,1,0,0,1,97,3,1,1
48,Texas/TX,4801200,"East Texas COG (Northeast)--Harrison, Upshur & Marion Counties PUMA, Texas/TX",48203,"Harrison County, Texas",66645,888,35,1332,53,0.566,105,0,124,14,0,0,119,0,124,0,124,124,243,43,6,0,51,0,0,0,51,49,51,0,51
48,Texas/TX,4801200,"East Texas COG (Northeast)--Harrison, Upshur & Marion Counties PUMA, Texas/TX",48315,"Marion County, Texas",10083,150,14,1488,139,0.086,16,0,19,2,0,0,18,0,19,0,19,19,37,43,5,0,51,0,0,0,51,49,51,0,51
48,Texas/TX,4801200,"East Texas COG (Northeast)--Harrison, Upshur & Marion Counties PUMA, Texas/TX",48459,"Upshur County, Texas",40769,384,10,942,25,0.348,64,0,76,8,0,0,72,0,76,0,76,76,148,43,5,0,51,0,0,0,51,49,51,0,51
48,Texas/TX,4801300,"East Texas COG (Northwest)--Van Zandt, Wood, Camp & Rains Counties PUMA, Texas/TX",48063,"Camp County, Texas",12813,351,11,2739,86,0.105,49,10,21,6,2,0,55,12,21,2,31,33,88,56,7,2,35,2,11,0,24,62,38,14,24
48,Texas/TX,4801300,"East Texas COG (Northwest)--Van Zandt, Wood, Camp & Rains Counties PUMA, Texas/TX",48379,"Rains County, Texas",11473,67,3,584,26,0.092,43,9,19,5,2,0,48,11,19,2,28,30,78,55,6,3,36,3,12,0,24,62,38,14,24
48,Texas/TX,4801300,"East Texas COG (Northwest)--Van Zandt, Wood, Camp & Rains Counties PUMA, Texas/TX",48467,"Van Zandt County, Texas",54368,684,26,1258,48,0.443,205,42,89,25,9,0,230,51,89,9,131,140,370,55,7,2,35,2,11,0,24,62,38,14,24
48,Texas/TX,4801300,"East Texas COG (Northwest)--Van Zandt, Wood, Camp & Rains Counties PUMA, Texas/TX",48499,"Wood County, Texas",43815,513,22,1171,50,0.36,166,34,73,20,8,0,186,42,73,8,107,115,301,55,7,3,36,3,11,0,24,62,38,14,24
48,Texas/TX,4801400,"Kaufman County PUMA, Texas/TX",48257,"Kaufman County, Texas",118910,3107,47,2613,40,1,237,57,24,0,0,0,237,57,24,0,81,81,318,75,0,0,25,0,18,0,8,75,25,18,8
48,Texas/TX,4801501,"East Texas COG (Central)--Smith County (Outside Tyler City) PUMA, Texas/TX",48423,"Smith County, Texas",225015,4625,99,2055,44,1,73,0,61,67,0,0,140,0,61,0,61,61,201,36,33,0,30,0,0,0,30,70,30,0,30
48,Texas/TX,4801502,"East Texas COG (Central)--Smith County (West)--Tyler City PUMA, Texas/TX",48423,"Smith County, Texas",225015,4625,99,2055,44,1,288,33,60,44,0,0,332,33,60,0,93,93,425,68,10,0,22,0,8,0,14,78,22,8,14
48,Texas/TX,4801600,"East Texas COG (Central)--Gregg County--Longview City PUMA, Texas/TX",48183,"Gregg County, Texas",123494,2674,63,2165,51,1,152,0,43,15,0,0,167,0,43,0,43,43,210,72,7,0,20,0,0,0,20,80,20,0,20
48,Texas/TX,4801700,"East Texas COG (Southeast)--Rusk, Cherokee & Panola Counties PUMA, Texas/TX",48073,"Cherokee County, Texas",51903,1546,28,2979,54,0.404,165,5,242,14,0,0,179,5,242,0,247,247,426,39,3,0,58,0,1,0,57,42,58,1,57
48,Texas/TX,4801700,"East Texas COG (Southeast)--Rusk, Cherokee & Panola Counties PUMA, Texas/TX",48365,"Panola County, Texas",23440,378,25,1613,107,0.184,75,2,110,6,0,0,81,2,110,0,112,112,193,39,3,0,58,0,1,0,57,42,58,1,57
48,Texas/TX,4801700,"East Texas COG (Southeast)--Rusk, Cherokee & Panola Counties PUMA, Texas/TX",48401,"Rusk County, Texas",53595,914,11,1705,21,0.412,168,5,247,14,0,0,182,5,247,0,252,252,434,39,3,0,58,0,1,0,57,42,58,1,57
48,Texas/TX,4801800,"East Texas COG (Southwest)--Henderson & Anderson Counties PUMA, Texas/TX",48001,"Anderson County, Texas",57863,2825,31,4882,54,0.419,206,17,72,75,0,0,281,17,72,0,89,89,370,56,20,0,24,0,5,0,19,76,24,5,19
48,Texas/TX,4801800,"East Texas COG (Southwest)--Henderson & Anderson Counties PUMA, Texas/TX",48213,"Henderson County, Texas",80460,947,23,1177,29,0.581,286,23,99,105,0,0,391,23,99,0,122,122,513,56,20,0,24,0,4,0,19,76,24,4,19
48,Texas/TX,4801901,"Collin County (Southwest)--Dallas (North), Plano (South) & Richardson (North) Cities PUMA, Texas/TX",48085,"Collin County, Texas",944350,13310,141,1409,15,1,62,30,0,0,0,0,62,30,0,0,30,30,92,67,0,0,33,0,33,0,0,67,33,33,0
48,Texas/TX,4801902,"Collin County (Southwest)--Plano City (West) PUMA, Texas/TX",48085,"Collin County, Texas",944350,13310,141,1409,15,1,0,0,17,67,24,0,67,24,17,24,17,41,108,0,62,22,16,22,0,0,16,62,38,22,16
48,Texas/TX,4801903,"Collin County (Southwest)--Plano City (Central) PUMA, Texas/TX",48085,"Collin County, Texas",944350,13310,141,1409,15,1,0,0,0,21,0,0,21,0,0,0,0,0,21,0,100,0,0,0,0,0,0,100,0,0,0
48,Texas/TX,4801904,"Collin County (South Central)--Allen, Murphy, Plano (East) & Parker Cities PUMA, Texas/TX",48085,"Collin County, Texas",944350,13310,141,1409,15,1,40,0,0,0,159,45,40,159,45,204,0,204,244,16,0,84,0,65,0,18,0,16,84,65,18
48,Texas/TX,4801905,"Collin County (Central)--McKinney City PUMA, Texas/TX",48085,"Collin County, Texas",944350,13310,141,1409,15,1,26,0,0,25,0,0,51,0,0,0,0,0,51,51,49,0,0,0,0,0,0,100,0,0,0
48,Texas/TX,4801906,"Collin County (Northwest)--Frisco City (East) & Prosper Town PUMA, Texas/TX",48085,"Collin County, Texas",944350,13310,141,1409,15,1,59,0,72,0,23,0,59,23,72,23,72,95,154,38,0,15,47,15,0,0,47,38,62,15,47
48,Texas/TX,4801907,"Collin County (East) PUMA, Texas/TX",48085,"Collin County, Texas",944350,13310,141,1409,15,1,136,0,41,57,0,0,193,0,41,0,41,41,234,58,24,0,18,0,0,0,18,82,18,0,18
48,Texas/TX,4802001,"Denton County (Far Southeast)--Carrollton (North) & Dallas (North) Cities PUMA, Texas/TX",48121,"Denton County, Texas",807047,11950,152,1481,19,1,12,59,21,12,0,10,24,59,31,10,80,90,114,11,11,9,70,0,52,9,18,21,79,52,27
48,Texas/TX,4802002,"Denton County (Southeast)--Lewisville City PUMA, Texas/TX",48121,"Denton County, Texas",807047,11950,152,1481,19,1,52,96,89,51,32,35,103,128,124,67,185,252,355,15,14,19,52,9,27,10,25,29,71,36,35
48,Texas/TX,4802003,"Denton County (South Central)--Flower Mound Town & Highland Village City PUMA, Texas/TX",48121,"Denton County, Texas",807047,11950,152,1481,19,1,119,0,0,0,0,0,119,0,0,0,0,0,119,100,0,0,0,0,0,0,0,100,0,0,0
48,Texas/TX,4802004,"Denton County (East Central)--Frisco (West), The Colony & Little Elm Cities PUMA, Texas/TX",48121,"Denton County, Texas",807047,11950,152,1481,19,1,10,0,0,24,0,0,34,0,0,0,0,0,34,29,71,0,0,0,0,0,0,100,0,0,0
48,Texas/TX,4802005,"Denton County (Central)--Denton (Central) & Corinth Cities PUMA, Texas/TX",48121,"Denton County, Texas",807047,11950,152,1481,19,1,154,89,92,64,8,8,218,97,100,16,181,197,415,37,15,4,44,2,21,2,22,53,47,23,24
48,Texas/TX,4802006,"Denton County (North & West)--Denton City (Outer) PUMA, Texas/TX",48121,"Denton County, Texas",807047,11950,152,1481,19,1,155,0,0,24,25,0,179,25,0,25,0,25,204,76,12,12,0,12,0,0,0,88,12,12,0
48,Texas/TX,4802101,"Ellis County PUMA, Texas/TX",48139,"Ellis County, Texas",168838,4328,68,2563,40,1,228,13,43,86,0,100,314,13,143,100,56,156,470,49,18,21,12,0,3,21,9,67,33,3,30
48,Texas/TX,4802102,"Johnson County PUMA, Texas/TX",48251,"Johnson County, Texas",163475,2958,49,1809,30,1,326,0,6,158,0,142,484,0,148,142,6,148,632,52,25,22,1,0,0,22,1,77,23,0,23
48,Texas/TX,4802200,"North Central Texas COG (West)--Hood, Erath, Palo Pinto & Somervell Counties PUMA, Texas/TX",48143,"Erath County, Texas",41482,840,12,2025,29,0.308,270,7,79,59,6,0,329,13,79,6,86,92,421,64,14,1,20,1,2,0,19,78,22,3,19
48,Texas/TX,4802200,"North Central Texas COG (West)--Hood, Erath, Palo Pinto & Somervell Counties PUMA, Texas/TX",48221,"Hood County, Texas",56901,935,27,1643,47,0.42,369,10,108,80,9,0,449,19,108,9,118,127,576,64,14,2,20,2,2,0,19,78,22,3,19
48,Texas/TX,4802200,"North Central Texas COG (West)--Hood, Erath, Palo Pinto & Somervell Counties PUMA, Texas/TX",48363,"Palo Pinto County, Texas",28317,545,15,1925,53,0.207,182,5,53,40,4,0,222,9,53,4,58,62,284,64,14,1,20,1,2,0,19,78,22,3,19
48,Texas/TX,4802200,"North Central Texas COG (West)--Hood, Erath, Palo Pinto & Somervell Counties PUMA, Texas/TX",48425,"Somervell County, Texas",8743,140,5,1601,57,0.065,57,2,17,12,1,0,69,3,17,1,19,20,89,64,13,1,21,1,2,0,19,78,22,3,19
48,Texas/TX,4802301,"Dallas County (Northeast)--Rowlett & Garland (Northeast) Cities PUMA, Texas/TX",48113,"Dallas County, Texas",2586552,83304,1115,3221,43,1,34,0,27,0,27,0,34,27,27,27,27,54,88,39,0,31,31,31,0,0,31,39,61,31,31
48,Texas/TX,4802302,"Dallas County (Northeast)--Garland City (South) PUMA, Texas/TX",48113,"Dallas County, Texas",2586552,83304,1115,3221,43,1,33,0,194,13,0,36,46,0,230,36,194,230,276,12,5,13,70,0,0,13,70,17,83,0,83
48,Texas/TX,4802303,"Dallas County (East)--Mesquite City (Central & Southeast) PUMA, Texas/TX",48113,"Dallas County, Texas",2586552,83304,1115,3221,43,1,54,32,16,14,0,0,68,32,16,0,48,48,116,47,12,0,41,0,28,0,14,59,41,28,14
48,Texas/TX,4802304,"Dallas County (Southeast)--Dallas City (Southeast) PUMA, Texas/TX",48113,"Dallas County, Texas",2586552,83304,1115,3221,43,1,90,37,22,41,0,0,131,37,22,0,59,59,190,47,22,0,31,0,19,0,12,69,31,19,12
48,Texas/TX,4802305,"Dallas (East) & Mesquite (West) Cities--South of I-30 & West of I-635 PUMA, Texas/TX",48113,"Dallas County, Texas",2586552,83304,1115,3221,43,1,130,89,90,154,0,0,284,89,90,0,179,179,463,28,33,0,39,0,19,0,19,61,39,19,19
48,Texas/TX,4802306,"Dallas (Northeast) & Mesquite (North) Cities--North of I-30 & West of I-635 PUMA, Texas/TX",48113,"Dallas County, Texas",2586552,83304,1115,3221,43,1,24,133,198,19,37,20,43,170,218,57,331,388,431,6,4,13,77,9,31,5,46,10,90,39,51
48,Texas/TX,4802307,"Dallas City (Northeast)--East of US-75 PUMA, Texas/TX",48113,"Dallas County, Texas",2586552,83304,1115,3221,43,1,13,13,218,79,56,298,92,69,516,354,231,585,677,2,12,52,34,8,2,44,32,14,86,10,76
48,Texas/TX,4802308,"Dallas County (Northeast)--Garland (Northwest) & Richardson (East) Cities PUMA, Texas/TX",48113,"Dallas County, Texas",2586552,83304,1115,3221,43,1,8,0,18,0,0,206,8,0,224,206,18,224,232,3,0,89,8,0,0,89,8,3,97,0,97
48,Texas/TX,4802309,"Dallas (Far North) & Richardson (Southwest) Cities PUMA, Texas/TX",48113,"Dallas County, Texas",2586552,83304,1115,3221,43,1,53,30,49,0,60,24,53,90,73,84,79,163,216,25,0,39,37,28,14,11,23,25,75,42,34
48,Texas/TX,4802310,"Dallas (Far North), Carrollton (Southeast) Cities & Addison Town--North of I-635 PUMA, Texas/TX",48113,"Dallas County, Texas",2586552,83304,1115,3221,43,1,104,18,170,25,0,62,129,18,232,62,188,250,379,27,7,16,50,0,5,16,45,34,66,5,61
48,Texas/TX,4802311,"Dallas City (North)--South of I-635 & West of US-75 PUMA, Texas/TX",48113,"Dallas County, Texas",2586552,83304,1115,3221,43,1,68,0,216,19,0,0,87,0,216,0,216,216,303,22,6,0,71,0,0,0,71,29,71,0,71
48,Texas/TX,4802312,"Dallas (West Central), University Park Cities & Highland Park Town PUMA, Texas/TX",48113,"Dallas County, Texas",2586552,83304,1115,3221,43,1,87,0,297,0,0,0,87,0,297,0,297,297,384,23,0,0,77,0,0,0,77,23,77,0,77
48,Texas/TX,4802313,"Dallas City (Downtown)--North of I-30 PUMA, Texas/TX",48113,"Dallas County, Texas",2586552,83304,1115,3221,43,1,13,0,304,0,0,0,13,0,304,0,304,304,317,4,0,0,96,0,0,0,96,4,96,0,96
48,Texas/TX,4802314,"Dallas City (East Central)--South of I-30 & East of I-35E PUMA, Texas/TX",48113,"Dallas County, Texas",2586552,83304,1115,3221,43,1,151,35,256,88,0,0,239,35,256,0,291,291,530,28,17,0,55,0,7,0,48,45,55,7,48
48,Texas/TX,4802315,"Dallas City (West Central)--East of Loop TX-12 & West of I-35E PUMA, Texas/TX",48113,"Dallas County, Texas",2586552,83304,1115,3221,43,1,50,62,286,78,0,0,128,62,286,0,348,348,476,11,16,0,73,0,13,0,60,27,73,13,60
48,Texas/TX,4802316,"Dallas City (South Central)--North of I-20 & West of I-35E PUMA, Texas/TX",48113,"Dallas County, Texas",2586552,83304,1115,3221,43,1,74,17,293,89,0,0,163,17,293,0,310,310,473,16,19,0,66,0,4,0,62,34,66,4,62
48,Texas/TX,4802317,"Dallas County (South)--DeSoto & Lancaster Cities PUMA, Texas/TX",48113,"Dallas County, Texas",2586552,83304,1115,3221,43,1,131,25,83,121,0,0,252,25,83,0,108,108,360,36,34,0,30,0,7,0,23,70,30,7,23
48,Texas/TX,4802318,"Dallas County (Southwest)--Cedar Hill & Duncanville Cities PUMA, Texas/TX",48113,"Dallas County, Texas",2586552,83304,1115,3221,43,1,118,37,78,65,34,0,183,71,78,34,115,149,332,36,20,10,35,10,11,0,23,55,45,21,23
48,Texas/TX,4802319,"Dallas County (West)--Grand Prairie (Central) & Dallas (Southwest) Cities PUMA, Texas/TX",48113,"Dallas County, Texas",2586552,83304,1115,3221,43,1,84,42,36,126,0,0,210,42,36,0,78,78,288,29,44,0,27,0,15,0,12,73,27,15,12
48,Texas/TX,4802320,"Dallas County (West)--Irving (South) & Grand Prairie (North) Cities PUMA, Texas/TX",48113,"Dallas County, Texas",2586552,83304,1115,3221,43,1,19,39,185,144,0,0,163,39,185,0,224,224,387,5,37,0,58,0,10,0,48,42,58,10,48
48,Texas/TX,4802321,"Dallas County (Northwest)--Irving (Central) & Dallas (Northwest) Cities PUMA, Texas/TX",48113,"Dallas County, Texas",2586552,83304,1115,3221,43,1,27,55,173,23,0,12,50,55,185,12,228,240,290,9,8,4,79,0,19,4,60,17,83,19,64
48,Texas/TX,4802322,"Dallas County (Northwest)--Irving (North), Coppell & Carrollton (Southwest) Cities PUMA, Texas/TX",48113,"Dallas County, Texas",2586552,83304,1115,3221,43,1,26,38,0,39,18,12,65,56,12,30,38,68,133,20,29,23,29,14,29,9,0,49,51,42,9
48,Texas/TX,4802400,"Parker County PUMA, Texas/TX",48367,"Parker County, Texas",129802,1940,32,1495,25,1,458,27,125,22,0,0,480,27,125,0,152,152,632,72,3,0,24,0,4,0,20,76,24,4,20
48,Texas/TX,4802501,"Tarrant County (Northeast)--Grapevine, Southlake & Colleyville Cities PUMA, Texas/TX",48439,"Tarrant County, Texas",2019977,48897,701,2421,35,1,33,0,0,30,0,0,63,0,0,0,0,0,63,52,48,0,0,0,0,0,0,100,0,0,0
48,Texas/TX,4802502,"Tarrant County (East)--Euless (South & West) & Arlington (North) Cities PUMA, Texas/TX",48439,"Tarrant County, Texas",2019977,48897,701,2421,35,1,79,0,0,0,0,0,79,0,0,0,0,0,79,100,0,0,0,0,0,0,0,100,0,0,0
48,Texas/TX,4802503,"Tarrant County (East)--Arlington (East) & Grand Prairie (West Central) Cities PUMA, Texas/TX",48439,"Tarrant County, Texas",2019977,48897,701,2421,35,1,125,45,88,92,111,0,217,156,88,111,133,244,461,27,20,24,29,24,10,0,19,47,53,34,19
48,Texas/TX,4802504,"Tarrant County (Southeast)--Arlington (Southeast) & Grand Prairie (Southwest) Cities PUMA, Texas/TX",48439,"Tarrant County, Texas",2019977,48897,701,2421,35,1,27,13,68,0,36,0,27,49,68,36,81,117,144,19,0,25,56,25,9,0,47,19,81,34,47
48,Texas/TX,4802505,"Tarrant County (Southeast)--Mansfield (North) & Arlington (Southwest) Cities PUMA, Texas/TX",48439,"Tarrant County, Texas",2019977,48897,701,2421,35,1,72,0,37,0,0,0,72,0,37,0,37,37,109,66,0,0,34,0,0,0,34,66,34,0,34
48,Texas/TX,4802506,"Tarrant County (South Central)--Fort Worth City (Southeast)--South of I-20 PUMA, Texas/TX",48439,"Tarrant County, Texas",2019977,48897,701,2421,35,1,207,46,178,62,19,0,269,65,178,19,224,243,512,40,12,4,44,4,9,0,35,53,47,13,35
48,Texas/TX,4802507,"Tarrant County (East)--Arlington City (West)--South of I-30 & East of Loop I-820 PUMA, Texas/TX",48439,"Tarrant County, Texas",2019977,48897,701,2421,35,1,114,9,0,0,0,0,114,9,0,0,9,9,123,93,0,0,7,0,7,0,0,93,7,7,0
48,Texas/TX,4802508,"Fort Worth City (East Central)--South of I-30, East of I-35W & Inside Loop I-820 PUMA, Texas/TX",48439,"Tarrant County, Texas",2019977,48897,701,2421,35,1,71,63,291,45,0,68,116,63,359,68,354,422,538,13,8,13,66,0,12,13,54,22,78,12,67
48,Texas/TX,4802509,"Fort Worth (Northeast) & Hurst (South) Cities--North of I-30 PUMA, Texas/TX",48439,"Tarrant County, Texas",2019977,48897,701,2421,35,1,59,191,89,42,0,136,101,191,225,136,280,416,517,11,8,26,54,0,37,26,17,20,80,37,44
48,Texas/TX,4802510,"Tarrant County (North)--North Richland Hills (North) & Keller Cities PUMA, Texas/TX",48439,"Tarrant County, Texas",2019977,48897,701,2421,35,1,24,0,64,45,0,0,69,0,64,0,64,64,133,18,34,0,48,0,0,0,48,52,48,0,48
48,Texas/TX,4802511,"Fort Worth City (North)--East of I-35W & West of US-377 PUMA, Texas/TX",48439,"Tarrant County, Texas",2019977,48897,701,2421,35,1,167,35,0,30,34,0,197,69,0,34,35,69,266,63,11,13,13,13,13,0,0,74,26,26,0
48,Texas/TX,4802512,"Fort Worth City (North Central) & Haltom City (North)--Inside Loop I-820 PUMA, Texas/TX",48439,"Tarrant County, Texas",2019977,48897,701,2421,35,1,77,289,583,292,19,0,369,308,583,19,872,891,1260,6,23,2,69,2,23,0,46,29,71,24,46
48,Texas/TX,4802513,"Fort Worth City (South Central) & Edgecliff Village Town PUMA, Texas/TX",48439,"Tarrant County, Texas",2019977,48897,701,2421,35,1,95,78,80,32,18,61,127,96,141,79,158,237,364,26,9,22,43,5,21,17,22,35,65,26,39
48,Texas/TX,4802514,"Tarrant County (Southwest)--Fort Worth (Southwest) & Benbrook Cities PUMA, Texas/TX",48439,"Tarrant County, Texas",2019977,48897,701,2421,35,1,47,0,45,11,0,92,58,0,137,92,45,137,195,24,6,47,23,0,0,47,23,30,70,0,70
48,Texas/TX,4802515,"Tarrant County (West)--Fort Worth City (West) PUMA, Texas/TX",48439,"Tarrant County, Texas",2019977,48897,701,2421,35,1,118,70,74,100,0,0,218,70,74,0,144,144,362,33,28,0,40,0,19,0,20,60,40,19,20
48,Texas/TX,4802516,"Tarrant County (Northwest)--Fort Worth (Northwest) & Saginaw Cities PUMA, Texas/TX",48439,"Tarrant County, Texas",2019977,48897,701,2421,35,1,94,0,101,0,0,0,94,0,101,0,101,101,195,48,0,0,52,0,0,0,52,48,52,0,52
48,Texas/TX,4802600,"West Central Texas COG (Outside Taylor County) PUMA, Texas/TX",48049,"Brown County, Texas",37834,815,30,2154,79,0.197,217,26,92,53,3,6,270,29,98,9,118,127,397,55,13,2,30,1,7,2,23,68,32,7,25
48,Texas/TX,4802600,"West Central Texas COG (Outside Taylor County) PUMA, Texas/TX",48059,"Callahan County, Texas",13770,87,3,632,22,0.071,78,9,33,19,1,2,97,10,35,3,42,45,142,55,13,2,30,1,6,1,23,68,32,7,25
48,Texas/TX,4802600,"West Central Texas COG (Outside Taylor County) PUMA, Texas/TX",48083,"Coleman County, Texas",8391,70,4,834,48,0.043,47,6,20,12,1,1,59,7,21,2,26,28,87,54,14,2,30,1,7,1,23,68,32,8,24
48,Texas/TX,4802600,"West Central Texas COG (Outside Taylor County) PUMA, Texas/TX",48093,"Comanche County, Texas",13495,300,3,2223,22,0.069,76,9,32,19,1,2,95,10,34,3,41,44,139,55,14,2,29,1,6,1,23,68,32,7,24
48,Texas/TX,4802600,"West Central Texas COG (Outside Taylor County) PUMA, Texas/TX",48133,"Eastland County, Texas",18270,171,3,936,16,0.094,104,13,44,25,1,3,129,14,47,4,57,61,190,55,13,2,30,1,7,2,23,68,32,7,25
48,Texas/TX,4802600,"West Central Texas COG (Outside Taylor County) PUMA, Texas/TX",48151,"Fisher County, Texas",3883,66,3,1700,77,0.02,22,3,9,5,0,1,27,3,10,1,12,13,40,55,12,2,30,0,8,2,22,68,32,8,25
48,Texas/TX,4802600,"West Central Texas COG (Outside Taylor County) PUMA, Texas/TX",48207,"Haskell County, Texas",5809,62,2,1067,34,0.029,32,4,14,8,0,1,40,4,15,1,18,19,59,54,14,2,31,0,7,2,24,68,32,7,25
48,Texas/TX,4802600,"West Central Texas COG (Outside Taylor County) PUMA, Texas/TX",48253,"Jones County, Texas",19891,583,0,2931,0,0.103,114,14,48,28,1,3,142,15,51,4,62,66,208,55,13,2,30,0,7,1,23,68,32,7,25
48,Texas/TX,4802600,"West Central Texas COG (Outside Taylor County) PUMA, Texas/TX",48263,"Kent County, Texas",749,9,0,1202,0,0.004,4,1,2,1,0,0,5,1,2,0,3,3,8,50,12,0,38,0,12,0,25,62,38,12,25
48,Texas/TX,4802600,"West Central Texas COG (Outside Taylor County) PUMA, Texas/TX",48275,"Knox County, Texas",3733,67,8,1795,214,0.02,22,3,9,5,0,1,27,3,10,1,12,13,40,55,12,2,30,0,8,2,22,68,32,8,25
48,Texas/TX,4802600,"West Central Texas COG (Outside Taylor County) PUMA, Texas/TX",48335,"Mitchell County, Texas",8558,87,1,1017,12,0.045,50,6,21,12,1,1,62,7,22,2,27,29,91,55,13,2,30,1,7,1,23,68,32,8,24
48,Texas/TX,4802600,"West Central Texas COG (Outside Taylor County) PUMA, Texas/TX",48353,"Nolan County, Texas",14966,226,5,1510,33,0.077,85,10,36,21,1,2,106,11,38,3,46,49,155,55,14,2,30,1,6,1,23,68,32,7,25
48,Texas/TX,4802600,"West Central Texas COG (Outside Taylor County) PUMA, Texas/TX",48399,"Runnels County, Texas",10310,263,5,2551,48,0.054,60,7,25,15,1,2,75,8,27,3,32,35,110,55,14,3,29,1,6,2,23,68,32,7,25
48,Texas/TX,4802600,"West Central Texas COG (Outside Taylor County) PUMA, Texas/TX",48415,"Scurry County, Texas",17239,646,3,3747,17,0.089,98,12,42,24,1,3,122,13,45,4,54,58,180,54,13,2,30,1,7,2,23,68,32,7,25
48,Texas/TX,4802600,"West Central Texas COG (Outside Taylor County) PUMA, Texas/TX",48417,"Shackelford County, Texas",3311,25,0,755,0,0.017,19,2,8,5,0,1,24,2,9,1,10,11,35,54,14,3,29,0,6,3,23,69,31,6,26
48,Texas/TX,4802600,"West Central Texas COG (Outside Taylor County) PUMA, Texas/TX",48429,"Stephens County, Texas",9372,132,4,1408,43,0.051,56,7,24,14,1,2,70,8,26,3,31,34,104,54,13,3,30,1,7,2,23,67,33,8,25
48,Texas/TX,4802600,"West Central Texas COG (Outside Taylor County) PUMA, Texas/TX",48433,"Stonewall County, Texas",1385,14,1,1011,72,0.007,8,1,3,2,0,0,10,1,3,0,4,4,14,57,14,0,29,0,7,0,21,71,29,7,21
48,Texas/TX,4802600,"West Central Texas COG (Outside Taylor County) PUMA, Texas/TX",48447,"Throckmorton County, Texas",1567,8,2,511,128,0.008,9,1,4,2,0,0,11,1,4,0,5,5,16,56,12,0,31,0,6,0,25,69,31,6,25
48,Texas/TX,4802700,"West Central Texas COG--Taylor County--Abilene City PUMA, Texas/TX",48441,"Taylor County, Texas",136348,3011,54,2208,40,1,281,11,0,44,44,81,325,55,81,125,11,136,461,61,10,27,2,10,2,18,0,70,30,12,18
48,Texas/TX,4802800,"Concho Valley COG & Permian Basin Regional Planning Commission (East) PUMA, Texas/TX",48033,"Borden County, Texas",665,1,0,150,0,0.006,3,1,2,3,0,0,6,1,2,0,3,3,9,33,33,0,33,0,11,0,22,67,33,11,22
48,Texas/TX,4802800,"Concho Valley COG & Permian Basin Regional Planning Commission (East) PUMA, Texas/TX",48081,"Coke County, Texas",3275,52,3,1588,92,0.031,13,3,10,13,0,2,26,3,12,2,13,15,41,32,32,5,32,0,7,5,24,63,37,7,29
48,Texas/TX,4802800,"Concho Valley COG & Permian Basin Regional Planning Commission (East) PUMA, Texas/TX",48095,"Concho County, Texas",4233,129,2,3047,47,0.041,18,4,13,18,0,2,36,4,15,2,17,19,55,33,33,4,31,0,7,4,24,65,35,7,27
48,Texas/TX,4802800,"Concho Valley COG & Permian Basin Regional Planning Commission (East) PUMA, Texas/TX",48105,"Crockett County, Texas",3633,164,6,4514,165,0.035,15,4,11,15,0,2,30,4,13,2,15,17,47,32,32,4,32,0,9,4,23,64,36,9,28
48,Texas/TX,4802800,"Concho Valley COG & Permian Basin Regional Planning Commission (East) PUMA, Texas/TX",48115,"Dawson County, Texas",12964,395,9,3047,69,0.125,54,14,39,54,1,7,108,15,46,8,53,61,169,32,32,5,31,1,8,4,23,64,36,9,27
48,Texas/TX,4802800,"Concho Valley COG & Permian Basin Regional Planning Commission (East) PUMA, Texas/TX",48173,"Glasscock County, Texas",1430,9,0,629,0,0.013,6,1,4,6,0,1,12,1,5,1,5,6,18,33,33,6,28,0,6,6,22,67,33,6,28
48,Texas/TX,4802800,"Concho Valley COG & Permian Basin Regional Planning Commission (East) PUMA, Texas/TX",48227,"Howard County, Texas",36667,722,12,1969,33,0.351,152,38,110,152,2,20,304,40,130,22,148,170,474,32,32,5,31,0,8,4,23,64,36,8,27
48,Texas/TX,4802800,"Concho Valley COG & Permian Basin Regional Planning Commission (East) PUMA, Texas/TX",48235,"Irion County, Texas",1524,10,0,656,0,0.015,6,2,5,6,0,1,12,2,6,1,7,8,20,30,30,5,35,0,10,5,25,60,40,10,30
48,Texas/TX,4802800,"Concho Valley COG & Permian Basin Regional Planning Commission (East) PUMA, Texas/TX",48267,"Kimble County, Texas",4408,16,1,363,23,0.042,18,5,13,18,0,2,36,5,15,2,18,20,56,32,32,4,32,0,9,4,23,64,36,9,27
48,Texas/TX,4802800,"Concho Valley COG & Permian Basin Regional Planning Commission (East) PUMA, Texas/TX",48307,"McCulloch County, Texas",8098,149,3,1840,37,0.078,34,9,24,34,0,4,68,9,28,4,33,37,105,32,32,4,31,0,9,4,23,65,35,9,27
48,Texas/TX,4802800,"Concho Valley COG & Permian Basin Regional Planning Commission (East) PUMA, Texas/TX",48317,"Martin County, Texas",5614,77,6,1372,107,0.055,24,6,17,24,0,3,48,6,20,3,23,26,74,32,32,4,31,0,8,4,23,65,35,8,27
48,Texas/TX,4802800,"Concho Valley COG & Permian Basin Regional Planning Commission (East) PUMA, Texas/TX",48319,"Mason County, Texas",4161,76,2,1826,48,0.039,17,4,12,17,0,2,34,4,14,2,16,18,52,33,33,4,31,0,8,4,23,65,35,8,27
48,Texas/TX,4802800,"Concho Valley COG & Permian Basin Regional Planning Commission (East) PUMA, Texas/TX",48327,"Menard County, Texas",2123,26,0,1225,0,0.02,9,2,6,9,0,1,18,2,7,1,8,9,27,33,33,4,30,0,7,4,22,67,33,7,26
48,Texas/TX,4802800,"Concho Valley COG & Permian Basin Regional Planning Commission (East) PUMA, Texas/TX",48383,"Reagan County, Texas",3752,87,6,2319,160,0.034,15,4,11,15,0,2,30,4,13,2,15,17,47,32,32,4,32,0,9,4,23,64,36,9,28
48,Texas/TX,4802800,"Concho Valley COG & Permian Basin Regional Planning Commission (East) PUMA, Texas/TX",48413,"Schleicher County, Texas",3061,53,2,1731,65,0.029,13,3,9,13,0,2,26,3,11,2,12,14,40,32,32,5,30,0,8,5,22,65,35,8,28
48,Texas/TX,4802800,"Concho Valley COG & Permian Basin Regional Planning Commission (East) PUMA, Texas/TX",48431,"Sterling County, Texas",1141,4,0,351,0,0.013,6,1,4,6,0,1,12,1,5,1,5,6,18,33,33,6,28,0,6,6,22,67,33,6,28
48,Texas/TX,4802800,"Concho Valley COG & Permian Basin Regional Planning Commission (East) PUMA, Texas/TX",48435,"Sutton County, Texas",3865,81,3,2096,78,0.037,16,4,12,16,0,2,32,4,14,2,16,18,50,32,32,4,32,0,8,4,24,64,36,8,28
48,Texas/TX,4802800,"Concho Valley COG & Permian Basin Regional Planning Commission (East) PUMA, Texas/TX",48461,"Upton County, Texas",3634,24,2,660,55,0.035,15,4,11,15,0,2,30,4,13,2,15,17,47,32,32,4,32,0,9,4,23,64,36,9,28
48,Texas/TX,4802900,"Concho Valley COG--Tom Green County--San Angelo City PUMA, Texas/TX",48451,"Tom Green County, Texas",117466,3655,66,3112,56,1,195,19,379,298,0,0,493,19,379,0,398,398,891,22,33,0,45,0,2,0,43,55,45,2,43
48,Texas/TX,4803000,"Permian Basin Regional Planning Commission (Central)--Midland County--Midland City PUMA, Texas/TX",48329,"Midland County, Texas",164194,3707,83,2258,51,1,42,0,72,36,0,0,78,0,72,0,72,72,150,28,24,0,48,0,0,0,48,52,48,0,48
48,Texas/TX,4803100,"Permian Basin Regional Planning Commission (Central)--Ector County--Odessa City PUMA, Texas/TX",48135,"Ector County, Texas",158342,4785,98,3022,62,1,18,8,0,13,0,0,31,8,0,0,8,8,39,46,33,0,21,0,21,0,0,79,21,21,0
48,Texas/TX,4803200,"Rio Grande COG & Permian Basin Regional Planning Commission (West) PUMA, Texas/TX",48003,"Andrews County, Texas",17818,415,8,2329,45,0.149,36,16,44,88,11,7,124,27,51,18,60,78,202,18,44,9,30,5,8,3,22,61,39,13,25
48,Texas/TX,4803200,"Rio Grande COG & Permian Basin Regional Planning Commission (West) PUMA, Texas/TX",48043,"Brewster County, Texas",9216,216,2,2344,22,0.077,19,8,23,46,6,4,65,14,27,10,31,41,106,18,43,9,29,6,8,4,22,61,39,13,25
48,Texas/TX,4803200,"Rio Grande COG & Permian Basin Regional Planning Commission (West) PUMA, Texas/TX",48103,"Crane County, Texas",4839,71,2,1467,41,0.041,10,4,12,24,3,2,34,7,14,5,16,21,55,18,44,9,29,5,7,4,22,62,38,13,25
48,Texas/TX,4803200,"Rio Grande COG & Permian Basin Regional Planning Commission (West) PUMA, Texas/TX",48109,"Culberson County, Texas",2241,54,2,2410,89,0.018,4,2,5,11,1,1,15,3,6,2,7,9,24,17,46,8,29,4,8,4,21,62,38,12,25
48,Texas/TX,4803200,"Rio Grande COG & Permian Basin Regional Planning Commission (West) PUMA, Texas/TX",48165,"Gaines County, Texas",20321,335,8,1649,39,0.172,42,18,51,102,13,8,144,31,59,21,69,90,234,18,44,9,29,6,8,3,22,62,38,13,25
48,Texas/TX,4803200,"Rio Grande COG & Permian Basin Regional Planning Commission (West) PUMA, Texas/TX",48229,"Hudspeth County, Texas",4098,45,3,1098,73,0.034,8,4,10,20,2,2,28,6,12,4,14,18,46,17,43,9,30,4,9,4,22,61,39,13,26
48,Texas/TX,4803200,"Rio Grande COG & Permian Basin Regional Planning Commission (West) PUMA, Texas/TX",48243,"Jeff Davis County, Texas",2234,14,0,627,0,0.018,4,2,5,11,1,1,15,3,6,2,7,9,24,17,46,8,29,4,8,4,21,62,38,12,25
48,Texas/TX,4803200,"Rio Grande COG & Permian Basin Regional Planning Commission (West) PUMA, Texas/TX",48371,"Pecos County, Texas",15797,364,5,2304,32,0.134,32,14,40,79,10,7,111,24,47,17,54,71,182,18,43,9,30,5,8,4,22,61,39,13,26
48,Texas/TX,4803200,"Rio Grande COG & Permian Basin Regional Planning Commission (West) PUMA, Texas/TX",48377,"Presidio County, Texas",7123,96,6,1348,84,0.058,14,6,17,34,4,3,48,10,20,7,23,30,78,18,44,9,29,5,8,4,22,62,38,13,26
48,Texas/TX,4803200,"Rio Grande COG & Permian Basin Regional Planning Commission (West) PUMA, Texas/TX",48389,"Reeves County, Texas",15125,192,6,1269,40,0.125,30,13,37,74,9,6,104,22,43,15,50,65,169,18,44,9,30,5,8,4,22,62,38,13,25
48,Texas/TX,4803200,"Rio Grande COG & Permian Basin Regional Planning Commission (West) PUMA, Texas/TX",48443,"Terrell County, Texas",862,3,0,348,0,0.007,2,1,2,4,1,0,6,2,2,1,3,4,10,20,40,10,30,10,10,0,20,60,40,20,20
48,Texas/TX,4803200,"Rio Grande COG & Permian Basin Regional Planning Commission (West) PUMA, Texas/TX",48475,"Ward County, Texas",11586,120,1,1036,9,0.097,23,10,29,57,7,5,80,17,34,12,39,51,131,18,44,9,30,5,8,4,22,61,39,13,26
48,Texas/TX,4803200,"Rio Grande COG & Permian Basin Regional Planning Commission (West) PUMA, Texas/TX",48495,"Winkler County, Texas",7802,113,2,1448,26,0.066,16,7,20,39,5,3,55,12,23,8,27,35,90,18,43,9,30,6,8,3,22,61,39,13,26
48,Texas/TX,4803200,"Rio Grande COG & Permian Basin Regional Planning Commission (West) PUMA, Texas/TX",48301,"Loving County, Texas",102,NA,NA,NA,NA,0.001,0,0,0,1,0,0,1,0,0,0,0,0,1,0,100,0,0,0,0,0,0,100,0,0,0
48,Texas/TX,4803301,"El Paso County (Outside El Paso City)--Socorro & Horizon Cities PUMA, Texas/TX",48141,"El Paso County, Texas",837654,23388,518,2792,62,1,14,25,332,197,0,0,211,25,332,0,357,357,568,2,35,0,63,0,4,0,58,37,63,4,58
48,Texas/TX,4803302,"El Paso City (East) PUMA, Texas/TX",48141,"El Paso County, Texas",837654,23388,518,2792,62,1,0,44,156,105,0,0,105,44,156,0,200,200,305,0,34,0,66,0,14,0,51,34,66,14,51
48,Texas/TX,4803303,"El Paso City (Southeast) PUMA, Texas/TX",48141,"El Paso County, Texas",837654,23388,518,2792,62,1,0,127,54,39,0,0,39,127,54,0,181,181,220,0,18,0,82,0,58,0,25,18,82,58,25
48,Texas/TX,4803304,"El Paso City (Central) PUMA, Texas/TX",48141,"El Paso County, Texas",837654,23388,518,2792,62,1,0,27,85,12,0,0,12,27,85,0,112,112,124,0,10,0,90,0,22,0,69,10,90,22,69
48,Texas/TX,4803305,"El Paso City (North) PUMA, Texas/TX",48141,"El Paso County, Texas",837654,23388,518,2792,62,1,0,143,270,102,0,0,102,143,270,0,413,413,515,0,20,0,80,0,28,0,52,20,80,28,52
48,Texas/TX,4803306,"El Paso City (Northwest) PUMA, Texas/TX",48141,"El Paso County, Texas",837654,23388,518,2792,62,1,21,20,175,76,0,0,97,20,175,0,195,195,292,7,26,0,67,0,7,0,60,33,67,7,60
48,Texas/TX,4803400,"Central Texas COG (West), Burnet & Llano Counties PUMA, Texas/TX",48053,"Burnet County, Texas",45750,722,12,1578,26,0.255,145,5,82,61,3,31,206,8,113,34,87,121,327,44,19,10,27,1,2,9,25,63,37,2,35
48,Texas/TX,4803400,"Central Texas COG (West), Burnet & Llano Counties PUMA, Texas/TX",48099,"Coryell County, Texas",75389,1818,12,2411,16,0.412,234,8,133,98,5,50,332,13,183,55,141,196,528,44,19,10,27,1,2,9,25,63,37,2,35
48,Texas/TX,4803400,"Central Texas COG (West), Burnet & Llano Counties PUMA, Texas/TX",48193,"Hamilton County, Texas",8269,124,4,1500,48,0.046,26,1,15,11,1,6,37,2,21,7,16,23,60,43,18,12,27,2,2,10,25,62,38,3,35
48,Texas/TX,4803400,"Central Texas COG (West), Burnet & Llano Counties PUMA, Texas/TX",48281,"Lampasas County, Texas",20640,245,8,1187,39,0.115,65,2,37,27,1,14,92,3,51,15,39,54,146,45,18,10,27,1,1,10,25,63,37,2,35
48,Texas/TX,4803400,"Central Texas COG (West), Burnet & Llano Counties PUMA, Texas/TX",48299,"Llano County, Texas",20640,124,2,601,10,0.112,64,2,36,27,1,14,91,3,50,15,38,53,144,44,19,10,26,1,1,10,25,63,37,2,35
48,Texas/TX,4803400,"Central Texas COG (West), Burnet & Llano Counties PUMA, Texas/TX",48333,"Mills County, Texas",4902,59,0,1204,0,0.027,15,1,9,6,0,3,21,1,12,3,10,13,34,44,18,9,29,0,3,9,26,62,38,3,35
48,Texas/TX,4803400,"Central Texas COG (West), Burnet & Llano Counties PUMA, Texas/TX",48411,"San Saba County, Texas",5962,54,0,906,0,0.033,19,1,11,8,0,4,27,1,15,4,12,16,43,44,19,9,28,0,2,9,26,63,37,2,35
48,Texas/TX,4803501,"Central Texas COG--Bell County (West)--Killeen & Harker Heights Cities PUMA, Texas/TX",48027,"Bell County, Texas",342236,5404,84,1579,25,1,99,0,4,21,0,29,120,0,33,29,4,33,153,65,14,19,3,0,0,19,3,78,22,0,22
48,Texas/TX,4803502,"Central Texas COG--Bell County (North, East & South)--Temple & Belton Cities PUMA, Texas/TX",48027,"Bell County, Texas",342236,5404,84,1579,25,1,183,0,4,97,0,0,280,0,4,0,4,4,284,64,34,0,1,0,0,0,1,99,1,0,1
48,Texas/TX,4803601,"Brazos Valley COG (Outside Brazos County) & Milam County PUMA, Texas/TX",48051,"Burleson County, Texas",17863,337,6,1887,34,0.116,154,22,81,36,5,0,190,27,81,5,103,108,298,52,12,2,35,2,7,0,27,64,36,9,27
48,Texas/TX,4803601,"Brazos Valley COG (Outside Brazos County) & Milam County PUMA, Texas/TX",48185,"Grimes County, Texas",27630,1089,31,3941,112,0.18,238,34,125,55,7,0,293,41,125,7,159,166,459,52,12,2,35,2,7,0,27,64,36,9,27
48,Texas/TX,4803601,"Brazos Valley COG (Outside Brazos County) & Milam County PUMA, Texas/TX",48289,"Leon County, Texas",17098,238,6,1392,35,0.113,150,21,79,35,4,0,185,25,79,4,100,104,289,52,12,1,35,1,7,0,27,64,36,9,27
48,Texas/TX,4803601,"Brazos Valley COG (Outside Brazos County) & Milam County PUMA, Texas/TX",48313,"Madison County, Texas",14128,719,6,5089,42,0.091,120,17,63,28,4,0,148,21,63,4,80,84,232,52,12,2,34,2,7,0,27,64,36,9,27
48,Texas/TX,4803601,"Brazos Valley COG (Outside Brazos County) & Milam County PUMA, Texas/TX",48331,"Milam County, Texas",24664,488,5,1979,20,0.162,214,31,113,50,6,0,264,37,113,6,144,150,414,52,12,1,35,1,7,0,27,64,36,9,27
48,Texas/TX,4803601,"Brazos Valley COG (Outside Brazos County) & Milam County PUMA, Texas/TX",48395,"Robertson County, Texas",16890,304,3,1800,18,0.109,144,21,76,33,4,0,177,25,76,4,97,101,278,52,12,1,35,1,8,0,27,64,36,9,27
48,Texas/TX,4803601,"Brazos Valley COG (Outside Brazos County) & Milam County PUMA, Texas/TX",48477,"Washington County, Texas",34796,636,48,1828,138,0.229,303,44,160,70,9,0,373,53,160,9,204,213,586,52,12,2,35,2,8,0,27,64,36,9,27
48,Texas/TX,4803602,"Brazos Valley COG--Brazos County--College Station & Bryan Cities PUMA, Texas/TX",48041,"Brazos County, Texas",219193,7005,64,3196,29,1,762,454,385,283,0,0,1045,454,385,0,839,839,1884,40,15,0,45,0,24,0,20,55,45,24,20
48,Texas/TX,4803700,"Heart of Texas COG (Outside McLennan County) & Navarro County PUMA, Texas/TX",48035,"Bosque County, Texas",18122,314,6,1733,33,0.112,108,23,68,33,4,7,141,27,75,11,91,102,243,44,14,5,37,2,9,3,28,58,42,11,31
48,Texas/TX,4803700,"Heart of Texas COG (Outside McLennan County) & Navarro County PUMA, Texas/TX",48145,"Falls County, Texas",17299,234,5,1353,29,0.107,103,22,65,32,4,7,135,26,72,11,87,98,233,44,14,5,37,2,9,3,28,58,42,11,31
48,Texas/TX,4803700,"Heart of Texas COG (Outside McLennan County) & Navarro County PUMA, Texas/TX",48161,"Freestone County, Texas",19709,404,2,2050,10,0.121,117,25,73,36,5,8,153,30,81,13,98,111,264,44,14,5,37,2,9,3,28,58,42,11,31
48,Texas/TX,4803700,"Heart of Texas COG (Outside McLennan County) & Navarro County PUMA, Texas/TX",48217,"Hill County, Texas",35399,645,14,1822,40,0.216,208,45,130,65,8,14,273,53,144,22,175,197,470,44,14,5,37,2,10,3,28,58,42,11,31
48,Texas/TX,4803700,"Heart of Texas COG (Outside McLennan County) & Navarro County PUMA, Texas/TX",48293,"Limestone County, Texas",23515,564,12,2398,51,0.145,140,30,87,43,6,10,183,36,97,16,117,133,316,44,14,5,37,2,9,3,28,58,42,11,31
48,Texas/TX,4803700,"Heart of Texas COG (Outside McLennan County) & Navarro County PUMA, Texas/TX",48349,"Navarro County, Texas",48583,1662,32,3421,66,0.299,288,62,180,89,12,20,377,74,200,32,242,274,651,44,14,5,37,2,10,3,28,58,42,11,31
48,Texas/TX,4803801,"Heart of Texas COG--McLennan County--Waco City (Central) PUMA, Texas/TX",48309,"McLennan County, Texas",248429,7942,105,3197,42,1,560,101,410,260,0,0,820,101,410,0,511,511,1331,42,20,0,38,0,8,0,31,62,38,8,31
48,Texas/TX,4803802,"Heart of Texas COG--McLennan County--Waco (Outer), Hewitt & Robinson Cities PUMA, Texas/TX",48309,"McLennan County, Texas",248429,7942,105,3197,42,1,704,103,73,192,0,0,896,103,73,0,176,176,1072,66,18,0,16,0,10,0,7,84,16,10,7
48,Texas/TX,4803900,"Deep East Texas COG (West) & Walker County PUMA, Texas/TX",48225,"Houston County, Texas",22955,371,10,1616,44,0.123,41,5,5,9,0,0,50,5,5,0,10,10,60,68,15,0,17,0,8,0,8,83,17,8,8
48,Texas/TX,4803900,"Deep East Texas COG (West) & Walker County PUMA, Texas/TX",48373,"Polk County, Texas",47837,1047,22,2189,46,0.26,87,10,11,20,0,0,107,10,11,0,21,21,128,68,16,0,16,0,8,0,9,84,16,8,9
48,Texas/TX,4803900,"Deep East Texas COG (West) & Walker County PUMA, Texas/TX",48407,"San Jacinto County, Texas",27819,226,9,812,32,0.15,50,6,7,11,0,0,61,6,7,0,13,13,74,68,15,0,18,0,8,0,9,82,18,8,9
48,Texas/TX,4803900,"Deep East Texas COG (West) & Walker County PUMA, Texas/TX",48455,"Trinity County, Texas",14569,194,7,1332,48,0.078,26,3,3,6,0,0,32,3,3,0,6,6,38,68,16,0,16,0,8,0,8,84,16,8,8
48,Texas/TX,4803900,"Deep East Texas COG (West) & Walker County PUMA, Texas/TX",48471,"Walker County, Texas",71539,3689,57,5157,80,0.388,130,16,17,29,0,0,159,16,17,0,33,33,192,68,15,0,17,0,8,0,9,83,17,8,9
48,Texas/TX,4804000,"Deep East Texas COG (Central)--Angelina & Nacogdoches Counties PUMA, Texas/TX",48005,"Angelina County, Texas",87607,2507,80,2862,91,0.572,530,65,276,197,9,37,727,74,313,46,341,387,1114,48,18,4,31,1,6,3,25,65,35,7,28
48,Texas/TX,4804000,"Deep East Texas COG (Central)--Angelina & Nacogdoches Counties PUMA, Texas/TX",48347,"Nacogdoches County, Texas",65558,1543,61,2354,93,0.428,396,48,207,147,7,28,543,55,235,35,255,290,833,48,18,4,31,1,6,3,25,65,35,7,28
48,Texas/TX,4804100,"Deep East Texas COG (East) PUMA, Texas/TX",48241,"Jasper County, Texas",35504,470,25,1324,70,0.31,177,31,89,26,0,7,203,31,96,7,120,127,330,54,8,2,36,0,9,2,27,62,38,9,29
48,Texas/TX,4804100,"Deep East Texas COG (East) PUMA, Texas/TX",48351,"Newton County, Texas",14057,178,10,1266,71,0.122,70,12,35,10,0,3,80,12,38,3,47,50,130,54,8,2,36,0,9,2,27,62,38,9,29
48,Texas/TX,4804100,"Deep East Texas COG (East) PUMA, Texas/TX",48403,"Sabine County, Texas",10458,77,8,736,76,0.089,51,9,26,7,0,2,58,9,28,2,35,37,95,54,7,2,37,0,9,2,27,61,39,9,29
48,Texas/TX,4804100,"Deep East Texas COG (East) PUMA, Texas/TX",48405,"San Augustine County, Texas",8327,236,15,2834,180,0.072,41,7,21,6,0,2,47,7,23,2,28,30,77,53,8,3,36,0,9,3,27,61,39,9,30
48,Texas/TX,4804100,"Deep East Texas COG (East) PUMA, Texas/TX",48419,"Shelby County, Texas",25478,477,27,1872,106,0.222,127,22,64,18,0,5,145,22,69,5,86,91,236,54,8,2,36,0,9,2,27,61,39,9,29
48,Texas/TX,4804100,"Deep East Texas COG (East) PUMA, Texas/TX",48457,"Tyler County, Texas",21496,214,4,996,19,0.185,105,19,53,15,0,4,120,19,57,4,72,76,196,54,8,2,37,0,10,2,27,61,39,10,29
48,Texas/TX,4804200,"Orange & Hardin Counties PUMA, Texas/TX",48199,"Hardin County, Texas",56379,1333,30,2364,53,0.399,48,0,7,0,0,0,48,0,7,0,7,7,55,87,0,0,13,0,0,0,13,87,13,0,13
48,Texas/TX,4804200,"Orange & Hardin Counties PUMA, Texas/TX",48361,"Orange County, Texas",84047,1961,43,2333,51,0.601,72,0,10,0,0,0,72,0,10,0,10,10,82,88,0,0,12,0,0,0,12,88,12,0,12
48,Texas/TX,4804301,"Jefferson County (North Central)--Beaumont City PUMA, Texas/TX",48245,"Jefferson County, Texas",255210,7325,132,2870,52,1,171,0,15,0,0,23,171,0,38,23,15,38,209,82,0,11,7,0,0,11,7,82,18,0,18
48,Texas/TX,4804302,"Jefferson County (Outside Beaumont City)--Port Arthur City PUMA, Texas/TX",48245,"Jefferson County, Texas",255210,7325,132,2870,52,1,100,25,94,35,40,0,135,65,94,40,119,159,294,34,12,14,40,14,9,0,32,46,54,22,32
48,Texas/TX,4804400,"Houston-Galveston Area Council--Liberty & Chambers Counties PUMA, Texas/TX",48071,"Chambers County, Texas",40292,1302,16,3231,40,0.328,93,0,31,0,0,0,93,0,31,0,31,31,124,75,0,0,25,0,0,0,25,75,25,0,25
48,Texas/TX,4804400,"Houston-Galveston Area Council--Liberty & Chambers Counties PUMA, Texas/TX",48291,"Liberty County, Texas",81862,2257,50,2757,61,0.672,190,0,65,0,0,0,190,0,65,0,65,65,255,75,0,0,25,0,0,0,25,75,25,0,25
48,Texas/TX,4804501,"Houston-Galveston Area Council--Montgomery County (Northeast)--Conroe City (East) PUMA, Texas/TX",48339,"Montgomery County, Texas",554445,10814,158,1950,28,1,119,0,83,34,0,0,153,0,83,0,83,83,236,50,14,0,35,0,0,0,35,65,35,0,35
48,Texas/TX,4804502,"Houston-Galveston Area Council--Montgomery County (West)--Conroe City (West) PUMA, Texas/TX",48339,"Montgomery County, Texas",554445,10814,158,1950,28,1,47,0,56,9,0,0,56,0,56,0,56,56,112,42,8,0,50,0,0,0,50,50,50,0,50
48,Texas/TX,4804503,"Houston-Galveston Area Council--Montgomery County (South)--The Woodlands (North) PUMA, Texas/TX",48339,"Montgomery County, Texas",554445,10814,158,1950,28,1,0,0,0,28,0,0,28,0,0,0,0,0,28,0,100,0,0,0,0,0,0,100,0,0,0
48,Texas/TX,4804504,"Houston-Galveston Area Council--Montgomery County (Southeast) PUMA, Texas/TX",48339,"Montgomery County, Texas",554445,10814,158,1950,28,1,70,0,45,0,0,0,70,0,45,0,45,45,115,61,0,0,39,0,0,0,39,61,39,0,39
48,Texas/TX,4804601,"Houston City (North Central)--North of I-10 & Inside Loop I-610 PUMA, Texas/TX",48201,"Harris County, Texas",4602523,140532,2548,3053,55,1,9,47,64,167,0,0,176,47,64,0,111,111,287,3,58,0,39,0,16,0,22,61,39,16,22
48,Texas/TX,4804602,"Houston City (East Central)--East of I-45 & Inside Loop I-610 PUMA, Texas/TX",48201,"Harris County, Texas",4602523,140532,2548,3053,55,1,0,55,108,138,0,0,138,55,108,0,163,163,301,0,46,0,54,0,18,0,36,46,54,18,36
48,Texas/TX,4804603,"Houston City (South Central)--South of US-59, West of I-45 & Inside Loop I-610 PUMA, Texas/TX",48201,"Harris County, Texas",4602523,140532,2548,3053,55,1,0,0,0,19,0,0,19,0,0,0,0,0,19,0,100,0,0,0,0,0,0,100,0,0,0
48,Texas/TX,4804604,"Houston City (West Central)--South of I-10 & Inside Loop I-610 PUMA, Texas/TX",48201,"Harris County, Texas",4602523,140532,2548,3053,55,1,19,0,0,47,0,0,66,0,0,0,0,0,66,29,71,0,0,0,0,0,0,100,0,0,0
48,Texas/TX,4804605,"Harris County (Southeast)--Pasadena City (North & Central)--Inside Beltway TX-8 PUMA, Texas/TX",48201,"Harris County, Texas",4602523,140532,2548,3053,55,1,35,66,296,11,0,0,46,66,296,0,362,362,408,9,3,0,89,0,16,0,73,11,89,16,73
48,Texas/TX,4804606,"Houston (East), Galena Park, Jacinto Cities & Cloverleaf PUMA, Texas/TX",48201,"Harris County, Texas",4602523,140532,2548,3053,55,1,37,20,220,26,0,0,63,20,220,0,240,240,303,12,9,0,79,0,7,0,73,21,79,7,73
48,Texas/TX,4804607,"Houston City (Northeast)--Between Loop I-610 & Beltway TX-8 PUMA, Texas/TX",48201,"Harris County, Texas",4602523,140532,2548,3053,55,1,35,0,20,13,0,0,48,0,20,0,20,20,68,51,19,0,29,0,0,0,29,71,29,0,29
48,Texas/TX,4804608,"Houston City (North) & Aldine--Between Loop I-610 & Beltway TX-8 PUMA, Texas/TX",48201,"Harris County, Texas",4602523,140532,2548,3053,55,1,13,18,223,97,0,0,110,18,223,0,241,241,351,4,28,0,69,0,5,0,64,31,69,5,64
48,Texas/TX,4804609,"Houston City (North)--South of Aldine & Inside Beltway TX-8 PUMA, Texas/TX",48201,"Harris County, Texas",4602523,140532,2548,3053,55,1,11,48,17,40,0,0,51,48,17,0,65,65,116,9,34,0,56,0,41,0,15,44,56,41,15
48,Texas/TX,4804610,"Houston City (North)--West of Aldine & Inside Beltway TX-8 PUMA, Texas/TX",48201,"Harris County, Texas",4602523,140532,2548,3053,55,1,117,0,134,0,0,22,117,0,156,22,134,156,273,43,0,8,49,0,0,8,49,43,57,0,57
48,Texas/TX,4804611,"Houston City (Northwest)--Between Loop I-610 & Beltway TX-8 PUMA, Texas/TX",48201,"Harris County, Texas",4602523,140532,2548,3053,55,1,23,0,0,88,0,0,111,0,0,0,0,0,111,21,79,0,0,0,0,0,0,100,0,0,0
48,Texas/TX,4804612,"Houston (West) & Spring Valley Village Cities--Between Loop I-610 & Beltway TX-8 PUMA, Texas/TX",48201,"Harris County, Texas",4602523,140532,2548,3053,55,1,29,39,95,0,0,0,29,39,95,0,134,134,163,18,0,0,82,0,24,0,58,18,82,24,58
48,Texas/TX,4804613,"Houston (West) & Hunters Creek Village Cities--Between Loop I-610 & Beltway TX-8 PUMA, Texas/TX",48201,"Harris County, Texas",4602523,140532,2548,3053,55,1,49,0,0,0,13,0,49,13,0,13,0,13,62,79,0,21,0,21,0,0,0,79,21,21,0
48,Texas/TX,4804614,"Houston City (West)--Westpark Tollway, Between Loop I-610 & Beltway TX-8 PUMA, Texas/TX",48201,"Harris County, Texas",4602523,140532,2548,3053,55,1,0,0,127,94,0,107,94,0,234,107,127,234,328,0,29,33,39,0,0,33,39,29,71,0,71
48,Texas/TX,4804615,"Houston (Southwest) & Bellaire (Southeast) Cities--Between Loop I-610 & Beltway TX-8 PUMA, Texas/TX",48201,"Harris County, Texas",4602523,140532,2548,3053,55,1,0,0,60,0,15,0,0,15,60,15,60,75,75,0,0,20,80,20,0,0,80,0,100,20,80
48,Texas/TX,4804616,"Houston City (Southwest)--Between Loop I-610 & Beltway TX-8 PUMA, Texas/TX",48201,"Harris County, Texas",4602523,140532,2548,3053,55,1,59,18,12,0,0,0,59,18,12,0,30,30,89,66,0,0,34,0,20,0,13,66,34,20,13
48,Texas/TX,4804617,"Houston City (South)--Between Loop I-610 & Beltway TX-8 PUMA, Texas/TX",48201,"Harris County, Texas",4602523,140532,2548,3053,55,1,334,0,0,0,55,0,334,55,0,55,0,55,389,86,0,14,0,14,0,0,0,86,14,14,0
48,Texas/TX,4804618,"Houston City (Southeast)--West of Pasadena City & Outside Loop I-610 PUMA, Texas/TX",48201,"Harris County, Texas",4602523,140532,2548,3053,55,1,91,36,66,24,0,0,115,36,66,0,102,102,217,42,11,0,47,0,17,0,30,53,47,17,30
48,Texas/TX,4804619,"Houston (Southeast) & South Houston Cities--Inside Beltway TX-8 PUMA, Texas/TX",48201,"Harris County, Texas",4602523,140532,2548,3053,55,1,0,57,150,32,45,80,32,102,230,125,207,332,364,0,9,34,57,12,16,22,41,9,91,28,63
48,Texas/TX,4804620,"Houston (Southeast) & Webster Cities PUMA, Texas/TX",48201,"Harris County, Texas",4602523,140532,2548,3053,55,1,41,116,0,0,0,0,41,116,0,0,116,116,157,26,0,0,74,0,74,0,0,26,74,74,0
48,Texas/TX,4804621,"Houston (Southeast), Pasadena (Southeast), La Porte (South) & Seabrook (East) Cities PUMA, Texas/TX",48201,"Harris County, Texas",4602523,140532,2548,3053,55,1,0,0,24,49,0,0,49,0,24,0,24,24,73,0,67,0,33,0,0,0,33,67,33,0,33
48,Texas/TX,4804622,"Harris County (East)--Deer Park, La Porte (North) Cities & Channelview PUMA, Texas/TX",48201,"Harris County, Texas",4602523,140532,2548,3053,55,1,104,0,0,12,0,0,116,0,0,0,0,0,116,90,10,0,0,0,0,0,0,100,0,0,0
48,Texas/TX,4804623,"Harris County (East)--Baytown City PUMA, Texas/TX",48201,"Harris County, Texas",4602523,140532,2548,3053,55,1,75,0,91,0,0,0,75,0,91,0,91,91,166,45,0,0,55,0,0,0,55,45,55,0,55
48,Texas/TX,4804624,"Harris County (Northeast)--Houston City (Far Northeast) PUMA, Texas/TX",48201,"Harris County, Texas",4602523,140532,2548,3053,55,1,83,0,0,22,0,0,105,0,0,0,0,0,105,79,21,0,0,0,0,0,0,100,0,0,0
48,Texas/TX,4804625,"Harris County (North)--Houston (North), Humble Cities & Atascocita PUMA, Texas/TX",48201,"Harris County, Texas",4602523,140532,2548,3053,55,1,0,0,83,98,0,0,98,0,83,0,83,83,181,0,54,0,46,0,0,0,46,54,46,0,46
48,Texas/TX,4804626,"Harris County (North)--Houston City (North)--I-45, Between Beltway TX-8 & FM-1960 PUMA, Texas/TX",48201,"Harris County, Texas",4602523,140532,2548,3053,55,1,11,65,310,63,0,55,74,65,365,55,375,430,504,2,12,11,74,0,13,11,62,15,85,13,72
48,Texas/TX,4804627,"Harris County (Far North)--Spring PUMA, Texas/TX",48201,"Harris County, Texas",4602523,140532,2548,3053,55,1,90,109,0,80,0,0,170,109,0,0,109,109,279,32,29,0,39,0,39,0,0,61,39,39,0
48,Texas/TX,4804628,"Harris County (Northwest)--Jersey Village City--Between Beltway TX-8 & FM-1960 PUMA, Texas/TX",48201,"Harris County, Texas",4602523,140532,2548,3053,55,1,0,20,26,0,0,0,0,20,26,0,46,46,46,0,0,0,100,0,43,0,57,0,100,43,57
48,Texas/TX,4804629,"Harris County (North)--North of FM-1960, West of I-45 & East of TX-249 PUMA, Texas/TX",48201,"Harris County, Texas",4602523,140532,2548,3053,55,1,108,0,0,0,0,0,108,0,0,0,0,0,108,100,0,0,0,0,0,0,0,100,0,0,0
48,Texas/TX,4804630,"Harris County (Far North)--Tomball City & The Woodlands (Southwest) PUMA, Texas/TX",48201,"Harris County, Texas",4602523,140532,2548,3053,55,1,120,281,0,0,0,0,120,281,0,0,281,281,401,30,0,0,70,0,70,0,0,30,70,70,0
48,Texas/TX,4804631,"Harris County (Northwest)--North of US-290 & North of FM-1960 PUMA, Texas/TX",48201,"Harris County, Texas",4602523,140532,2548,3053,55,1,28,0,0,23,0,0,51,0,0,0,0,0,51,55,45,0,0,0,0,0,0,100,0,0,0
48,Texas/TX,4804632,"Harris County (Far Northwest)--Katy City (Northeast) PUMA, Texas/TX",48201,"Harris County, Texas",4602523,140532,2548,3053,55,1,53,0,173,7,14,0,60,14,173,14,173,187,247,21,3,6,70,6,0,0,70,24,76,6,70
48,Texas/TX,4804633,"Harris County (Northwest)--South of US-290 & West of TX-6 PUMA, Texas/TX",48201,"Harris County, Texas",4602523,140532,2548,3053,55,1,83,0,0,63,59,0,146,59,0,59,0,59,205,40,31,29,0,29,0,0,0,71,29,29,0
48,Texas/TX,4804634,"Harris County (West)--Houston City (West)--North of US-90 & West of TX-6 PUMA, Texas/TX",48201,"Harris County, Texas",4602523,140532,2548,3053,55,1,92,0,0,0,0,0,92,0,0,0,0,0,92,100,0,0,0,0,0,0,0,100,0,0,0
48,Texas/TX,4804635,"Houston City (West)--South of I-10 & West of TX-6 PUMA, Texas/TX",48201,"Harris County, Texas",4602523,140532,2548,3053,55,1,16,47,91,0,0,0,16,47,91,0,138,138,154,10,0,0,90,0,31,0,59,10,90,31,59
48,Texas/TX,4804636,"Houston City (West)--East of TX-6 & West of Beltway TX-8 PUMA, Texas/TX",48201,"Harris County, Texas",4602523,140532,2548,3053,55,1,109,0,96,0,0,0,109,0,96,0,96,96,205,53,0,0,47,0,0,0,47,53,47,0,47
48,Texas/TX,4804637,"Houston City (West)--Westpark Tollway, West of Beltway TX-8 PUMA, Texas/TX",48201,"Harris County, Texas",4602523,140532,2548,3053,55,1,0,0,44,45,36,56,45,36,100,92,44,136,181,0,25,51,24,20,0,31,24,25,75,20,55
48,Texas/TX,4804638,"Houston City (Southwest)--East of TX-6 & West of Beltway TX-8 PUMA, Texas/TX",48201,"Harris County, Texas",4602523,140532,2548,3053,55,1,41,22,16,23,0,33,64,22,49,33,38,71,135,30,17,24,28,0,16,24,12,47,53,16,36
48,Texas/TX,4804701,"Galveston County (Central, South & East)--Galveston, Texas City & La Marque Cities PUMA, Texas/TX",48167,"Galveston County, Texas",327089,11575,154,3539,47,1,147,16,29,26,0,0,173,16,29,0,45,45,218,67,12,0,21,0,7,0,13,79,21,7,13
48,Texas/TX,4804702,"Galveston County (Northwest)--League City & Friendswood City PUMA, Texas/TX",48167,"Galveston County, Texas",327089,11575,154,3539,47,1,76,0,33,45,0,0,121,0,33,0,33,33,154,49,29,0,21,0,0,0,21,79,21,0,21
48,Texas/TX,4804801,"Houston-Galveston Area Council--Brazoria County (North)--Pearland City PUMA, Texas/TX",48039,"Brazoria County, Texas",353999,11169,163,3155,46,1,148,0,0,0,0,0,148,0,0,0,0,0,148,100,0,0,0,0,0,0,0,100,0,0,0
48,Texas/TX,4804802,"Houston-Galveston Area Council--Brazoria County (Central)--Alvin City PUMA, Texas/TX",48039,"Brazoria County, Texas",353999,11169,163,3155,46,1,22,15,13,5,0,0,27,15,13,0,28,28,55,40,9,0,51,0,27,0,24,49,51,27,24
48,Texas/TX,4804803,"Houston-Galveston Area Council--Brazoria County (Southwest)--Lake Jackson City PUMA, Texas/TX",48039,"Brazoria County, Texas",353999,11169,163,3155,46,1,36,48,0,9,0,0,45,48,0,0,48,48,93,39,10,0,52,0,52,0,0,48,52,52,0
48,Texas/TX,4804901,"Fort Bend County (East)--Missouri City PUMA, Texas/TX",48157,"Fort Bend County, Texas",739342,16167,283,2187,38,1,0,0,34,28,23,79,28,23,113,102,34,136,164,0,17,62,21,14,0,48,21,17,83,14,69
48,Texas/TX,4804902,"Fort Bend County (Northeast)--Sugar Land & Stafford Cities PUMA, Texas/TX",48157,"Fort Bend County, Texas",739342,16167,283,2187,38,1,68,0,15,0,0,0,68,0,15,0,15,15,83,82,0,0,18,0,0,0,18,82,18,0,18
48,Texas/TX,4804903,"Fort Bend County (Central)--Rosenberg City, Pecan Grove & New Territory PUMA, Texas/TX",48157,"Fort Bend County, Texas",739342,16167,283,2187,38,1,30,22,40,97,13,0,127,35,40,13,62,75,202,15,48,6,31,6,11,0,20,63,37,17,20
48,Texas/TX,4804904,"Fort Bend County (North)--Mission Bend (Southwest), Cinco Ranch & Four Corners PUMA, Texas/TX",48157,"Fort Bend County, Texas",739342,16167,283,2187,38,1,0,0,0,16,18,23,16,18,23,41,0,41,57,0,28,72,0,32,0,40,0,28,72,32,40
48,Texas/TX,4804905,"Fort Bend County (West & South) PUMA, Texas/TX",48157,"Fort Bend County, Texas",739342,16167,283,2187,38,1,177,101,54,50,0,0,227,101,54,0,155,155,382,46,13,0,41,0,26,0,14,59,41,26,14
48,Texas/TX,4805000,"Houston-Galveston Area Council (West) PUMA, Texas/TX",48015,"Austin County, Texas",29565,488,9,1651,30,0.165,139,24,131,31,0,6,170,24,137,6,155,161,331,42,9,2,47,0,7,2,40,51,49,7,41
48,Texas/TX,4805000,"Houston-Galveston Area Council (West) PUMA, Texas/TX",48089,"Colorado County, Texas",21022,482,4,2293,19,0.117,99,17,93,22,0,4,121,17,97,4,110,114,235,42,9,2,47,0,7,2,40,51,49,7,41
48,Texas/TX,4805000,"Houston-Galveston Area Council (West) PUMA, Texas/TX",48321,"Matagorda County, Texas",36743,1044,46,2841,125,0.207,175,30,165,39,0,7,214,30,172,7,195,202,416,42,9,2,47,0,7,2,40,51,49,7,41
48,Texas/TX,4805000,"Houston-Galveston Area Council (West) PUMA, Texas/TX",48473,"Waller County, Texas",49987,841,13,1682,26,0.279,235,40,222,52,0,10,287,40,232,10,262,272,559,42,9,2,47,0,7,2,40,51,49,7,42
48,Texas/TX,4805000,"Houston-Galveston Area Council (West) PUMA, Texas/TX",48481,"Wharton County, Texas",41551,1355,50,3261,120,0.232,196,34,185,43,0,8,239,34,193,8,219,227,466,42,9,2,47,0,7,2,40,51,49,7,41
48,Texas/TX,4805100,"Capital Area COG (East)--Bastrop, Caldwell, Fayette & Lee Counties PUMA, Texas/TX",48021,"Bastrop County, Texas",82577,1814,29,2197,35,0.498,216,4,59,62,0,0,278,4,59,0,63,63,341,63,18,0,18,0,1,0,17,82,18,1,17
48,Texas/TX,4805100,"Capital Area COG (East)--Bastrop, Caldwell, Fayette & Lee Counties PUMA, Texas/TX",48055,"Caldwell County, Texas",41401,1523,35,3679,85,0.248,108,2,30,31,0,0,139,2,30,0,32,32,171,63,18,0,19,0,1,0,18,81,19,1,18
48,Texas/TX,4805100,"Capital Area COG (East)--Bastrop, Caldwell, Fayette & Lee Counties PUMA, Texas/TX",48149,"Fayette County, Texas",25066,473,18,1887,72,0.151,66,1,18,19,0,0,85,1,18,0,19,19,104,63,18,0,18,0,1,0,17,82,18,1,17
48,Texas/TX,4805100,"Capital Area COG (East)--Bastrop, Caldwell, Fayette & Lee Counties PUMA, Texas/TX",48287,"Lee County, Texas",16952,219,14,1292,83,0.103,45,1,12,13,0,0,58,1,12,0,13,13,71,63,18,0,18,0,1,0,17,82,18,1,17
48,Texas/TX,4805201,"Capital Area COG--Williamson County (North)--Georgetown (East) & Taylor Cities PUMA, Texas/TX",48491,"Williamson County, Texas",527057,8759,143,1662,27,1,59,0,149,8,0,0,67,0,149,0,149,149,216,27,4,0,69,0,0,0,69,31,69,0,69
48,Texas/TX,4805202,"Capital Area COG--Williamson County (Southeast)--Round Rock City PUMA, Texas/TX",48491,"Williamson County, Texas",527057,8759,143,1662,27,1,79,0,11,0,0,0,79,0,11,0,11,11,90,88,0,0,12,0,0,0,12,88,12,0,12
48,Texas/TX,4805204,"Capital Area COG--Williamson County (West)--Cedar Park & Leander Cities PUMA, Texas/TX",48491,"Williamson County, Texas",527057,8759,143,1662,27,1,96,0,0,15,0,0,111,0,0,0,0,0,111,86,14,0,0,0,0,0,0,100,0,0,0
48,Texas/TX,4805301,"Travis County (Northeast)--Pflugerville, Manor Cities & Wells Branch PUMA, Texas/TX",48453,"Travis County, Texas",1203166,29073,420,2416,35,1,32,0,23,152,0,0,184,0,23,0,23,23,207,15,73,0,11,0,0,0,11,89,11,0,11
48,Texas/TX,4805302,"Austin City (North) PUMA, Texas/TX",48453,"Travis County, Texas",1203166,29073,420,2416,35,1,242,0,64,33,28,0,275,28,64,28,64,92,367,66,9,8,17,8,0,0,17,75,25,8,17
48,Texas/TX,4805303,"Austin City (Northeast) PUMA, Texas/TX",48453,"Travis County, Texas",1203166,29073,420,2416,35,1,138,0,180,31,0,11,169,0,191,11,180,191,360,38,9,3,50,0,0,3,50,47,53,0,53
48,Texas/TX,4805304,"Austin City (Southeast) PUMA, Texas/TX",48453,"Travis County, Texas",1203166,29073,420,2416,35,1,24,0,97,48,102,0,72,102,97,102,97,199,271,9,18,38,36,38,0,0,36,27,73,38,36
48,Texas/TX,4805305,"Austin City (Northwest) PUMA, Texas/TX",48453,"Travis County, Texas",1203166,29073,420,2416,35,1,58,0,9,6,0,0,64,0,9,0,9,9,73,79,8,0,12,0,0,0,12,88,12,0,12
48,Texas/TX,4805306,"Austin City (Central) PUMA, Texas/TX",48453,"Travis County, Texas",1203166,29073,420,2416,35,1,78,19,0,28,0,72,106,19,72,72,19,91,197,40,14,37,10,0,10,37,0,54,46,10,37
48,Texas/TX,4805307,"Austin City (South) PUMA, Texas/TX",48453,"Travis County, Texas",1203166,29073,420,2416,35,1,16,0,81,0,0,0,16,0,81,0,81,81,97,16,0,0,84,0,0,0,84,16,84,0,84
48,Texas/TX,4805308,"Austin City (Southwest), Lost Creek & Barton Creek PUMA, Texas/TX",48453,"Travis County, Texas",1203166,29073,420,2416,35,1,70,0,0,0,0,0,70,0,0,0,0,0,70,100,0,0,0,0,0,0,0,100,0,0,0
48,Texas/TX,4805309,"Travis County (West, South & Outside Austin City) PUMA, Texas/TX",48453,"Travis County, Texas",1203166,29073,420,2416,35,1,18,0,128,0,0,0,18,0,128,0,128,128,146,12,0,0,88,0,0,0,88,12,88,0,88
48,Texas/TX,4805400,"Capital Area COG (Southwest)--Hays County PUMA, Texas/TX",48209,"Hays County, Texas",204150,5871,61,2876,30,1,238,0,0,75,0,0,313,0,0,0,0,0,313,76,24,0,0,0,0,0,0,100,0,0,0
48,Texas/TX,4805500,"Golden Crescent Regional Planning Commission (North) & Wilson & Karnes Counties PUMA, Texas/TX",48123,"DeWitt County, Texas",20435,996,34,4874,166,0.141,86,9,145,88,0,0,174,9,145,0,154,154,328,26,27,0,47,0,3,0,44,53,47,3,44
48,Texas/TX,4805500,"Golden Crescent Regional Planning Commission (North) & Wilson & Karnes Counties PUMA, Texas/TX",48175,"Goliad County, Texas",7531,154,6,2045,80,0.051,31,3,52,32,0,0,63,3,52,0,55,55,118,26,27,0,47,0,3,0,44,53,47,3,44
48,Texas/TX,4805500,"Golden Crescent Regional Planning Commission (North) & Wilson & Karnes Counties PUMA, Texas/TX",48177,"Gonzales County, Texas",20667,1057,17,5114,82,0.141,86,9,145,88,0,0,174,9,145,0,154,154,328,26,27,0,47,0,3,0,44,53,47,3,44
48,Texas/TX,4805500,"Golden Crescent Regional Planning Commission (North) & Wilson & Karnes Counties PUMA, Texas/TX",48239,"Jackson County, Texas",14820,606,15,4089,101,0.101,62,7,104,63,0,0,125,7,104,0,111,111,236,26,27,0,47,0,3,0,44,53,47,3,44
48,Texas/TX,4805500,"Golden Crescent Regional Planning Commission (North) & Wilson & Karnes Counties PUMA, Texas/TX",48255,"Karnes County, Texas",15387,937,16,6090,104,0.103,63,7,106,65,0,0,128,7,106,0,113,113,241,26,27,0,47,0,3,0,44,53,47,3,44
48,Texas/TX,4805500,"Golden Crescent Regional Planning Commission (North) & Wilson & Karnes Counties PUMA, Texas/TX",48285,"Lavaca County, Texas",19941,973,35,4879,176,0.134,82,9,138,84,0,0,166,9,138,0,147,147,313,26,27,0,47,0,3,0,44,53,47,3,44
48,Texas/TX,4805500,"Golden Crescent Regional Planning Commission (North) & Wilson & Karnes Counties PUMA, Texas/TX",48493,"Wilson County, Texas",48198,888,26,1842,54,0.328,200,22,337,206,0,1,406,22,338,1,359,360,766,26,27,0,47,0,3,0,44,53,47,3,44
48,Texas/TX,4805600,"Golden Crescent Regional Planning Commission (Southeast)--Victoria & Calhoun Counties PUMA, Texas/TX",48057,"Calhoun County, Texas",21807,818,7,3751,32,0.192,54,5,9,19,0,0,73,5,9,0,14,14,87,62,22,0,16,0,6,0,10,84,16,6,10
48,Texas/TX,4805600,"Golden Crescent Regional Planning Commission (Southeast)--Victoria & Calhoun Counties PUMA, Texas/TX",48469,"Victoria County, Texas",91970,4053,95,4407,103,0.808,225,21,37,78,0,0,303,21,37,0,58,58,361,62,22,0,16,0,6,0,10,84,16,6,10
48,Texas/TX,4805700,"Alamo Area COG (Northeast)--Guadalupe County PUMA, Texas/TX",48187,"Guadalupe County, Texas",155137,3566,76,2299,49,1,266,60,79,324,0,0,590,60,79,0,139,139,729,36,44,0,19,0,8,0,11,81,19,8,11
48,Texas/TX,4805800,"Alamo Area COG (Northeast)--Comal County PUMA, Texas/TX",48091,"Comal County, Texas",135097,3431,116,2540,86,1,111,0,0,143,0,0,254,0,0,0,0,0,254,44,56,0,0,0,0,0,0,100,0,0,0
48,Texas/TX,4805901,"San Antonio City (Central) PUMA, Texas/TX",48029,"Bexar County, Texas",1925865,54207,1271,2815,66,1,55,12,104,139,0,0,194,12,104,0,116,116,310,18,45,0,37,0,4,0,34,63,37,4,34
48,Texas/TX,4805902,"San Antonio City (Northeast)--Inside Loop I-410 PUMA, Texas/TX",48029,"Bexar County, Texas",1925865,54207,1271,2815,66,1,87,34,58,108,0,0,195,34,58,0,92,92,287,30,38,0,32,0,12,0,20,68,32,12,20
48,Texas/TX,4805903,"San Antonio City (Southeast)--Inside Loop I-410 PUMA, Texas/TX",48029,"Bexar County, Texas",1925865,54207,1271,2815,66,1,119,13,73,196,0,8,315,13,81,8,86,94,409,29,48,2,21,0,3,2,18,77,23,3,20
48,Texas/TX,4805904,"San Antonio City (Northwest)--Inside Loop I-410 PUMA, Texas/TX",48029,"Bexar County, Texas",1925865,54207,1271,2815,66,1,18,0,37,141,0,99,159,0,136,99,37,136,295,6,48,34,13,0,0,34,13,54,46,0,46
48,Texas/TX,4805905,"San Antonio City (West)--Inside Loop I-410 PUMA, Texas/TX",48029,"Bexar County, Texas",1925865,54207,1271,2815,66,1,0,32,52,292,0,0,292,32,52,0,84,84,376,0,78,0,22,0,9,0,14,78,22,9,14
48,Texas/TX,4805906,"San Antonio City (Southwest)--Inside Loop I-410 PUMA, Texas/TX",48029,"Bexar County, Texas",1925865,54207,1271,2815,66,1,0,105,150,228,0,0,228,105,150,0,255,255,483,0,47,0,53,0,22,0,31,47,53,22,31
48,Texas/TX,4805907,"Bexar County (South)--San Antonio City (Far South) PUMA, Texas/TX",48029,"Bexar County, Texas",1925865,54207,1271,2815,66,1,106,33,163,111,0,0,217,33,163,0,196,196,413,26,27,0,47,0,8,0,39,53,47,8,39
48,Texas/TX,4805908,"San Antonio City (West)--Between Loop TX-1604 & Loop I-410 PUMA, Texas/TX",48029,"Bexar County, Texas",1925865,54207,1271,2815,66,1,0,0,29,0,25,0,0,25,29,25,29,54,54,0,0,46,54,46,0,0,54,0,100,46,54
48,Texas/TX,4805909,"San Antonio (Northwest) & Leon Valley Cities PUMA, Texas/TX",48029,"Bexar County, Texas",1925865,54207,1271,2815,66,1,75,44,0,0,9,0,75,53,0,9,44,53,128,59,0,7,34,7,34,0,0,59,41,41,0
48,Texas/TX,4805910,"San Antonio City (Northwest)--Between Loop TX-1604 & Loop I-410 PUMA, Texas/TX",48029,"Bexar County, Texas",1925865,54207,1271,2815,66,1,14,0,0,11,38,25,25,38,25,63,0,63,88,16,12,72,0,43,0,28,0,28,72,43,28
48,Texas/TX,4805911,"San Antonio City (North), Hollywood Park Town & Shavano Park City PUMA, Texas/TX",48029,"Bexar County, Texas",1925865,54207,1271,2815,66,1,260,62,95,0,32,0,260,94,95,32,157,189,449,58,0,7,35,7,14,0,21,58,42,21,21
48,Texas/TX,4805912,"San Antonio City (Northeast)--Between Loop TX-1604 & Loop I-410 PUMA, Texas/TX",48029,"Bexar County, Texas",1925865,54207,1271,2815,66,1,21,22,11,74,19,0,95,41,11,19,33,52,147,14,50,13,22,13,15,0,7,65,35,28,7
48,Texas/TX,4805913,"San Antonio (Northeast), Kirby & Windcrest Cities PUMA, Texas/TX",48029,"Bexar County, Texas",1925865,54207,1271,2815,66,1,156,0,99,46,13,0,202,13,99,13,99,112,314,50,15,4,32,4,0,0,32,64,36,4,32
48,Texas/TX,4805914,"Bexar County (Northwest)--San Antonio (Far Northwest) & Helotes Cities PUMA, Texas/TX",48029,"Bexar County, Texas",1925865,54207,1271,2815,66,1,82,0,16,30,0,0,112,0,16,0,16,16,128,64,23,0,12,0,0,0,12,88,12,0,12
48,Texas/TX,4805915,"Bexar County (North)--San Antonio City (Far North) & Timberwood Park PUMA, Texas/TX",48029,"Bexar County, Texas",1925865,54207,1271,2815,66,1,0,0,0,0,0,15,0,0,15,15,0,15,15,0,0,100,0,0,0,100,0,0,100,0,100
48,Texas/TX,4805916,"Bexar County (Northeast)--San Antonio (Northeast), Universal City & Converse Cities PUMA, Texas/TX",48029,"Bexar County, Texas",1925865,54207,1271,2815,66,1,21,22,0,54,0,0,75,22,0,0,22,22,97,22,56,0,23,0,23,0,0,77,23,23,0
48,Texas/TX,4806000,"Alamo Area COG (Northwest) & Blanco County PUMA, Texas/TX",48031,"Blanco County, Texas",11279,144,5,1277,44,0.086,20,4,5,17,0,0,37,4,5,0,9,9,46,43,37,0,20,0,9,0,11,80,20,9,11
48,Texas/TX,4806000,"Alamo Area COG (Northwest) & Blanco County PUMA, Texas/TX",48171,"Gillespie County, Texas",26208,310,10,1183,38,0.201,46,10,11,39,0,0,85,10,11,0,21,21,106,43,37,0,20,0,9,0,10,80,20,9,10
48,Texas/TX,4806000,"Alamo Area COG (Northwest) & Blanco County PUMA, Texas/TX",48259,"Kendall County, Texas",41982,331,7,788,17,0.322,73,16,17,63,0,0,136,16,17,0,33,33,169,43,37,0,20,0,9,0,10,80,20,9,10
48,Texas/TX,4806000,"Alamo Area COG (Northwest) & Blanco County PUMA, Texas/TX",48265,"Kerr County, Texas",51365,590,10,1149,19,0.39,89,20,21,76,0,0,165,20,21,0,41,41,206,43,37,0,20,0,10,0,10,80,20,10,10
48,Texas/TX,4806100,"Alamo Area COG (Southwest) PUMA, Texas/TX",48013,"Atascosa County, Texas",48828,1154,30,2363,61,0.352,100,70,68,143,0,0,243,70,68,0,138,138,381,26,38,0,36,0,18,0,18,64,36,18,18
48,Texas/TX,4806100,"Alamo Area COG (Southwest) PUMA, Texas/TX",48019,"Bandera County, Texas",21763,158,8,726,37,0.157,45,31,30,64,0,0,109,31,30,0,61,61,170,26,38,0,36,0,18,0,18,64,36,18,18
48,Texas/TX,4806100,"Alamo Area COG (Southwest) PUMA, Texas/TX",48163,"Frio County, Texas",19394,973,9,5017,46,0.137,39,27,27,56,0,0,95,27,27,0,54,54,149,26,38,0,36,0,18,0,18,64,36,18,18
48,Texas/TX,4806100,"Alamo Area COG (Southwest) PUMA, Texas/TX",48325,"Medina County, Texas",49334,1193,45,2418,91,0.355,101,71,69,144,0,0,245,71,69,0,140,140,385,26,37,0,36,0,18,0,18,64,36,18,18
48,Texas/TX,4806200,"Middle Rio Grande Development Council PUMA, Texas/TX",48127,"Dimmit County, Texas",10663,254,7,2382,66,0.062,11,20,20,62,0,1,73,20,21,1,40,41,114,10,54,1,35,0,18,1,18,64,36,18,18
48,Texas/TX,4806200,"Middle Rio Grande Development Council PUMA, Texas/TX",48137,"Edwards County, Texas",2055,67,1,3260,49,0.011,2,4,4,11,0,0,13,4,4,0,8,8,21,10,52,0,38,0,19,0,19,62,38,19,19
48,Texas/TX,4806200,"Middle Rio Grande Development Council PUMA, Texas/TX",48271,"Kinney County, Texas",3675,44,1,1197,27,0.021,4,7,7,21,0,1,25,7,8,1,14,15,40,10,52,2,35,0,18,2,18,62,38,18,20
48,Texas/TX,4806200,"Middle Rio Grande Development Council PUMA, Texas/TX",48283,"La Salle County, Texas",7409,360,11,4859,148,0.044,8,14,14,44,0,1,52,14,15,1,28,29,81,10,54,1,35,0,17,1,17,64,36,17,19
48,Texas/TX,4806200,"Middle Rio Grande Development Council PUMA, Texas/TX",48323,"Maverick County, Texas",57970,3652,119,6300,205,0.333,59,107,106,333,0,8,392,107,114,8,213,221,613,10,54,1,35,0,17,1,17,64,36,17,19
48,Texas/TX,4806200,"Middle Rio Grande Development Council PUMA, Texas/TX",48385,"Real County, Texas",3389,118,7,3482,207,0.02,4,6,6,20,0,0,24,6,6,0,12,12,36,11,56,0,33,0,17,0,17,67,33,17,17
48,Texas/TX,4806200,"Middle Rio Grande Development Council PUMA, Texas/TX",48463,"Uvalde County, Texas",27009,771,32,2855,118,0.158,28,51,50,158,0,4,186,51,54,4,101,105,291,10,54,1,35,0,18,1,17,64,36,18,19
48,Texas/TX,4806200,"Middle Rio Grande Development Council PUMA, Texas/TX",48465,"Val Verde County, Texas",49027,2168,100,4422,204,0.282,50,90,90,282,0,7,332,90,97,7,180,187,519,10,54,1,35,0,17,1,17,64,36,17,19
48,Texas/TX,4806200,"Middle Rio Grande Development Council PUMA, Texas/TX",48507,"Zavala County, Texas",12131,367,16,3025,132,0.069,12,22,22,69,0,2,81,22,24,2,44,46,127,9,54,2,35,0,17,2,17,64,36,17,19
48,Texas/TX,4806301,"South Texas Development Council (North)--Webb County--Laredo City (Central) PUMA, Texas/TX",48479,"Webb County, Texas",272053,13651,290,5018,107,1,0,10,64,43,0,0,43,10,64,0,74,74,117,0,37,0,63,0,9,0,55,37,63,9,55
48,Texas/TX,4806302,"South Texas Development Council--Webb County (North & East)--Laredo City (Outer) PUMA, Texas/TX",48479,"Webb County, Texas",272053,13651,290,5018,107,1,17,0,152,23,0,0,40,0,152,0,152,152,192,9,12,0,79,0,0,0,79,21,79,0,79
48,Texas/TX,4806400,"South Texas Development Council (South) & Coastal Bend COG (West) PUMA, Texas/TX",48131,"Duval County, Texas",11355,434,14,3822,123,0.106,4,7,29,42,0,0,46,7,29,0,36,36,82,5,51,0,44,0,9,0,35,56,44,9,35
48,Texas/TX,4806400,"South Texas Development Council (South) & Coastal Bend COG (West) PUMA, Texas/TX",48247,"Jim Hogg County, Texas",5282,107,3,2026,57,0.048,2,3,13,19,0,0,21,3,13,0,16,16,37,5,51,0,43,0,8,0,35,57,43,8,35
48,Texas/TX,4806400,"South Texas Development Council (South) & Coastal Bend COG (West) PUMA, Texas/TX",48297,"Live Oak County, Texas",12123,368,9,3036,74,0.112,4,8,31,44,0,0,48,8,31,0,39,39,87,5,51,0,45,0,9,0,36,55,45,9,36
48,Texas/TX,4806400,"South Texas Development Council (South) & Coastal Bend COG (West) PUMA, Texas/TX",48311,"McMullen County, Texas",662,24,0,3625,0,0.007,0,0,2,3,0,0,3,0,2,0,2,2,5,0,60,0,40,0,0,0,40,60,40,0,40
48,Texas/TX,4806400,"South Texas Development Council (South) & Coastal Bend COG (West) PUMA, Texas/TX",48427,"Starr County, Texas",63894,3737,162,5849,254,0.594,23,41,163,236,0,0,259,41,163,0,204,204,463,5,51,0,44,0,9,0,35,56,44,9,35
48,Texas/TX,4806400,"South Texas Development Council (South) & Coastal Bend COG (West) PUMA, Texas/TX",48505,"Zapata County, Texas",14369,333,6,2317,42,0.133,5,9,36,53,0,0,58,9,36,0,45,45,103,5,51,0,44,0,9,0,35,56,44,9,35
48,Texas/TX,4806500,"Coastal Bend COG (Northeast) PUMA, Texas/TX",48007,"Aransas County, Texas",24763,322,18,1300,73,0.193,9,0,13,40,0,0,49,0,13,0,13,13,62,15,65,0,21,0,0,0,21,79,21,0,21
48,Texas/TX,4806500,"Coastal Bend COG (Northeast) PUMA, Texas/TX",48025,"Bee County, Texas",32691,1815,31,5552,95,0.245,12,0,16,51,0,0,63,0,16,0,16,16,79,15,65,0,20,0,0,0,20,80,20,0,20
48,Texas/TX,4806500,"Coastal Bend COG (Northeast) PUMA, Texas/TX",48391,"Refugio County, Texas",7236,304,14,4201,193,0.055,3,0,4,11,0,0,14,0,4,0,4,4,18,17,61,0,22,0,0,0,22,78,22,0,22
48,Texas/TX,4806500,"Coastal Bend COG (Northeast) PUMA, Texas/TX",48409,"San Patricio County, Texas",67046,1460,73,2178,109,0.507,25,0,33,106,0,0,131,0,33,0,33,33,164,15,65,0,20,0,0,0,20,80,20,0,20
48,Texas/TX,4806601,"Coastal Bend COG--Nueces County--Corpus Christi City (Outer) PUMA, Texas/TX",48355,"Nueces County, Texas",360486,20451,411,5673,114,1,157,10,101,158,0,65,315,10,166,65,111,176,491,32,32,13,23,0,2,13,21,64,36,2,34
48,Texas/TX,4806602,"Coastal Bend COG--Nueces County (Central)--Corpus Christi City (North Central) PUMA, Texas/TX",48355,"Nueces County, Texas",360486,20451,411,5673,114,1,69,10,82,112,0,0,181,10,82,0,92,92,273,25,41,0,34,0,4,0,30,66,34,4,30
48,Texas/TX,4806603,"Coastal Bend COG--Nueces County (Central)--Corpus Christi City (South Central) PUMA, Texas/TX",48355,"Nueces County, Texas",360486,20451,411,5673,114,1,41,0,0,97,15,0,138,15,0,15,0,15,153,27,63,10,0,10,0,0,0,90,10,10,0
48,Texas/TX,4806701,"Cameron County (East)--Brownsville City (North) PUMA, Texas/TX",48061,"Cameron County, Texas",421750,22698,913,5382,216,1,41,45,435,133,0,0,174,45,435,0,480,480,654,6,20,0,73,0,7,0,67,27,73,7,67
48,Texas/TX,4806702,"Cameron County (West)--Harlingen & San Benito Cities PUMA, Texas/TX",48061,"Cameron County, Texas",421750,22698,913,5382,216,1,59,39,459,263,0,0,322,39,459,0,498,498,820,7,32,0,61,0,5,0,56,39,61,5,56
48,Texas/TX,4806703,"Cameron County (South)--Brownsville City (Central) PUMA, Texas/TX",48061,"Cameron County, Texas",421750,22698,913,5382,216,1,10,83,249,93,0,0,103,83,249,0,332,332,435,2,21,0,76,0,19,0,57,24,76,19,57
48,Texas/TX,4806801,"Hidalgo County (Southeast)--Weslaco & Mercedes Cities PUMA, Texas/TX",48215,"Hidalgo County, Texas",849389,31502,1630,3709,192,1,0,46,401,308,0,0,308,46,401,0,447,447,755,0,41,0,59,0,6,0,53,41,59,6,53
48,Texas/TX,4806802,"Hidalgo County (East)--Alamo & Donna Cities PUMA, Texas/TX",48215,"Hidalgo County, Texas",849389,31502,1630,3709,192,1,0,26,945,187,0,0,187,26,945,0,971,971,1158,0,16,0,84,0,2,0,82,16,84,2,82
48,Texas/TX,4806803,"Hidalgo County (South Central)--Pharr, San Juan & Hidalgo Cities PUMA, Texas/TX",48215,"Hidalgo County, Texas",849389,31502,1630,3709,192,1,0,0,204,187,0,0,187,0,204,0,204,204,391,0,48,0,52,0,0,0,52,48,52,0,52
48,Texas/TX,4806804,"Hidalgo County (North Central)--Edinburg City PUMA, Texas/TX",48215,"Hidalgo County, Texas",849389,31502,1630,3709,192,1,0,65,495,98,0,0,98,65,495,0,560,560,658,0,15,0,85,0,10,0,75,15,85,10,75
48,Texas/TX,4806805,"Hidalgo County (Central)--McAllen City PUMA, Texas/TX",48215,"Hidalgo County, Texas",849389,31502,1630,3709,192,1,33,44,189,151,0,0,184,44,189,0,233,233,417,8,36,0,56,0,11,0,45,44,56,11,45
48,Texas/TX,4806806,"Hidalgo County (Southwest)--Mission City PUMA, Texas/TX",48215,"Hidalgo County, Texas",849389,31502,1630,3709,192,1,0,26,190,204,0,0,204,26,190,0,216,216,420,0,49,0,51,0,6,0,45,49,51,6,45
48,Texas/TX,4806807,"Hidalgo County (North & West) PUMA, Texas/TX",48215,"Hidalgo County, Texas",849389,31502,1630,3709,192,1,0,90,795,245,0,0,245,90,795,0,885,885,1130,0,22,0,78,0,8,0,70,22,78,8,70
48,Texas/TX,4806900,"Coastal Bend COG (Southeast) & Willacy County PUMA, Texas/TX",48047,"Brooks County, Texas",7180,312,22,4345,306,0.071,32,7,8,49,0,0,81,7,8,0,15,15,96,33,51,0,16,0,7,0,8,84,16,7,8
48,Texas/TX,4806900,"Coastal Bend COG (Southeast) & Willacy County PUMA, Texas/TX",48249,"Jim Wells County, Texas",41192,1457,36,3537,87,0.402,178,41,44,277,0,0,455,41,44,0,85,85,540,33,51,0,16,0,8,0,8,84,16,8,8
48,Texas/TX,4806900,"Coastal Bend COG (Southeast) & Willacy County PUMA, Texas/TX",48261,"Kenedy County, Texas",595,7,2,1176,336,0.004,2,0,0,3,0,0,5,0,0,0,0,0,5,40,60,0,0,0,0,0,0,100,0,0,0
48,Texas/TX,4806900,"Coastal Bend COG (Southeast) & Willacy County PUMA, Texas/TX",48273,"Kleberg County, Texas",31425,997,41,3173,130,0.31,138,32,34,214,0,0,352,32,34,0,66,66,418,33,51,0,16,0,8,0,8,84,16,8,8
48,Texas/TX,4806900,"Coastal Bend COG (Southeast) & Willacy County PUMA, Texas/TX",48489,"Willacy County, Texas",21754,1207,48,5548,221,0.213,95,22,23,147,0,0,242,22,23,0,45,45,287,33,51,0,16,0,8,0,8,84,16,8,8
49,Utah/UT,4903001,"Tooele & Box Elder Counties PUMA, Utah/UT",49003,"Box Elder County, Utah",53001,550,5,1038,9,0.45,346,40,5,29,0,0,375,40,5,0,45,45,420,82,7,0,11,0,10,0,1,89,11,10,1
49,Utah/UT,4903001,"Tooele & Box Elder Counties PUMA, Utah/UT",49045,"Tooele County, Utah",65185,857,0,1315,0,0.55,423,50,6,35,0,0,458,50,6,0,56,56,514,82,7,0,11,0,10,0,1,89,11,10,1
49,Utah/UT,4905001,"Cache, Summit, Morgan & Rich Counties PUMA, Utah/UT",49005,"Cache County, Utah",122336,2695,6,2203,5,0.694,986,83,195,214,74,141,1200,157,336,215,278,493,1693,58,13,13,16,4,5,8,12,71,29,9,20
49,Utah/UT,4905001,"Cache, Summit, Morgan & Rich Counties PUMA, Utah/UT",49029,"Morgan County, Utah",11391,100,0,878,0,0.065,92,8,18,20,7,13,112,15,31,20,26,46,158,58,13,13,16,4,5,8,11,71,29,9,20
49,Utah/UT,4905001,"Cache, Summit, Morgan & Rich Counties PUMA, Utah/UT",49033,"Rich County, Utah",2350,18,0,766,0,0.013,18,2,4,4,1,3,22,3,7,4,6,10,32,56,12,12,19,3,6,9,12,69,31,9,22
49,Utah/UT,4905001,"Cache, Summit, Morgan & Rich Counties PUMA, Utah/UT",49043,"Summit County, Utah",40511,981,1,2422,2,0.228,324,27,64,70,24,46,394,51,110,70,91,161,555,58,13,13,16,4,5,8,12,71,29,9,20
49,Utah/UT,4911001,"Davis County (North)--Layton, Clearfield, Kaysville, Syracuse & Clinton Cities PUMA, Utah/UT",49011,"Davis County, Utah",340621,4966,28,1458,8,1,391,80,49,43,28,56,434,108,105,84,129,213,647,60,7,13,20,4,12,9,8,67,33,17,16
49,Utah/UT,4911002,"Davis County (South)--Bountiful, Farmington & North Salt Lake Cities PUMA, Utah/UT",49011,"Davis County, Utah",340621,4966,28,1458,8,1,119,0,0,94,0,0,213,0,0,0,0,0,213,56,44,0,0,0,0,0,0,100,0,0,0
49,Utah/UT,4913001,"Southeast Utah & Uintah Basin Region PUMA, Utah/UT",49007,"Carbon County, Utah",20356,117,0,575,0,0.14,34,0,47,0,0,0,34,0,47,0,47,47,81,42,0,0,58,0,0,0,58,42,58,0,58
49,Utah/UT,4913001,"Southeast Utah & Uintah Basin Region PUMA, Utah/UT",49009,"Daggett County, Utah",612,1,0,163,0,0.008,2,0,3,0,0,0,2,0,3,0,3,3,5,40,0,0,60,0,0,0,60,40,60,0,60
49,Utah/UT,4913001,"Southeast Utah & Uintah Basin Region PUMA, Utah/UT",49013,"Duchesne County, Utah",20219,106,0,524,0,0.14,34,0,47,0,0,0,34,0,47,0,47,47,81,42,0,0,58,0,0,0,58,42,58,0,58
49,Utah/UT,4913001,"Southeast Utah & Uintah Basin Region PUMA, Utah/UT",49015,"Emery County, Utah",10248,36,0,351,0,0.07,17,0,24,0,0,0,17,0,24,0,24,24,41,41,0,0,59,0,0,0,59,41,59,0,59
49,Utah/UT,4913001,"Southeast Utah & Uintah Basin Region PUMA, Utah/UT",49019,"Grand County, Utah",9616,57,1,593,10,0.066,16,0,22,0,0,0,16,0,22,0,22,22,38,42,0,0,58,0,0,0,58,42,58,0,58
49,Utah/UT,4913001,"Southeast Utah & Uintah Basin Region PUMA, Utah/UT",49037,"San Juan County, Utah",15281,697,29,4561,190,0.116,28,0,39,0,0,0,28,0,39,0,39,39,67,42,0,0,58,0,0,0,58,42,58,0,58
49,Utah/UT,4913001,"Southeast Utah & Uintah Basin Region PUMA, Utah/UT",49047,"Uintah County, Utah",36323,109,0,300,0,0.25,61,0,84,0,0,0,61,0,84,0,84,84,145,42,0,0,58,0,0,0,58,42,58,0,58
49,Utah/UT,4913001,"Southeast Utah & Uintah Basin Region PUMA, Utah/UT",49051,"Wasatch County, Utah",30523,745,7,2441,23,0.21,51,0,71,0,0,0,51,0,71,0,71,71,122,42,0,0,58,0,0,0,58,42,58,0,58
49,Utah/UT,4921001,"Southwest & South Central Utah (Outside Washington County)--Cedar City PUMA, Utah/UT",49001,"Beaver County, Utah",6443,38,0,590,0,0.044,52,2,40,7,0,3,59,2,43,3,42,45,104,50,7,3,40,0,2,3,38,57,43,2,41
49,Utah/UT,4921001,"Southwest & South Central Utah (Outside Washington County)--Cedar City PUMA, Utah/UT",49017,"Garfield County, Utah",5017,48,2,957,40,0.034,40,2,31,5,0,2,45,2,33,2,33,35,80,50,6,2,41,0,2,2,39,56,44,2,41
49,Utah/UT,4921001,"Southwest & South Central Utah (Outside Washington County)--Cedar City PUMA, Utah/UT",49021,"Iron County, Utah",49691,734,3,1477,6,0.339,402,16,311,54,1,21,456,17,332,22,327,349,805,50,7,3,41,0,2,3,39,57,43,2,41
49,Utah/UT,4921001,"Southwest & South Central Utah (Outside Washington County)--Cedar City PUMA, Utah/UT",49023,"Juab County, Utah",10948,126,1,1151,9,0.075,89,4,69,12,0,5,101,4,74,5,73,78,179,50,7,3,41,0,2,3,39,56,44,2,41
49,Utah/UT,4921001,"Southwest & South Central Utah (Outside Washington County)--Cedar City PUMA, Utah/UT",49025,"Kane County, Utah",7350,75,1,1020,14,0.05,59,2,46,8,0,3,67,2,49,3,48,51,118,50,7,3,41,0,2,3,39,57,43,2,42
49,Utah/UT,4921001,"Southwest & South Central Utah (Outside Washington County)--Cedar City PUMA, Utah/UT",49027,"Millard County, Utah",12733,185,0,1453,0,0.086,102,4,79,14,0,5,116,4,84,5,83,88,204,50,7,2,41,0,2,2,39,57,43,2,41
49,Utah/UT,4921001,"Southwest & South Central Utah (Outside Washington County)--Cedar City PUMA, Utah/UT",49031,"Piute County, Utah",1904,7,0,368,0,0.01,12,0,9,2,0,1,14,0,10,1,9,10,24,50,8,4,38,0,0,4,38,58,42,0,42
49,Utah/UT,4921001,"Southwest & South Central Utah (Outside Washington County)--Cedar City PUMA, Utah/UT",49039,"Sanpete County, Utah",29366,211,1,719,3,0.2,237,10,183,32,1,12,269,11,195,13,193,206,475,50,7,3,41,0,2,3,39,57,43,2,41
49,Utah/UT,4921001,"Southwest & South Central Utah (Outside Washington County)--Cedar City PUMA, Utah/UT",49041,"Sevier County, Utah",21118,105,1,497,5,0.144,171,7,132,23,0,9,194,7,141,9,139,148,342,50,7,3,41,0,2,3,39,57,43,2,41
49,Utah/UT,4921001,"Southwest & South Central Utah (Outside Washington County)--Cedar City PUMA, Utah/UT",49055,"Wayne County, Utah",2694,2,0,74,0,0.018,21,1,17,3,0,1,24,1,18,1,18,19,43,49,7,2,42,0,2,2,40,56,44,2,42
49,Utah/UT,4935001,"Salt Lake County (Northwest)--Salt Lake City (West), West Valley City (West) & Magna PUMA, Utah/UT",49035,"Salt Lake County, Utah",1120805,29977,250,2675,22,1,102,38,502,138,76,27,240,114,529,103,540,643,883,12,16,12,61,9,4,3,57,27,73,13,60
49,Utah/UT,4935002,"Salt Lake County (Northeast)--Salt Lake City (East) PUMA, Utah/UT",49035,"Salt Lake County, Utah",1120805,29977,250,2675,22,1,214,0,145,23,0,15,237,0,160,15,145,160,397,54,6,4,37,0,0,4,37,60,40,0,40
49,Utah/UT,4935003,"Salt Lake County--West Valley City (Central), Salt Lake City (South Central) & Kearns PUMA, Utah/UT",49035,"Salt Lake County, Utah",1120805,29977,250,2675,22,1,185,0,329,150,39,127,335,39,456,166,329,495,830,22,18,20,40,5,0,15,40,40,60,5,55
49,Utah/UT,4935004,"Salt Lake County--West Valley City (East), Taylorsville & Murray (West) Cities PUMA, Utah/UT",49035,"Salt Lake County, Utah",1120805,29977,250,2675,22,1,117,20,92,379,33,30,496,53,122,63,112,175,671,17,56,9,17,5,3,4,14,74,26,8,18
49,Utah/UT,4935005,"Salt Lake County (East Central)--Murray (East), Holladay Cities & Millcreek PUMA, Utah/UT",49035,"Salt Lake County, Utah",1120805,29977,250,2675,22,1,156,11,68,0,0,0,156,11,68,0,79,79,235,66,0,0,34,0,5,0,29,66,34,5,29
49,Utah/UT,4935006,"Salt Lake County--West Jordan (West), Herriman & South Jordan (West) Cities PUMA, Utah/UT",49035,"Salt Lake County, Utah",1120805,29977,250,2675,22,1,77,151,38,0,0,0,77,151,38,0,189,189,266,29,0,0,71,0,57,0,14,29,71,57,14
49,Utah/UT,4935007,"Salt Lake County--West Jordan (East), South Jordan (East) & Riverton Cities PUMA, Utah/UT",49035,"Salt Lake County, Utah",1120805,29977,250,2675,22,1,84,0,15,0,65,71,84,65,86,136,15,151,235,36,0,58,6,28,0,30,6,36,64,28,37
49,Utah/UT,4935008,"Salt Lake County (Southeast)--Sandy (North), Cottonwood Heights & Midvale Cities PUMA, Utah/UT",49035,"Salt Lake County, Utah",1120805,29977,250,2675,22,1,62,0,0,0,0,0,62,0,0,0,0,0,62,100,0,0,0,0,0,0,0,100,0,0,0
49,Utah/UT,4935009,"Salt Lake County (South & East Central)--Draper (Northwest) & Sandy (South) Cities PUMA, Utah/UT",49035,"Salt Lake County, Utah",1120805,29977,250,2675,22,1,106,0,0,0,0,0,106,0,0,0,0,0,106,100,0,0,0,0,0,0,0,100,0,0,0
49,Utah/UT,4949001,"Utah County (West)--Saratoga Springs, Payson & Lehi (Southwest) Cities PUMA, Utah/UT",49049,"Utah County, Utah",590440,17584,54,2978,9,1,472,28,193,111,12,0,583,40,193,12,221,233,816,58,14,1,27,1,3,0,24,71,29,5,24
49,Utah/UT,4949002,"Utah County (Central)--Orem, Pleasant Grove, American Fork & Lindon Cities PUMA, Utah/UT",49049,"Utah County, Utah",590440,17584,54,2978,9,1,274,21,172,65,36,0,339,57,172,36,193,229,568,48,11,6,34,6,4,0,30,60,40,10,30
49,Utah/UT,4949003,"Utah County (Central)--Provo City PUMA, Utah/UT",49049,"Utah County, Utah",590440,17584,54,2978,9,1,155,17,98,0,0,0,155,17,98,0,115,115,270,57,0,0,43,0,6,0,36,57,43,6,36
49,Utah/UT,4949004,"Utah County (East)--Spanish Fork, Springville, Lehi (Northeast) & Highland Cities PUMA, Utah/UT",49049,"Utah County, Utah",590440,17584,54,2978,9,1,301,157,144,7,15,36,308,172,180,51,301,352,660,46,1,8,46,2,24,5,22,47,53,26,27
49,Utah/UT,4953001,"Washington County--St. George City PUMA, Utah/UT",49053,"Washington County, Utah",160537,3269,26,2036,16,1,411,0,0,0,0,47,411,0,47,47,0,47,458,90,0,10,0,0,0,10,0,90,10,0,10
49,Utah/UT,4957001,"Weber County (West)--Roy, North Ogden, Ogden (Northwest) & West Haven Cities PUMA, Utah/UT",49057,"Weber County, Utah",247731,4117,31,1662,13,1,376,126,95,196,44,0,572,170,95,44,221,265,837,45,23,5,26,5,15,0,11,68,32,20,11
49,Utah/UT,4957002,"Weber County (East)--Ogden (Southeast) & South Ogden Cities PUMA, Utah/UT",49057,"Weber County, Utah",247731,4117,31,1662,13,1,283,170,187,38,10,23,321,180,210,33,357,390,711,40,5,5,50,1,24,3,26,45,55,25,30
50,Vermont/VT,5000100,"Northwest Vermont--Chittenden, Franklin & Grand Isle Counties--Burlington City PUMA, Vermont/VT",50007,"Chittenden County, Vermont",162052,835,39,515,24,0.743,1311,35,76,0,74,221,1311,109,297,295,111,406,1717,76,0,17,6,4,2,13,4,76,24,6,17
50,Vermont/VT,5000100,"Northwest Vermont--Chittenden, Franklin & Grand Isle Counties--Burlington City PUMA, Vermont/VT",50011,"Franklin County, Vermont",49025,125,7,255,14,0.225,397,11,23,0,22,67,397,33,90,89,34,123,520,76,0,17,7,4,2,13,4,76,24,6,17
50,Vermont/VT,5000100,"Northwest Vermont--Chittenden, Franklin & Grand Isle Counties--Burlington City PUMA, Vermont/VT",50013,"Grand Isle County, Vermont",6965,14,0,201,0,0.032,56,2,3,0,3,10,56,5,13,13,5,18,74,76,0,18,7,4,3,14,4,76,24,7,18
50,Vermont/VT,5000200,"Northeast Vermont--Washington, Caledonia, Orleans, Lamoille & Essex Counties PUMA, Vermont/VT",50005,"Caledonia County, Vermont",30425,34,0,112,0,0.206,342,0,0,17,0,0,359,0,0,0,0,0,359,95,5,0,0,0,0,0,0,100,0,0,0
50,Vermont/VT,5000200,"Northeast Vermont--Washington, Caledonia, Orleans, Lamoille & Essex Counties PUMA, Vermont/VT",50009,"Essex County, Vermont",6208,6,0,97,0,0.042,70,0,0,3,0,0,73,0,0,0,0,0,73,96,4,0,0,0,0,0,0,100,0,0,0
50,Vermont/VT,5000200,"Northeast Vermont--Washington, Caledonia, Orleans, Lamoille & Essex Counties PUMA, Vermont/VT",50015,"Lamoille County, Vermont",25268,57,1,226,4,0.172,285,0,0,14,0,0,299,0,0,0,0,0,299,95,5,0,0,0,0,0,0,100,0,0,0
50,Vermont/VT,5000200,"Northeast Vermont--Washington, Caledonia, Orleans, Lamoille & Essex Counties PUMA, Vermont/VT",50019,"Orleans County, Vermont",26911,21,0,78,0,0.182,302,0,0,15,0,0,317,0,0,0,0,0,317,95,5,0,0,0,0,0,0,100,0,0,0
50,Vermont/VT,5000200,"Northeast Vermont--Washington, Caledonia, Orleans, Lamoille & Essex Counties PUMA, Vermont/VT",50023,"Washington County, Vermont",58477,77,2,132,3,0.397,658,0,0,33,0,0,691,0,0,0,0,0,691,95,5,0,0,0,0,0,0,100,0,0,0
50,Vermont/VT,5000300,"Southeast Vermont--Windsor, Windham & Orange Counties PUMA, Vermont/VT",50017,"Orange County, Vermont",28937,24,0,83,0,0.227,229,0,22,0,6,0,229,6,22,6,22,28,257,89,0,2,9,2,0,0,9,89,11,2,9
50,Vermont/VT,5000300,"Southeast Vermont--Windsor, Windham & Orange Counties PUMA, Vermont/VT",50025,"Windham County, Vermont",43150,123,3,285,7,0.338,340,0,32,0,9,0,340,9,32,9,32,41,381,89,0,2,8,2,0,0,8,89,11,2,8
50,Vermont/VT,5000300,"Southeast Vermont--Windsor, Windham & Orange Counties PUMA, Vermont/VT",50027,"Windsor County, Vermont",55427,86,2,155,4,0.435,438,0,42,0,11,0,438,11,42,11,42,53,491,89,0,2,9,2,0,0,9,89,11,2,9
50,Vermont/VT,5000400,"Southwest Vermont--Rutland, Bennington & Addison Counties PUMA, Vermont/VT",50001,"Addison County, Vermont",36939,83,2,225,5,0.279,455,0,7,0,0,4,455,0,11,4,7,11,466,98,0,1,2,0,0,1,2,98,2,0,2
50,Vermont/VT,5000400,"Southwest Vermont--Rutland, Bennington & Addison Counties PUMA, Vermont/VT",50003,"Bennington County, Vermont",35920,110,1,306,3,0.273,445,0,7,0,0,4,445,0,11,4,7,11,456,98,0,1,2,0,0,1,2,98,2,0,2
50,Vermont/VT,5000400,"Southwest Vermont--Rutland, Bennington & Addison Counties PUMA, Vermont/VT",50021,"Rutland County, Vermont",59273,128,1,216,2,0.448,731,0,11,0,0,7,731,0,18,7,11,18,749,98,0,1,1,0,0,1,1,98,2,0,2
51,Virginia/VA,5101301,"Arlington County (North) PUMA, Virginia/VA",51013,"Arlington County, Virginia",231803,3909,148,1686,64,1,0,0,0,0,0,4,0,0,4,4,0,4,4,0,0,100,0,0,0,100,0,0,100,0,100
51,Virginia/VA,5101302,"Arlington County (South) PUMA, Virginia/VA",51013,"Arlington County, Virginia",231803,3909,148,1686,64,1,0,0,47,0,0,0,0,0,47,0,47,47,47,0,0,0,100,0,0,0,100,0,100,0,100
51,Virginia/VA,5104101,"Chesterfield County (East)--James River Region PUMA, Virginia/VA",51041,"Chesterfield County, Virginia",339447,5916,94,1743,28,1,154,0,27,0,0,0,154,0,27,0,27,27,181,85,0,0,15,0,0,0,15,85,15,0,15
51,Virginia/VA,5104102,"Chesterfield County (Central)--Chester & Rockwood PUMA, Virginia/VA",51041,"Chesterfield County, Virginia",339447,5916,94,1743,28,1,76,21,16,0,0,0,76,21,16,0,37,37,113,67,0,0,33,0,19,0,14,67,33,19,14
51,Virginia/VA,5104103,"Chesterfield County (West)--Brandermill & Woodlake PUMA, Virginia/VA",51041,"Chesterfield County, Virginia",339447,5916,94,1743,28,1,187,0,0,0,0,0,187,0,0,0,0,0,187,100,0,0,0,0,0,0,0,100,0,0,0
51,Virginia/VA,5110701,"Loudoun County (Northeast)--Sterling & Ashburn (Northeast/Ashburn Village) PUMA, Virginia/VA",51107,"Loudoun County, Virginia",385143,6774,124,1759,32,1,128,0,57,82,14,0,210,14,57,14,57,71,281,46,29,5,20,5,0,0,20,75,25,5,20
51,Virginia/VA,5110702,"Loudoun County (East Central)--Ashburn (Southwest/Belmont Ridge) & Dulles Airport PUMA, Virginia/VA",51107,"Loudoun County, Virginia",385143,6774,124,1759,32,1,20,0,0,0,0,0,20,0,0,0,0,0,20,100,0,0,0,0,0,0,0,100,0,0,0
51,Virginia/VA,5110703,"Loudoun County (West & South)--Leesburg Town PUMA, Virginia/VA",51107,"Loudoun County, Virginia",385143,6774,124,1759,32,1,153,0,49,19,23,0,172,23,49,23,49,72,244,63,8,9,20,9,0,0,20,70,30,9,20
51,Virginia/VA,5151010,"LENOWISCO & Cumberland Plateau Planning District Commissions PUMA, Virginia/VA",51027,"Buchanan County, Virginia",22138,137,2,619,9,0.113,64,1,3,0,0,0,64,1,3,0,4,4,68,94,0,0,6,0,1,0,4,94,6,1,4
51,Virginia/VA,5151010,"LENOWISCO & Cumberland Plateau Planning District Commissions PUMA, Virginia/VA",51051,"Dickenson County, Virginia",14960,99,1,662,7,0.076,43,1,2,0,0,0,43,1,2,0,3,3,46,93,0,0,7,0,2,0,4,93,7,2,4
51,Virginia/VA,5151010,"LENOWISCO & Cumberland Plateau Planning District Commissions PUMA, Virginia/VA",51105,"Lee County, Virginia",24134,266,7,1102,29,0.123,70,1,3,0,0,0,70,1,3,0,4,4,74,95,0,0,5,0,1,0,4,95,5,1,4
51,Virginia/VA,5151010,"LENOWISCO & Cumberland Plateau Planning District Commissions PUMA, Virginia/VA",51167,"Russell County, Virginia",27408,254,5,927,18,0.14,80,1,3,0,0,0,80,1,3,0,4,4,84,95,0,0,5,0,1,0,4,95,5,1,4
51,Virginia/VA,5151010,"LENOWISCO & Cumberland Plateau Planning District Commissions PUMA, Virginia/VA",51169,"Scott County, Virginia",22009,184,4,836,18,0.112,64,1,3,0,0,0,64,1,3,0,4,4,68,94,0,0,6,0,1,0,4,94,6,1,4
51,Virginia/VA,5151010,"LENOWISCO & Cumberland Plateau Planning District Commissions PUMA, Virginia/VA",51185,"Tazewell County, Virginia",42080,284,2,675,5,0.215,123,2,5,0,0,0,123,2,5,0,7,7,130,95,0,0,5,0,2,0,4,95,5,2,4
51,Virginia/VA,5151010,"LENOWISCO & Cumberland Plateau Planning District Commissions PUMA, Virginia/VA",51195,"Wise County, Virginia",39025,400,9,1025,23,0.2,114,2,5,0,0,0,114,2,5,0,7,7,121,94,0,0,6,0,2,0,4,94,6,2,4
51,Virginia/VA,5151010,"LENOWISCO & Cumberland Plateau Planning District Commissions PUMA, Virginia/VA",51720,"Norton city, Virginia",3990,33,0,827,0,0.02,11,0,0,0,0,0,11,0,0,0,0,0,11,100,0,0,0,0,0,0,0,100,0,0,0
51,Virginia/VA,5151020,"Mount Rogers Planning District Commission PUMA, Virginia/VA",51021,"Bland County, Virginia",6447,64,5,993,78,0.034,31,0,5,0,0,0,31,0,5,0,5,5,36,86,0,0,14,0,0,0,14,86,14,0,14
51,Virginia/VA,5151020,"Mount Rogers Planning District Commission PUMA, Virginia/VA",51035,"Carroll County, Virginia",29738,492,24,1654,81,0.156,144,0,24,0,0,0,144,0,24,0,24,24,168,86,0,0,14,0,0,0,14,86,14,0,14
51,Virginia/VA,5151020,"Mount Rogers Planning District Commission PUMA, Virginia/VA",51077,"Grayson County, Virginia",15811,308,12,1948,76,0.08,74,0,13,0,0,0,74,0,13,0,13,13,87,85,0,0,15,0,0,0,15,85,15,0,15
51,Virginia/VA,5151020,"Mount Rogers Planning District Commission PUMA, Virginia/VA",51173,"Smyth County, Virginia",31059,457,10,1471,32,0.164,151,0,26,0,0,0,151,0,26,0,26,26,177,85,0,0,15,0,0,0,15,85,15,0,15
51,Virginia/VA,5151020,"Mount Rogers Planning District Commission PUMA, Virginia/VA",51191,"Washington County, Virginia",54406,553,20,1016,37,0.287,264,0,45,0,0,0,264,0,45,0,45,45,309,85,0,0,15,0,0,0,15,85,15,0,15
51,Virginia/VA,5151020,"Mount Rogers Planning District Commission PUMA, Virginia/VA",51197,"Wythe County, Virginia",28940,232,4,802,14,0.153,141,0,24,0,0,0,141,0,24,0,24,24,165,85,0,0,15,0,0,0,15,85,15,0,15
51,Virginia/VA,5151020,"Mount Rogers Planning District Commission PUMA, Virginia/VA",51520,"Bristol city, Virginia",16843,182,5,1081,30,0.09,83,0,14,0,0,0,83,0,14,0,14,14,97,86,0,0,14,0,0,0,14,86,14,0,14
51,Virginia/VA,5151020,"Mount Rogers Planning District Commission PUMA, Virginia/VA",51640,"Galax city, Virginia",6638,413,30,6222,452,0.036,33,0,6,0,0,0,33,0,6,0,6,6,39,85,0,0,15,0,0,0,15,85,15,0,15
51,Virginia/VA,5151040,"New River Valley Planning District Commission PUMA, Virginia/VA",51063,"Floyd County, Virginia",15666,201,9,1283,57,0.086,47,0,4,0,5,0,47,5,4,5,4,9,56,84,0,9,7,9,0,0,7,84,16,9,7
51,Virginia/VA,5151040,"New River Valley Planning District Commission PUMA, Virginia/VA",51071,"Giles County, Virginia",16814,88,0,523,0,0.092,50,0,4,0,5,0,50,5,4,5,4,9,59,85,0,8,7,8,0,0,7,85,15,8,7
51,Virginia/VA,5151040,"New River Valley Planning District Commission PUMA, Virginia/VA",51121,"Montgomery County, Virginia",97997,1880,4,1918,4,0.539,293,0,24,0,29,0,293,29,24,29,24,53,346,85,0,8,7,8,0,0,7,85,15,8,7
51,Virginia/VA,5151040,"New River Valley Planning District Commission PUMA, Virginia/VA",51155,"Pulaski County, Virginia",34234,225,5,657,15,0.187,102,0,8,0,10,0,102,10,8,10,8,18,120,85,0,8,7,8,0,0,7,85,15,8,7
51,Virginia/VA,5151040,"New River Valley Planning District Commission PUMA, Virginia/VA",51750,"Radford city, Virginia",17630,734,1,4163,6,0.096,52,0,4,0,5,0,52,5,4,5,4,9,61,85,0,8,7,8,0,0,7,85,15,8,7
51,Virginia/VA,5151044,"Roanoke Valley-Alleghany Regional Commission (Roanoke, Salem Cities & Vinton Town) PUMA, Virginia/VA",51161,"Roanoke County, Virginia",93583,842,7,900,7,0.062,8,0,0,0,1,7,8,1,7,8,0,8,16,50,0,50,0,6,0,44,0,50,50,6,44
51,Virginia/VA,5151044,"Roanoke Valley-Alleghany Regional Commission (Roanoke, Salem Cities & Vinton Town) PUMA, Virginia/VA",51770,"Roanoke city, Virginia",99621,1656,23,1662,23,0.747,100,0,0,0,14,79,100,14,79,93,0,93,193,52,0,48,0,7,0,41,0,52,48,7,41
51,Virginia/VA,5151044,"Roanoke Valley-Alleghany Regional Commission (Roanoke, Salem Cities & Vinton Town) PUMA, Virginia/VA",51775,"Salem city, Virginia",25519,264,5,1035,20,0.191,26,0,0,0,4,20,26,4,20,24,0,24,50,52,0,48,0,8,0,40,0,52,48,8,40
51,Virginia/VA,5151045,"Roanoke Valley-Alleghany Regional Commission (Outside Roanoke & Salem Cities) PUMA, Virginia/VA",51005,"Alleghany County, Virginia",15286,78,4,510,26,0.077,48,0,4,0,0,0,48,0,4,0,4,4,52,92,0,0,8,0,0,0,8,92,8,0,8
51,Virginia/VA,5151045,"Roanoke Valley-Alleghany Regional Commission (Outside Roanoke & Salem Cities) PUMA, Virginia/VA",51023,"Botetourt County, Virginia",33222,297,10,894,30,0.165,103,0,9,0,0,0,103,0,9,0,9,9,112,92,0,0,8,0,0,0,8,92,8,0,8
51,Virginia/VA,5151045,"Roanoke Valley-Alleghany Regional Commission (Outside Roanoke & Salem Cities) PUMA, Virginia/VA",51045,"Craig County, Virginia",5113,29,0,567,0,0.026,16,0,1,0,0,0,16,0,1,0,1,1,17,94,0,0,6,0,0,0,6,94,6,0,6
51,Virginia/VA,5151045,"Roanoke Valley-Alleghany Regional Commission (Outside Roanoke & Salem Cities) PUMA, Virginia/VA",51067,"Franklin County, Virginia",56233,333,3,592,5,0.278,173,0,15,0,0,0,173,0,15,0,15,15,188,92,0,0,8,0,0,0,8,92,8,0,8
51,Virginia/VA,5151045,"Roanoke Valley-Alleghany Regional Commission (Outside Roanoke & Salem Cities) PUMA, Virginia/VA",51161,"Roanoke County, Virginia",93583,842,7,900,7,0.426,265,0,23,0,0,0,265,0,23,0,23,23,288,92,0,0,8,0,0,0,8,92,8,0,8
51,Virginia/VA,5151045,"Roanoke Valley-Alleghany Regional Commission (Outside Roanoke & Salem Cities) PUMA, Virginia/VA",51580,"Covington city, Virginia",5582,32,0,573,0,0.027,17,0,1,0,0,0,17,0,1,0,1,1,18,94,0,0,6,0,0,0,6,94,6,0,6
51,Virginia/VA,5151080,"Central Shenandoah Planning District Commission (Southwest) PUMA, Virginia/VA",51015,"Augusta County, Virginia",74701,478,7,640,9,0.458,781,0,22,7,30,0,788,30,22,30,22,52,840,93,1,4,3,4,0,0,3,94,6,4,3
51,Virginia/VA,5151080,"Central Shenandoah Planning District Commission (Southwest) PUMA, Virginia/VA",51017,"Bath County, Virginia",4393,7,0,159,0,0.027,46,0,1,0,2,0,46,2,1,2,1,3,49,94,0,4,2,4,0,0,2,94,6,4,2
51,Virginia/VA,5151080,"Central Shenandoah Planning District Commission (Southwest) PUMA, Virginia/VA",51091,"Highland County, Virginia",2214,7,0,316,0,0.014,24,0,1,0,1,0,24,1,1,1,1,2,26,92,0,4,4,4,0,0,4,92,8,4,4
51,Virginia/VA,5151080,"Central Shenandoah Planning District Commission (Southwest) PUMA, Virginia/VA",51163,"Rockbridge County, Virginia",22509,108,2,480,9,0.137,234,0,7,2,9,0,236,9,7,9,7,16,252,93,1,4,3,4,0,0,3,94,6,4,3
51,Virginia/VA,5151080,"Central Shenandoah Planning District Commission (Southwest) PUMA, Virginia/VA",51530,"Buena Vista city, Virginia",6399,80,1,1250,16,0.039,67,0,2,1,3,0,68,3,2,3,2,5,73,92,1,4,3,4,0,0,3,93,7,4,3
51,Virginia/VA,5151080,"Central Shenandoah Planning District Commission (Southwest) PUMA, Virginia/VA",51678,"Lexington city, Virginia",7110,73,1,1027,14,0.043,73,0,2,1,3,0,74,3,2,3,2,5,79,92,1,4,3,4,0,0,3,94,6,4,3
51,Virginia/VA,5151080,"Central Shenandoah Planning District Commission (Southwest) PUMA, Virginia/VA",51790,"Staunton city, Virginia",24452,251,0,1027,0,0.149,254,0,7,2,10,0,256,10,7,10,7,17,273,93,1,4,3,4,0,0,3,94,6,4,3
51,Virginia/VA,5151080,"Central Shenandoah Planning District Commission (Southwest) PUMA, Virginia/VA",51820,"Waynesboro city, Virginia",21926,259,3,1181,14,0.134,229,0,7,2,9,0,231,9,7,9,7,16,247,93,1,4,3,4,0,0,3,94,6,4,3
51,Virginia/VA,5151084,"Northern Shenandoah Valley Regional Commission (North) PUMA, Virginia/VA",51043,"Clarke County, Virginia",14365,94,0,654,0,0.114,34,2,31,3,0,0,37,2,31,0,33,33,70,49,4,0,47,0,3,0,44,53,47,3,44
51,Virginia/VA,5151084,"Northern Shenandoah Valley Regional Commission (North) PUMA, Virginia/VA",51069,"Frederick County, Virginia",85153,873,13,1025,15,0.668,196,13,182,17,0,0,213,13,182,0,195,195,408,48,4,0,48,0,3,0,45,52,48,3,45
51,Virginia/VA,5151084,"Northern Shenandoah Valley Regional Commission (North) PUMA, Virginia/VA",51840,"Winchester city, Virginia",27789,495,4,1781,14,0.218,64,4,59,6,0,0,70,4,59,0,63,63,133,48,5,0,47,0,3,0,44,53,47,3,44
51,Virginia/VA,5151085,"Northern Shenandoah Valley Regional Commission (South) PUMA, Virginia/VA",51139,"Page County, Virginia",23749,390,29,1642,122,0.223,257,44,24,2,4,3,259,48,27,7,68,75,334,77,1,2,20,1,13,1,7,78,22,14,8
51,Virginia/VA,5151085,"Northern Shenandoah Valley Regional Commission (South) PUMA, Virginia/VA",51171,"Shenandoah County, Virginia",43045,805,58,1870,135,0.407,469,80,44,4,8,6,473,88,50,14,124,138,611,77,1,2,20,1,13,1,7,77,23,14,8
51,Virginia/VA,5151085,"Northern Shenandoah Valley Regional Commission (South) PUMA, Virginia/VA",51187,"Warren County, Virginia",39449,415,7,1052,18,0.369,425,73,40,4,7,6,429,80,46,13,113,126,555,77,1,2,20,1,13,1,7,77,23,14,8
51,Virginia/VA,5151087,"Rappahannock-Rapidan Regional Commission PUMA, Virginia/VA",51047,"Culpeper County, Virginia",50450,1190,17,2359,34,0.286,142,0,216,0,0,0,142,0,216,0,216,216,358,40,0,0,60,0,0,0,60,40,60,0,60
51,Virginia/VA,5151087,"Rappahannock-Rapidan Regional Commission PUMA, Virginia/VA",51061,"Fauquier County, Virginia",69115,925,25,1338,36,0.394,196,0,297,0,0,0,196,0,297,0,297,297,493,40,0,0,60,0,0,0,60,40,60,0,60
51,Virginia/VA,5151087,"Rappahannock-Rapidan Regional Commission PUMA, Virginia/VA",51113,"Madison County, Virginia",13139,106,3,807,23,0.075,37,0,57,0,0,0,37,0,57,0,57,57,94,39,0,0,61,0,0,0,61,39,61,0,61
51,Virginia/VA,5151087,"Rappahannock-Rapidan Regional Commission PUMA, Virginia/VA",51137,"Orange County, Virginia",35612,320,4,899,11,0.203,101,0,153,0,0,0,101,0,153,0,153,153,254,40,0,0,60,0,0,0,60,40,60,0,60
51,Virginia/VA,5151087,"Rappahannock-Rapidan Regional Commission PUMA, Virginia/VA",51157,"Rappahannock County, Virginia",7332,64,2,873,27,0.042,21,0,32,0,0,0,21,0,32,0,32,32,53,40,0,0,60,0,0,0,60,40,60,0,60
51,Virginia/VA,5151089,"Thomas Jefferson Planning District Commission (South & East) PUMA, Virginia/VA",51003,"Albemarle County, Virginia",106355,1233,21,1159,20,0.343,120,0,45,0,0,0,120,0,45,0,45,45,165,73,0,0,27,0,0,0,27,73,27,0,27
51,Virginia/VA,5151089,"Thomas Jefferson Planning District Commission (South & East) PUMA, Virginia/VA",51065,"Fluvanna County, Virginia",26282,375,9,1427,34,0.226,79,0,29,0,0,0,79,0,29,0,29,29,108,73,0,0,27,0,0,0,27,73,27,0,27
51,Virginia/VA,5151089,"Thomas Jefferson Planning District Commission (South & East) PUMA, Virginia/VA",51109,"Louisa County, Virginia",35380,287,6,811,17,0.303,106,0,39,0,0,0,106,0,39,0,39,39,145,73,0,0,27,0,0,0,27,73,27,0,27
51,Virginia/VA,5151089,"Thomas Jefferson Planning District Commission (South & East) PUMA, Virginia/VA",51125,"Nelson County, Virginia",14812,100,2,675,14,0.128,45,0,17,0,0,0,45,0,17,0,17,17,62,73,0,0,27,0,0,0,27,73,27,0,27
51,Virginia/VA,5151090,"Thomas Jefferson Planning District Commission (North) PUMA, Virginia/VA",51003,"Albemarle County, Virginia",106355,1233,21,1159,20,0.503,125,0,22,0,0,0,125,0,22,0,22,22,147,85,0,0,15,0,0,0,15,85,15,0,15
51,Virginia/VA,5151090,"Thomas Jefferson Planning District Commission (North) PUMA, Virginia/VA",51079,"Greene County, Virginia",19410,216,3,1113,15,0.145,36,0,6,0,0,0,36,0,6,0,6,6,42,86,0,0,14,0,0,0,14,86,14,0,14
51,Virginia/VA,5151090,"Thomas Jefferson Planning District Commission (North) PUMA, Virginia/VA",51540,"Charlottesville city, Virginia",47042,1144,28,2432,60,0.352,88,0,15,0,0,0,88,0,15,0,15,15,103,85,0,0,15,0,0,0,15,85,15,0,15
51,Virginia/VA,5151095,"Virginia's Region 2000 (North)--Bedford, Amherst, Appomattox Counties & Bedford City PUMA, Virginia/VA",51009,"Amherst County, Virginia",31882,390,4,1223,13,0.253,78,0,0,0,0,0,78,0,0,0,0,0,78,100,0,0,0,0,0,0,0,100,0,0,0
51,Virginia/VA,5151095,"Virginia's Region 2000 (North)--Bedford, Amherst, Appomattox Counties & Bedford City PUMA, Virginia/VA",51011,"Appomattox County, Virginia",15577,213,3,1367,19,0.124,38,0,0,0,0,0,38,0,0,0,0,0,38,100,0,0,0,0,0,0,0,100,0,0,0
51,Virginia/VA,5151095,"Virginia's Region 2000 (North)--Bedford, Amherst, Appomattox Counties & Bedford City PUMA, Virginia/VA",51019,"Bedford County, Virginia",77908,739,13,949,17,0.623,192,0,0,0,0,0,192,0,0,0,0,0,192,100,0,0,0,0,0,0,0,100,0,0,0
51,Virginia/VA,5151096,"Virginia's Region 2000 (South)--Campbell County & Lynchburg City PUMA, Virginia/VA",51031,"Campbell County, Virginia",55170,436,4,790,7,0.407,87,0,79,6,0,0,93,0,79,0,79,79,172,51,3,0,46,0,0,0,46,54,46,0,46
51,Virginia/VA,5151096,"Virginia's Region 2000 (South)--Campbell County & Lynchburg City PUMA, Virginia/VA",51680,"Lynchburg city, Virginia",80131,1374,13,1715,16,0.593,126,0,115,9,0,0,135,0,115,0,115,115,250,50,4,0,46,0,0,0,46,54,46,0,46
51,Virginia/VA,5151097,"West Piedmont Planning District Commission PUMA, Virginia/VA",51089,"Henry County, Virginia",51588,1042,20,2020,39,0.276,227,0,9,39,6,0,266,6,9,6,9,15,281,81,14,2,3,2,0,0,3,95,5,2,3
51,Virginia/VA,5151097,"West Piedmont Planning District Commission PUMA, Virginia/VA",51141,"Patrick County, Virginia",17859,276,24,1545,134,0.096,79,0,3,13,2,0,92,2,3,2,3,5,97,81,13,2,3,2,0,0,3,95,5,2,3
51,Virginia/VA,5151097,"West Piedmont Planning District Commission PUMA, Virginia/VA",51143,"Pittsylvania County, Virginia",61676,985,9,1597,15,0.331,273,0,10,46,7,0,319,7,10,7,10,17,336,81,14,2,3,2,0,0,3,95,5,2,3
51,Virginia/VA,5151097,"West Piedmont Planning District Commission PUMA, Virginia/VA",51590,"Danville city, Virginia",41512,860,27,2072,65,0.225,185,0,7,32,5,0,217,5,7,5,7,12,229,81,14,2,3,2,0,0,3,95,5,2,3
51,Virginia/VA,5151097,"West Piedmont Planning District Commission PUMA, Virginia/VA",51690,"Martinsville city, Virginia",13101,380,16,2901,122,0.072,59,0,2,10,2,0,69,2,2,2,2,4,73,81,14,3,3,3,0,0,3,95,5,3,3
51,Virginia/VA,5151105,"Southside Planning District Commission & Commonwealth Regional Council PUMA, Virginia/VA",51007,"Amelia County, Virginia",12854,124,5,965,39,0.07,71,0,14,4,7,0,75,7,14,7,14,21,96,74,4,7,15,7,0,0,15,78,22,7,15
51,Virginia/VA,5151105,"Southside Planning District Commission & Commonwealth Regional Council PUMA, Virginia/VA",51025,"Brunswick County, Virginia",16665,351,5,2106,30,0.088,89,0,18,5,8,0,94,8,18,8,18,26,120,74,4,7,15,7,0,0,15,78,22,7,15
51,Virginia/VA,5151105,"Southside Planning District Commission & Commonwealth Regional Council PUMA, Virginia/VA",51029,"Buckingham County, Virginia",17004,677,9,3981,53,0.092,94,0,19,5,9,0,99,9,19,9,19,28,127,74,4,7,15,7,0,0,15,78,22,7,15
51,Virginia/VA,5151105,"Southside Planning District Commission & Commonwealth Regional Council PUMA, Virginia/VA",51037,"Charlotte County, Virginia",12095,106,0,876,0,0.066,67,0,14,4,6,0,71,6,14,6,14,20,91,74,4,7,15,7,0,0,15,78,22,7,15
51,Virginia/VA,5151105,"Southside Planning District Commission & Commonwealth Regional Council PUMA, Virginia/VA",51049,"Cumberland County, Virginia",9786,104,2,1063,20,0.052,53,0,11,3,5,0,56,5,11,5,11,16,72,74,4,7,15,7,0,0,15,78,22,7,15
51,Virginia/VA,5151105,"Southside Planning District Commission & Commonwealth Regional Council PUMA, Virginia/VA",51083,"Halifax County, Virginia",34779,342,6,983,17,0.189,192,0,39,11,18,0,203,18,39,18,39,57,260,74,4,7,15,7,0,0,15,78,22,7,15
51,Virginia/VA,5151105,"Southside Planning District Commission & Commonwealth Regional Council PUMA, Virginia/VA",51111,"Lunenburg County, Virginia",12278,116,3,945,24,0.066,67,0,14,4,6,0,71,6,14,6,14,20,91,74,4,7,15,7,0,0,15,78,22,7,15
51,Virginia/VA,5151105,"Southside Planning District Commission & Commonwealth Regional Council PUMA, Virginia/VA",51117,"Mecklenburg County, Virginia",30847,711,33,2305,107,0.167,170,0,35,10,16,0,180,16,35,16,35,51,231,74,4,7,15,7,0,0,15,78,22,7,15
51,Virginia/VA,5151105,"Southside Planning District Commission & Commonwealth Regional Council PUMA, Virginia/VA",51135,"Nottoway County, Virginia",15500,257,18,1658,116,0.084,85,0,17,5,8,0,90,8,17,8,17,25,115,74,4,7,15,7,0,0,15,78,22,7,15
51,Virginia/VA,5151105,"Southside Planning District Commission & Commonwealth Regional Council PUMA, Virginia/VA",51147,"Prince Edward County, Virginia",22956,577,12,2514,52,0.125,127,0,26,7,12,0,134,12,26,12,26,38,172,74,4,7,15,7,0,0,15,78,22,7,15
51,Virginia/VA,5151110,"Central Shenandoah Planning District Commission (Northeast) PUMA, Virginia/VA",51165,"Rockingham County, Virginia",79444,1414,21,1780,26,0.6,1288,267,422,290,53,152,1578,320,574,205,689,894,2472,52,12,8,28,2,11,6,17,64,36,13,23
51,Virginia/VA,5151110,"Central Shenandoah Planning District Commission (Northeast) PUMA, Virginia/VA",51660,"Harrisonburg city, Virginia",53391,2578,34,4829,64,0.4,859,178,282,194,35,101,1053,213,383,136,460,596,1649,52,12,8,28,2,11,6,17,64,36,13,23
51,Virginia/VA,5151115,"George Washington Regional Commission (North) PUMA, Virginia/VA",51179,"Stafford County, Virginia",144012,1998,17,1387,12,0.836,163,0,68,0,0,0,163,0,68,0,68,68,231,71,0,0,29,0,0,0,29,71,29,0,29
51,Virginia/VA,5151115,"George Washington Regional Commission (North) PUMA, Virginia/VA",51630,"Fredericksburg city, Virginia",28469,535,5,1879,18,0.164,32,0,13,0,0,0,32,0,13,0,13,13,45,71,0,0,29,0,0,0,29,71,29,0,29
51,Virginia/VA,5151120,"George Washington Regional Commission (South) PUMA, Virginia/VA",51033,"Caroline County, Virginia",30184,347,5,1150,17,0.16,58,12,1,0,2,0,58,14,1,2,13,15,73,79,0,3,18,3,16,0,1,79,21,19,1
51,Virginia/VA,5151120,"George Washington Regional Commission (South) PUMA, Virginia/VA",51099,"King George County, Virginia",25890,228,4,881,15,0.138,50,10,1,0,2,0,50,12,1,2,11,13,63,79,0,3,17,3,16,0,2,79,21,19,2
51,Virginia/VA,5151120,"George Washington Regional Commission (South) PUMA, Virginia/VA",51177,"Spotsylvania County, Virginia",131412,2121,44,1614,33,0.702,253,53,3,0,9,0,253,62,3,9,56,65,318,80,0,3,18,3,17,0,1,80,20,19,1
51,Virginia/VA,5151125,"Middle Peninsula, Northern Neck & Accomack-Northampton Planning District Commissions PUMA, Virginia/VA",51001,"Accomack County, Virginia",32742,1172,19,3580,58,0.194,295,14,21,0,4,14,295,18,35,18,35,53,348,85,0,5,10,1,4,4,6,85,15,5,10
51,Virginia/VA,5151125,"Middle Peninsula, Northern Neck & Accomack-Northampton Planning District Commissions PUMA, Virginia/VA",51057,"Essex County, Virginia",11036,176,2,1595,18,0.066,100,5,7,0,1,5,100,6,12,6,12,18,118,85,0,5,10,1,4,4,6,85,15,5,10
51,Virginia/VA,5151125,"Middle Peninsula, Northern Neck & Accomack-Northampton Planning District Commissions PUMA, Virginia/VA",51073,"Gloucester County, Virginia",37161,235,2,632,5,0.219,333,16,23,0,5,15,333,21,38,20,39,59,392,85,0,5,10,1,4,4,6,85,15,5,10
51,Virginia/VA,5151125,"Middle Peninsula, Northern Neck & Accomack-Northampton Planning District Commissions PUMA, Virginia/VA",51097,"King and Queen County, Virginia",7052,72,1,1021,14,0.042,64,3,4,0,1,3,64,4,7,4,7,11,75,85,0,5,9,1,4,4,5,85,15,5,9
51,Virginia/VA,5151125,"Middle Peninsula, Northern Neck & Accomack-Northampton Planning District Commissions PUMA, Virginia/VA",51103,"Lancaster County, Virginia",10804,142,0,1314,0,0.065,99,5,7,0,1,5,99,6,12,6,12,18,117,85,0,5,10,1,4,4,6,85,15,5,10
51,Virginia/VA,5151125,"Middle Peninsula, Northern Neck & Accomack-Northampton Planning District Commissions PUMA, Virginia/VA",51115,"Mathews County, Virginia",8796,49,0,557,0,0.052,79,4,6,0,1,4,79,5,10,5,10,15,94,84,0,5,11,1,4,4,6,84,16,5,11
51,Virginia/VA,5151125,"Middle Peninsula, Northern Neck & Accomack-Northampton Planning District Commissions PUMA, Virginia/VA",51119,"Middlesex County, Virginia",10700,113,10,1056,93,0.064,97,5,7,0,1,4,97,6,11,5,12,17,114,85,0,4,11,1,4,4,6,85,15,5,10
51,Virginia/VA,5151125,"Middle Peninsula, Northern Neck & Accomack-Northampton Planning District Commissions PUMA, Virginia/VA",51131,"Northampton County, Virginia",11957,305,31,2551,259,0.072,110,5,8,0,2,5,110,7,13,7,13,20,130,85,0,5,10,2,4,4,6,85,15,5,10
51,Virginia/VA,5151125,"Middle Peninsula, Northern Neck & Accomack-Northampton Planning District Commissions PUMA, Virginia/VA",51133,"Northumberland County, Virginia",12223,152,6,1244,49,0.072,110,5,8,0,2,5,110,7,13,7,13,20,130,85,0,5,10,2,4,4,6,85,15,5,10
51,Virginia/VA,5151125,"Middle Peninsula, Northern Neck & Accomack-Northampton Planning District Commissions PUMA, Virginia/VA",51159,"Richmond County, Virginia",8878,346,4,3897,45,0.052,79,4,6,0,1,4,79,5,10,5,10,15,94,84,0,5,11,1,4,4,6,84,16,5,11
51,Virginia/VA,5151125,"Middle Peninsula, Northern Neck & Accomack-Northampton Planning District Commissions PUMA, Virginia/VA",51193,"Westmoreland County, Virginia",17638,273,3,1548,17,0.104,158,7,11,0,2,7,158,9,18,9,18,27,185,85,0,5,10,1,4,4,6,85,15,5,10
51,Virginia/VA,5151135,"Crater Planning District Commission PUMA, Virginia/VA",51053,"Dinwiddie County, Virginia",28308,376,11,1328,39,0.162,184,0,0,13,0,0,197,0,0,0,0,0,197,93,7,0,0,0,0,0,0,100,0,0,0
51,Virginia/VA,5151135,"Crater Planning District Commission PUMA, Virginia/VA",51081,"Greensville County, Virginia",11659,782,11,6707,94,0.067,76,0,0,5,0,0,81,0,0,0,0,0,81,94,6,0,0,0,0,0,0,100,0,0,0
51,Virginia/VA,5151135,"Crater Planning District Commission PUMA, Virginia/VA",51149,"Prince George County, Virginia",37894,791,5,2087,13,0.218,248,0,0,17,0,0,265,0,0,0,0,0,265,94,6,0,0,0,0,0,0,100,0,0,0
51,Virginia/VA,5151135,"Crater Planning District Commission PUMA, Virginia/VA",51181,"Surry County, Virginia",6600,118,3,1788,45,0.038,43,0,0,3,0,0,46,0,0,0,0,0,46,93,7,0,0,0,0,0,0,100,0,0,0
51,Virginia/VA,5151135,"Crater Planning District Commission PUMA, Virginia/VA",51183,"Sussex County, Virginia",11486,462,11,4022,96,0.066,75,0,0,5,0,0,80,0,0,0,0,0,80,94,6,0,0,0,0,0,0,100,0,0,0
51,Virginia/VA,5151135,"Crater Planning District Commission PUMA, Virginia/VA",51570,"Colonial Heights city, Virginia",17593,253,25,1438,142,0.102,116,0,0,8,0,0,124,0,0,0,0,0,124,94,6,0,0,0,0,0,0,100,0,0,0
51,Virginia/VA,5151135,"Crater Planning District Commission PUMA, Virginia/VA",51595,"Emporia city, Virginia",5381,255,26,4739,483,0.031,35,0,0,2,0,0,37,0,0,0,0,0,37,95,5,0,0,0,0,0,0,100,0,0,0
51,Virginia/VA,5151135,"Crater Planning District Commission PUMA, Virginia/VA",51670,"Hopewell city, Virginia",22408,390,7,1740,31,0.131,149,0,0,10,0,0,159,0,0,0,0,0,159,94,6,0,0,0,0,0,0,100,0,0,0
51,Virginia/VA,5151135,"Crater Planning District Commission PUMA, Virginia/VA",51730,"Petersburg city, Virginia",31827,734,29,2306,91,0.184,209,0,0,14,0,0,223,0,0,0,0,0,223,94,6,0,0,0,0,0,0,100,0,0,0
51,Virginia/VA,5151145,"Isle of Wight, Southampton Counties, Suffolk & Franklin Cities PUMA, Virginia/VA",51093,"Isle of Wight County, Virginia",36372,723,19,1988,52,0.24,392,0,1,0,0,4,392,0,5,4,1,5,397,99,0,1,0,0,0,1,0,99,1,0,1
51,Virginia/VA,5151145,"Isle of Wight, Southampton Counties, Suffolk & Franklin Cities PUMA, Virginia/VA",51175,"Southampton County, Virginia",17939,748,23,4170,128,0.119,194,0,0,0,0,2,194,0,2,2,0,2,196,99,0,1,0,0,0,1,0,99,1,0,1
51,Virginia/VA,5151145,"Isle of Wight, Southampton Counties, Suffolk & Franklin Cities PUMA, Virginia/VA",51620,"Franklin city, Virginia",8211,413,9,5030,110,0.055,90,0,0,0,0,1,90,0,1,1,0,1,91,99,0,1,0,0,0,1,0,99,1,0,1
51,Virginia/VA,5151145,"Isle of Wight, Southampton Counties, Suffolk & Franklin Cities PUMA, Virginia/VA",51800,"Suffolk city, Virginia",89160,1963,72,2202,81,0.586,956,0,2,0,0,9,956,0,11,9,2,11,967,99,0,1,0,0,0,1,0,99,1,0,1
51,Virginia/VA,5151154,"Norfolk City (Northeast) PUMA, Virginia/VA",51710,"Norfolk city, Virginia",245592,4800,78,1954,32,1,338,0,51,47,0,16,385,0,67,16,51,67,452,75,10,4,11,0,0,4,11,85,15,0,15
51,Virginia/VA,5151155,"Portsmouth & Norfolk (Southwest) Cities PUMA, Virginia/VA",51710,"Norfolk city, Virginia",245592,4800,78,1954,32,0.269,25,0,0,9,0,0,34,0,0,0,0,0,34,74,26,0,0,0,0,0,0,100,0,0,0
51,Virginia/VA,5151155,"Portsmouth & Norfolk (Southwest) Cities PUMA, Virginia/VA",51740,"Portsmouth city, Virginia",95311,2547,58,2672,61,0.731,69,0,0,25,0,0,94,0,0,0,0,0,94,73,27,0,0,0,0,0,0,100,0,0,0
51,Virginia/VA,5151164,"Virginia Beach City (North) PUMA, Virginia/VA",51810,"Virginia Beach city, Virginia",450135,6776,88,1505,20,1,173,0,26,0,0,0,173,0,26,0,26,26,199,87,0,0,13,0,0,0,13,87,13,0,13
51,Virginia/VA,5151165,"Virginia Beach City (Central) PUMA, Virginia/VA",51810,"Virginia Beach city, Virginia",450135,6776,88,1505,20,1,79,0,0,0,0,0,79,0,0,0,0,0,79,100,0,0,0,0,0,0,0,100,0,0,0
51,Virginia/VA,5151167,"Virginia Beach City (South) PUMA, Virginia/VA",51810,"Virginia Beach city, Virginia",450135,6776,88,1505,20,1,136,0,0,13,0,0,149,0,0,0,0,0,149,91,9,0,0,0,0,0,0,100,0,0,0
51,Virginia/VA,5151175,"Newport News City PUMA, Virginia/VA",51700,"Newport News city, Virginia",180145,2715,38,1507,21,1,533,0,96,46,78,203,579,78,299,281,96,377,956,56,5,29,10,8,0,21,10,61,39,8,31
51,Virginia/VA,5151186,"Hampton City PUMA, Virginia/VA",51650,"Hampton city, Virginia",135583,1803,24,1330,18,1,530,0,0,0,72,44,530,72,44,116,0,116,646,82,0,18,0,11,0,7,0,82,18,11,7
51,Virginia/VA,5151206,"James City, York Counties, Williamsburg & Poquoson Cities PUMA, Virginia/VA",51095,"James City County, Virginia",74153,842,20,1135,27,0.439,65,0,6,0,0,0,65,0,6,0,6,6,71,92,0,0,8,0,0,0,8,92,8,0,8
51,Virginia/VA,5151206,"James City, York Counties, Williamsburg & Poquoson Cities PUMA, Virginia/VA",51199,"York County, Virginia",67587,541,8,800,12,0.401,59,0,5,0,0,0,59,0,5,0,5,5,64,92,0,0,8,0,0,0,8,92,8,0,8
51,Virginia/VA,5151206,"James City, York Counties, Williamsburg & Poquoson Cities PUMA, Virginia/VA",51735,"Poquoson city, Virginia",12039,74,2,615,17,0.071,11,0,1,0,0,0,11,0,1,0,1,1,12,92,0,0,8,0,0,0,8,92,8,0,8
51,Virginia/VA,5151206,"James City, York Counties, Williamsburg & Poquoson Cities PUMA, Virginia/VA",51830,"Williamsburg city, Virginia",14788,177,7,1197,47,0.09,13,0,1,0,0,0,13,0,1,0,1,1,14,93,0,0,7,0,0,0,7,93,7,0,7
51,Virginia/VA,5151215,"Hanover, Powhatan, Goochland, New Kent, King William & Charles City Counties PUMA, Virginia/VA",51036,"Charles City County, Virginia",6995,84,5,1201,71,0.035,18,0,2,0,0,0,18,0,2,0,2,2,20,90,0,0,10,0,0,0,10,90,10,0,10
51,Virginia/VA,5151215,"Hanover, Powhatan, Goochland, New Kent, King William & Charles City Counties PUMA, Virginia/VA",51075,"Goochland County, Virginia",22482,266,7,1183,31,0.113,58,0,8,0,0,0,58,0,8,0,8,8,66,88,0,0,12,0,0,0,12,88,12,0,12
51,Virginia/VA,5151215,"Hanover, Powhatan, Goochland, New Kent, King William & Charles City Counties PUMA, Virginia/VA",51085,"Hanover County, Virginia",104449,1286,37,1231,35,0.522,266,0,37,0,0,0,266,0,37,0,37,37,303,88,0,0,12,0,0,0,12,88,12,0,12
51,Virginia/VA,5151215,"Hanover, Powhatan, Goochland, New Kent, King William & Charles City Counties PUMA, Virginia/VA",51101,"King William County, Virginia",16497,157,2,952,12,0.082,42,0,6,0,0,0,42,0,6,0,6,6,48,88,0,0,12,0,0,0,12,88,12,0,12
51,Virginia/VA,5151215,"Hanover, Powhatan, Goochland, New Kent, King William & Charles City Counties PUMA, Virginia/VA",51127,"New Kent County, Virginia",21103,188,3,891,14,0.106,54,0,8,0,0,0,54,0,8,0,8,8,62,87,0,0,13,0,0,0,13,87,13,0,13
51,Virginia/VA,5151215,"Hanover, Powhatan, Goochland, New Kent, King William & Charles City Counties PUMA, Virginia/VA",51145,"Powhatan County, Virginia",28574,219,5,766,17,0.142,72,0,10,0,0,0,72,0,10,0,10,10,82,88,0,0,12,0,0,0,12,88,12,0,12
51,Virginia/VA,5151224,"Henrico County (South & East)--Highland Springs, East Highland Park & Glen Allen PUMA, Virginia/VA",51087,"Henrico County, Virginia",325642,5399,211,1658,65,1,491,0,0,0,0,59,491,0,59,59,0,59,550,89,0,11,0,0,0,11,0,89,11,0,11
51,Virginia/VA,5151225,"Henrico County (West)--Tuckahoe, Short Pump & Wyndham PUMA, Virginia/VA",51087,"Henrico County, Virginia",325642,5399,211,1658,65,1,36,17,51,0,23,11,36,40,62,34,68,102,138,26,0,25,49,17,12,8,37,26,74,29,45
51,Virginia/VA,5151235,"Richmond City PUMA, Virginia/VA",51760,"Richmond city, Virginia",223787,4595,61,2053,27,1,744,0,80,58,0,0,802,0,80,0,80,80,882,84,7,0,9,0,0,0,9,91,9,0,9
51,Virginia/VA,5151244,"Prince William County (North & West)--Linton Hall & Gainesville PUMA, Virginia/VA",51153,"Prince William County, Virginia",456749,12318,202,2697,44,1,12,0,0,0,0,0,12,0,0,0,0,0,12,100,0,0,0,0,0,0,0,100,0,0,0
51,Virginia/VA,5151245,"Manassas, Manassas Park Cities & Prince William County (Central)--Buckhall & Sudley PUMA, Virginia/VA",51153,"Prince William County, Virginia",456749,12318,202,2697,44,0.553,0,0,0,12,0,0,12,0,0,0,0,0,12,0,100,0,0,0,0,0,0,100,0,0,0
51,Virginia/VA,5151245,"Manassas, Manassas Park Cities & Prince William County (Central)--Buckhall & Sudley PUMA, Virginia/VA",51683,"Manassas city, Virginia",41457,1918,25,4626,60,0.323,0,0,0,7,0,0,7,0,0,0,0,0,7,0,100,0,0,0,0,0,0,100,0,0,0
51,Virginia/VA,5151245,"Manassas, Manassas Park Cities & Prince William County (Central)--Buckhall & Sudley PUMA, Virginia/VA",51685,"Manassas Park city, Virginia",16423,610,8,3714,49,0.124,0,0,0,3,0,0,3,0,0,0,0,0,3,0,100,0,0,0,0,0,0,100,0,0,0
51,Virginia/VA,5151246,"Prince William County (Southeast)--Dale City, Lake Ridge & Woodbridge PUMA, Virginia/VA",51153,"Prince William County, Virginia",456749,12318,202,2697,44,1,86,30,76,0,27,20,86,57,96,47,106,153,239,36,0,20,44,11,13,8,32,36,64,24,40
51,Virginia/VA,5151255,"Alexandria City PUMA, Virginia/VA",51510,"Alexandria city, Virginia",156505,3780,69,2415,44,1,21,0,92,7,27,0,28,27,92,27,92,119,147,14,5,18,63,18,0,0,63,19,81,18,63
51,Virginia/VA,5155001,"Chesapeake City (Northeast) PUMA, Virginia/VA",51550,"Chesapeake city, Virginia",237820,4271,71,1796,30,1,75,0,49,0,0,0,75,0,49,0,49,49,124,60,0,0,40,0,0,0,40,60,40,0,40
51,Virginia/VA,5155002,"Chesapeake City (South & West) PUMA, Virginia/VA",51550,"Chesapeake city, Virginia",237820,4271,71,1796,30,1,110,0,0,0,0,0,110,0,0,0,0,0,110,100,0,0,0,0,0,0,0,100,0,0,0
51,Virginia/VA,5159301,"Fairfax County (East Central)--Annandale, West Falls Church & Bailey's Crossroads PUMA, Virginia/VA",51059,"Fairfax County, Virginia",1143529,20627,586,1804,51,1,55,22,19,0,54,32,55,76,51,86,41,127,182,30,0,47,23,30,12,18,10,30,70,42,28
51,Virginia/VA,5159302,"Fairfax County (Southeast)--Woodlawn, Rose Hill & Mount Vernon PUMA, Virginia/VA",51059,"Fairfax County, Virginia",1143529,20627,586,1804,51,1,8,0,37,0,19,27,8,19,64,46,37,83,91,9,0,51,41,21,0,30,41,9,91,21,70
51,Virginia/VA,5159303,"Fairfax County (Central) & Fairfax City--Burke PUMA, Virginia/VA",51059,"Fairfax County, Virginia",1143529,20627,586,1804,51,0.85,67,0,12,0,23,0,67,23,12,23,12,35,102,66,0,23,12,23,0,0,12,66,34,23,12
51,Virginia/VA,5159303,"Fairfax County (Central) & Fairfax City--Burke PUMA, Virginia/VA",51600,"Fairfax city, Virginia",23865,135,8,566,34,0.15,12,0,2,0,4,0,12,4,2,4,2,6,18,67,0,22,11,22,0,0,11,67,33,22,11
51,Virginia/VA,5159304,"Fairfax County (Southwest)--Centreville (Southeast) & Lorton PUMA, Virginia/VA",51059,"Fairfax County, Virginia",1143529,20627,586,1804,51,1,32,0,0,0,0,0,32,0,0,0,0,0,32,100,0,0,0,0,0,0,0,100,0,0,0
51,Virginia/VA,5159305,"Fairfax County (North Central)--Vienna Town, Oakton & Fair Oaks (East) PUMA, Virginia/VA",51059,"Fairfax County, Virginia",1143529,20627,586,1804,51,1,28,0,11,0,0,26,28,0,37,26,11,37,65,43,0,40,17,0,0,40,17,43,57,0,57
51,Virginia/VA,5159306,"Fairfax County (South Central)--Springfield (South), West Springfield & Franconia PUMA, Virginia/VA",51059,"Fairfax County, Virginia",1143529,20627,586,1804,51,1,54,0,0,24,0,100,78,0,100,100,0,100,178,30,13,56,0,0,0,56,0,44,56,0,56
51,Virginia/VA,5159307,"Fairfax County (Northwest)--Reston (North) & Franklin Farm PUMA, Virginia/VA",51059,"Fairfax County, Virginia",1143529,20627,586,1804,51,1,13,0,18,19,0,22,32,0,40,22,18,40,72,18,26,31,25,0,0,31,25,44,56,0,56
51,Virginia/VA,5159308,"Fairfax County (Northeast)--McLean & Idylwood PUMA, Virginia/VA",51059,"Fairfax County, Virginia",1143529,20627,586,1804,51,0.879,0,0,54,0,0,0,0,0,54,0,54,54,54,0,0,0,100,0,0,0,100,0,100,0,100
51,Virginia/VA,5159308,"Fairfax County (Northeast)--McLean & Idylwood PUMA, Virginia/VA",51610,"Falls Church city, Virginia",14067,70,6,498,43,0.121,0,0,8,0,0,0,0,0,8,0,8,8,8,0,0,0,100,0,0,0,100,0,100,0,100
51,Virginia/VA,5159309,"Fairfax County (West Central)--Centreville (North & West) & Chantilly (South & West) PUMA, Virginia/VA",51059,"Fairfax County, Virginia",1143529,20627,586,1804,51,1,0,18,0,0,0,13,0,18,13,13,18,31,31,0,0,42,58,0,58,42,0,0,100,58,42
53,Washington/WA,5310100,"Whatcom County--Bellingham City PUMA, Washington/WA",53073,"Whatcom County, Washington",216812,1328,52,613,24,1,1109,58,794,106,0,180,1215,58,974,180,852,1032,2247,49,5,8,38,0,3,8,35,54,46,3,43
53,Washington/WA,5310200,"Skagit, Island & San Juan Counties PUMA, Washington/WA",53029,"Island County, Washington",81636,318,15,390,18,0.371,215,39,474,90,35,28,305,74,502,63,513,576,881,24,10,7,58,4,4,3,54,35,65,8,57
53,Washington/WA,5310200,"Skagit, Island & San Juan Counties PUMA, Washington/WA",53055,"San Juan County, Washington",16473,30,0,182,0,0.073,42,8,93,18,7,5,60,15,98,12,101,113,173,24,10,7,58,4,5,3,54,35,65,9,57
53,Washington/WA,5310200,"Skagit, Island & San Juan Counties PUMA, Washington/WA",53057,"Skagit County, Washington",123907,1096,24,885,19,0.555,321,58,709,135,52,42,456,110,751,94,767,861,1317,24,10,7,58,4,4,3,54,35,65,8,57
53,Washington/WA,5310300,"Chelan & Douglas Counties PUMA, Washington/WA",53007,"Chelan County, Washington",75757,2055,17,2713,22,0.649,382,565,2070,279,25,0,661,590,2070,25,2635,2660,3321,12,8,1,79,1,17,0,62,20,80,18,62
53,Washington/WA,5310300,"Chelan & Douglas Counties PUMA, Washington/WA",53017,"Douglas County, Washington",41371,1295,10,3130,24,0.351,207,306,1119,151,13,0,358,319,1119,13,1425,1438,1796,12,8,1,79,1,17,0,62,20,80,18,62
53,Washington/WA,5310400,"Stevens, Okanogan, Pend Oreille & Ferry Counties PUMA, Washington/WA",53019,"Ferry County, Washington",7576,30,0,396,0,0.071,37,6,84,18,0,0,55,6,84,0,90,90,145,26,12,0,62,0,4,0,58,38,62,4,58
53,Washington/WA,5310400,"Stevens, Okanogan, Pend Oreille & Ferry Counties PUMA, Washington/WA",53047,"Okanogan County, Washington",41638,1061,13,2548,31,0.389,205,34,461,101,0,2,306,34,463,2,495,497,803,26,13,0,62,0,4,0,57,38,62,4,58
53,Washington/WA,5310400,"Stevens, Okanogan, Pend Oreille & Ferry Counties PUMA, Washington/WA",53051,"Pend Oreille County, Washington",13219,60,0,454,0,0.123,65,11,146,32,0,1,97,11,147,1,157,158,255,25,13,0,62,0,4,0,57,38,62,4,58
53,Washington/WA,5310400,"Stevens, Okanogan, Pend Oreille & Ferry Counties PUMA, Washington/WA",53065,"Stevens County, Washington",44214,165,2,373,5,0.416,219,36,493,108,0,2,327,36,495,2,529,531,858,26,13,0,62,0,4,0,57,38,62,4,58
53,Washington/WA,5310501,"Spokane County (North Central)--Spokane City (North) PUMA, Washington/WA",53063,"Spokane County, Washington",497875,6808,168,1367,34,1,480,0,24,70,0,0,550,0,24,0,24,24,574,84,12,0,4,0,0,0,4,96,4,0,4
53,Washington/WA,5310502,"Spokane County (South Central)--Spokane City (South) PUMA, Washington/WA",53063,"Spokane County, Washington",497875,6808,168,1367,34,1,327,0,10,9,0,0,336,0,10,0,10,10,346,95,3,0,3,0,0,0,3,97,3,0,3
53,Washington/WA,5310503,"Spokane County (East Central)--Greater Spokane Valley City PUMA, Washington/WA",53063,"Spokane County, Washington",497875,6808,168,1367,34,1,394,0,67,49,0,0,443,0,67,0,67,67,510,77,10,0,13,0,0,0,13,87,13,0,13
53,Washington/WA,5310504,"Spokane County (Outer)--Cheney City PUMA, Washington/WA",53063,"Spokane County, Washington",497875,6808,168,1367,34,1,376,41,0,47,0,15,423,41,15,15,41,56,479,78,10,3,9,0,9,3,0,88,12,9,3
53,Washington/WA,5310600,"Whitman, Asotin, Adams, Lincoln, Columbia & Garfield Counties PUMA, Washington/WA",53001,"Adams County, Washington",19452,835,10,4293,51,0.18,173,61,320,44,0,4,217,61,324,4,381,385,602,29,7,1,63,0,10,1,53,36,64,10,54
53,Washington/WA,5310600,"Whitman, Asotin, Adams, Lincoln, Columbia & Garfield Counties PUMA, Washington/WA",53003,"Asotin County, Washington",22337,105,2,470,9,0.209,201,71,371,51,0,4,252,71,375,4,442,446,698,29,7,1,63,0,10,1,53,36,64,10,54
53,Washington/WA,5310600,"Whitman, Asotin, Adams, Lincoln, Columbia & Garfield Counties PUMA, Washington/WA",53013,"Columbia County, Washington",4001,14,1,350,25,0.037,36,13,66,9,0,1,45,13,67,1,79,80,125,29,7,1,63,0,10,1,53,36,64,10,54
53,Washington/WA,5310600,"Whitman, Asotin, Adams, Lincoln, Columbia & Garfield Counties PUMA, Washington/WA",53023,"Garfield County, Washington",2224,11,0,495,0,0.021,20,7,37,5,0,0,25,7,37,0,44,44,69,29,7,0,64,0,10,0,54,36,64,10,54
53,Washington/WA,5310600,"Whitman, Asotin, Adams, Lincoln, Columbia & Garfield Counties PUMA, Washington/WA",53043,"Lincoln County, Washington",10435,45,1,431,10,0.097,93,33,172,24,0,2,117,33,174,2,205,207,324,29,7,1,63,0,10,1,53,36,64,10,54
53,Washington/WA,5310600,"Whitman, Asotin, Adams, Lincoln, Columbia & Garfield Counties PUMA, Washington/WA",53075,"Whitman County, Washington",48593,1240,0,2552,0,0.457,440,156,811,112,0,9,552,156,820,9,967,976,1528,29,7,1,63,0,10,1,53,36,64,10,54
53,Washington/WA,5310701,"Benton & Franklin Counties--Pasco, Richland (North) & West Richland Cities PUMA, Washington/WA",53005,"Benton County, Washington",194168,4684,133,2412,68,0.407,113,264,1102,256,0,8,369,264,1110,8,1366,1374,1743,6,15,0,78,0,15,0,63,21,79,15,64
53,Washington/WA,5310701,"Benton & Franklin Counties--Pasco, Richland (North) & West Richland Cities PUMA, Washington/WA",53021,"Franklin County, Washington",90660,4379,67,4830,74,0.593,164,384,1606,374,0,12,538,384,1618,12,1990,2002,2540,6,15,0,78,0,15,0,63,21,79,15,64
53,Washington/WA,5310702,"Benton County (East Central)--Kennewick & Richland (South) Cities PUMA, Washington/WA",53005,"Benton County, Washington",194168,4684,133,2412,68,1,297,171,1327,208,27,88,505,198,1415,115,1498,1613,2118,14,10,5,71,1,8,4,63,24,76,9,67
53,Washington/WA,5310703,"Walla Walla, Benton (Outer) & Franklin (Outer) Counties PUMA, Washington/WA",53005,"Benton County, Washington",194168,4684,133,2412,68,0.267,234,104,828,103,25,3,337,129,831,28,932,960,1297,18,8,2,72,2,8,0,64,26,74,10,64
53,Washington/WA,5310703,"Walla Walla, Benton (Outer) & Franklin (Outer) Counties PUMA, Washington/WA",53021,"Franklin County, Washington",90660,4379,67,4830,74,0.181,159,70,561,70,17,2,229,87,563,19,631,650,879,18,8,2,72,2,8,0,64,26,74,10,64
53,Washington/WA,5310703,"Walla Walla, Benton (Outer) & Franklin (Outer) Counties PUMA, Washington/WA",53071,"Walla Walla County, Washington",60236,897,7,1489,12,0.552,484,215,1712,214,52,6,698,267,1718,58,1927,1985,2683,18,8,2,72,2,8,0,64,26,74,10,64
53,Washington/WA,5310800,"Grant & Kittitas Counties PUMA, Washington/WA",53025,"Grant County, Washington",94860,3033,20,3197,21,0.676,863,496,4324,671,0,39,1534,496,4363,39,4820,4859,6393,13,10,1,75,0,8,1,68,24,76,8,68
53,Washington/WA,5310800,"Grant & Kittitas Counties PUMA, Washington/WA",53037,"Kittitas County, Washington",44825,528,22,1178,49,0.324,413,237,2073,321,0,18,734,237,2091,18,2310,2328,3062,13,10,1,75,0,8,1,68,24,76,8,68
53,Washington/WA,5310901,"Yakima County (Central)--Greater Yakima City PUMA, Washington/WA",53077,"Yakima County, Washington",249325,12216,271,4900,109,1,589,653,3059,450,0,18,1039,653,3077,18,3712,3730,4769,12,9,0,78,0,14,0,64,22,78,14,65
53,Washington/WA,5310902,"Yakima County (Outer)--Sunnyside & Grandview Cities PUMA, Washington/WA",53077,"Yakima County, Washington",249325,12216,271,4900,109,1,512,1205,7435,1468,0,19,1980,1205,7454,19,8640,8659,10639,5,14,0,81,0,11,0,70,19,81,11,70
53,Washington/WA,5311000,"Lewis, Klickitat & Skamania Counties PUMA, Washington/WA",53039,"Klickitat County, Washington",21396,192,3,897,14,0.194,66,7,115,22,6,2,88,13,117,8,122,130,218,30,10,4,56,3,3,1,53,40,60,6,54
53,Washington/WA,5311000,"Lewis, Klickitat & Skamania Counties PUMA, Washington/WA",53041,"Lewis County, Washington",76947,491,4,638,5,0.701,240,24,417,80,23,6,320,47,423,29,441,470,790,30,10,4,56,3,3,1,53,41,59,6,54
53,Washington/WA,5311000,"Lewis, Klickitat & Skamania Counties PUMA, Washington/WA",53059,"Skamania County, Washington",11620,65,1,559,9,0.105,36,4,62,12,3,1,48,7,63,4,66,70,118,31,10,3,56,3,3,1,53,41,59,6,53
53,Washington/WA,5311101,"Clark County (Southwest)--Vancouver City (West & Central) PUMA, Washington/WA",53011,"Clark County, Washington",465384,3300,64,709,14,1,171,15,58,56,10,0,227,25,58,10,73,83,310,55,18,3,24,3,5,0,19,73,27,8,19
53,Washington/WA,5311102,"Clark County (West Central)--Salmon Creek & Hazel Dell PUMA, Washington/WA",53011,"Clark County, Washington",465384,3300,64,709,14,1,296,81,55,29,0,10,325,81,65,10,136,146,471,63,6,2,29,0,17,2,12,69,31,17,14
53,Washington/WA,5311103,"Clark County (Southeast)--Vancouver (East), Camas & Washougal Cities PUMA, Washington/WA",53011,"Clark County, Washington",465384,3300,64,709,14,1,176,0,9,0,0,22,176,0,31,22,9,31,207,85,0,11,4,0,0,11,4,85,15,0,15
53,Washington/WA,5311104,"Clark County (North)--Battle Ground City & Orchards PUMA, Washington/WA",53011,"Clark County, Washington",465384,3300,64,709,14,1,368,37,63,10,42,25,378,79,88,67,100,167,545,68,2,12,18,8,7,5,12,69,31,14,16
53,Washington/WA,5311200,"Cowlitz, Pacific & Wahkiakum Counties PUMA, Washington/WA",53015,"Cowlitz County, Washington",105112,657,7,625,7,0.806,623,108,218,55,23,63,678,131,281,86,326,412,1090,57,5,8,30,2,10,6,20,62,38,12,26
53,Washington/WA,5311200,"Cowlitz, Pacific & Wahkiakum Counties PUMA, Washington/WA",53049,"Pacific County, Washington",21281,80,3,376,14,0.163,126,22,44,11,5,13,137,27,57,18,66,84,221,57,5,8,30,2,10,6,20,62,38,12,26
53,Washington/WA,5311200,"Cowlitz, Pacific & Wahkiakum Counties PUMA, Washington/WA",53069,"Wahkiakum County, Washington",4189,6,0,143,0,0.032,25,4,9,2,1,2,27,5,11,3,13,16,43,58,5,7,30,2,9,5,21,63,37,12,26
53,Washington/WA,5311300,"Grays Harbor & Mason Counties PUMA, Washington/WA",53027,"Grays Harbor County, Washington",71967,476,7,661,10,0.535,306,31,447,117,0,0,423,31,447,0,478,478,901,34,13,0,53,0,3,0,50,47,53,3,50
53,Washington/WA,5311300,"Grays Harbor & Mason Counties PUMA, Washington/WA",53045,"Mason County, Washington",62627,386,4,616,6,0.465,266,27,388,101,0,0,367,27,388,0,415,415,782,34,13,0,53,0,3,0,50,47,53,3,50
53,Washington/WA,5311401,"Thurston County (Central)--Olympia, Lacey & Tumwater Cities PUMA, Washington/WA",53067,"Thurston County, Washington",274684,1179,18,429,7,1,324,31,108,129,20,0,453,51,108,20,139,159,612,53,21,3,23,3,5,0,18,74,26,8,18
53,Washington/WA,5311402,"Thurston County (Outer) PUMA, Washington/WA",53067,"Thurston County, Washington",274684,1179,18,429,7,1,354,0,56,33,15,10,387,15,66,25,56,81,468,76,7,5,12,3,0,2,12,83,17,3,14
53,Washington/WA,5311501,"Pierce County (Central)--Tacoma City (Central) PUMA, Washington/WA",53053,"Pierce County, Washington",859840,8677,220,1009,26,1,266,0,157,64,30,7,330,30,164,37,157,194,524,51,12,7,30,6,0,1,30,63,37,6,31
53,Washington/WA,5311502,"Pierce County (Northwest)--Peninsula Region & Tacoma City (West) PUMA, Washington/WA",53053,"Pierce County, Washington",859840,8677,220,1009,26,1,47,0,0,20,0,0,67,0,0,0,0,0,67,70,30,0,0,0,0,0,0,100,0,0,0
53,Washington/WA,5311503,"Pierce County (West Central)--Lakewood City & Joint Base Lewis-McChord PUMA, Washington/WA",53053,"Pierce County, Washington",859840,8677,220,1009,26,1,66,54,91,21,0,0,87,54,91,0,145,145,232,28,9,0,62,0,23,0,39,38,62,23,39
53,Washington/WA,5311504,"Pierce County (South Central)--Tacoma City (South), Parkland & Spanaway PUMA, Washington/WA",53053,"Pierce County, Washington",859840,8677,220,1009,26,1,273,76,263,55,26,0,328,102,263,26,339,365,693,39,8,4,49,4,11,0,38,47,53,15,38
53,Washington/WA,5311505,"Pierce County (North Central)--Tacoma (Port) & Bonney Lake (Northwest) Cities PUMA, Washington/WA",53053,"Pierce County, Washington",859840,8677,220,1009,26,1,200,21,56,41,4,43,241,25,99,47,77,124,365,55,11,13,21,1,6,12,15,66,34,7,27
53,Washington/WA,5311506,"Pierce County (East Central)--Puyallup City & South Hill PUMA, Washington/WA",53053,"Pierce County, Washington",859840,8677,220,1009,26,1,134,0,116,0,103,39,134,103,155,142,116,258,392,34,0,36,30,26,0,10,30,34,66,26,40
53,Washington/WA,5311507,"Pierce County (Southeast)--Graham, Elk Plain & Prairie Ridge PUMA, Washington/WA",53053,"Pierce County, Washington",859840,8677,220,1009,26,1,196,16,15,61,0,0,257,16,15,0,31,31,288,68,21,0,11,0,6,0,5,89,11,6,5
53,Washington/WA,5311601,"Seattle City (Northwest) PUMA, Washington/WA",53033,"King County, Washington",2163257,21915,787,1013,36,1,153,0,0,0,0,0,153,0,0,0,0,0,153,100,0,0,0,0,0,0,0,100,0,0,0
53,Washington/WA,5311602,"Seattle City (Northeast) PUMA, Washington/WA",53033,"King County, Washington",2163257,21915,787,1013,36,1,126,0,13,63,0,55,189,0,68,55,13,68,257,49,25,21,5,0,0,21,5,74,26,0,26
53,Washington/WA,5311603,"Seattle City (Downtown)--Queen Anne & Magnolia PUMA, Washington/WA",53033,"King County, Washington",2163257,21915,787,1013,36,1,85,23,24,0,0,60,85,23,84,60,47,107,192,44,0,31,24,0,12,31,12,44,56,12,44
53,Washington/WA,5311604,"Seattle City (Southeast)--Capitol Hill PUMA, Washington/WA",53033,"King County, Washington",2163257,21915,787,1013,36,1,155,0,72,26,14,221,181,14,293,235,72,307,488,32,5,48,15,3,0,45,15,37,63,3,60
53,Washington/WA,5311605,"Seattle City (West)--Duwamish & Beacon Hill PUMA, Washington/WA",53033,"King County, Washington",2163257,21915,787,1013,36,1,191,0,199,141,136,46,332,136,245,182,199,381,713,27,20,26,28,19,0,6,28,47,53,19,34
53,Washington/WA,5311606,"King County (Northwest)--Shoreline, Kenmore & Bothell (South) Cities PUMA, Washington/WA",53033,"King County, Washington",2163257,21915,787,1013,36,1,75,22,0,0,0,40,75,22,40,40,22,62,137,55,0,29,16,0,16,29,0,55,45,16,29
53,Washington/WA,5311607,"King County (Northwest)--Redmond, Kirkland Cities, Inglewood & Finn Hill PUMA, Washington/WA",53033,"King County, Washington",2163257,21915,787,1013,36,1,166,0,5,100,20,24,266,20,29,44,5,49,315,53,32,14,2,6,0,8,2,84,16,6,9
53,Washington/WA,5311608,"King County (Northwest Central)--Greater Bellevue City PUMA, Washington/WA",53033,"King County, Washington",2163257,21915,787,1013,36,1,88,25,14,0,40,15,88,65,29,55,39,94,182,48,0,30,21,22,14,8,8,48,52,36,16
53,Washington/WA,5311609,"King County (Central)--Sammamish, Issaquah, Mercer Island & Newcastle Cities PUMA, Washington/WA",53033,"King County, Washington",2163257,21915,787,1013,36,1,236,0,25,0,0,0,236,0,25,0,25,25,261,90,0,0,10,0,0,0,10,90,10,0,10
53,Washington/WA,5311610,"King County (Central)--Renton City, Fairwood, Bryn Mawr & Skyway PUMA, Washington/WA",53033,"King County, Washington",2163257,21915,787,1013,36,1,116,0,82,31,141,143,147,141,225,284,82,366,513,23,6,55,16,27,0,28,16,29,71,27,44
53,Washington/WA,5311611,"King County (West Central)--Burien, SeaTac, Tukwila Cities & White Center PUMA, Washington/WA",53033,"King County, Washington",2163257,21915,787,1013,36,1,171,66,91,78,74,192,249,140,283,266,157,423,672,25,12,40,23,11,10,29,14,37,63,21,42
53,Washington/WA,5311612,"King County (Far Southwest)--Federal Way, Des Moines Cities & Vashon Island PUMA, Washington/WA",53033,"King County, Washington",2163257,21915,787,1013,36,1,136,271,153,72,53,96,208,324,249,149,424,573,781,17,9,19,54,7,35,12,20,27,73,41,32
53,Washington/WA,5311613,"King County (Southwest Central)--Kent City PUMA, Washington/WA",53033,"King County, Washington",2163257,21915,787,1013,36,1,188,95,155,47,127,331,235,222,486,458,250,708,943,20,5,49,27,13,10,35,16,25,75,24,52
53,Washington/WA,5311614,"King County (Southwest)--Auburn City & Lakeland PUMA, Washington/WA",53033,"King County, Washington",2163257,21915,787,1013,36,1,387,0,200,37,31,33,424,31,233,64,200,264,688,56,5,9,29,5,0,5,29,62,38,5,34
53,Washington/WA,5311615,"King County (Southeast)--Maple Valley, Covington & Enumclaw Cities PUMA, Washington/WA",53033,"King County, Washington",2163257,21915,787,1013,36,1,217,69,40,9,0,0,226,69,40,0,109,109,335,65,3,0,33,0,21,0,12,67,33,21,12
53,Washington/WA,5311616,"King County (Northeast)--Snoqualmie City, Cottage Lake, Union Hill & Novelty Hill PUMA, Washington/WA",53033,"King County, Washington",2163257,21915,787,1013,36,1,78,81,27,42,0,0,120,81,27,0,108,108,228,34,18,0,47,0,36,0,12,53,47,36,12
53,Washington/WA,5311701,"Snohomish County (Southwest)--Edmonds, Lynnwood & Mountlake Terrace Cities PUMA, Washington/WA",53061,"Snohomish County, Washington",786620,8016,223,1019,28,1,94,93,62,0,37,14,94,130,76,51,155,206,300,31,0,17,52,12,31,5,21,31,69,43,25
53,Washington/WA,5311702,"Snohomish County (West Central)--Mukilteo & Everett (Southwest) Cities PUMA, Washington/WA",53061,"Snohomish County, Washington",786620,8016,223,1019,28,1,12,46,242,0,23,0,12,69,242,23,288,311,323,4,0,7,89,7,14,0,75,4,96,21,75
53,Washington/WA,5311703,"Snohomish County (Central)--Everett City (Central & East) & Eastmont PUMA, Washington/WA",53061,"Snohomish County, Washington",786620,8016,223,1019,28,1,65,97,83,103,134,159,168,231,242,293,180,473,641,10,16,46,28,21,15,25,13,26,74,36,38
53,Washington/WA,5311704,"Snohomish County (South Central)--Bothell (North), Mill Creek Cities & Silver Firs PUMA, Washington/WA",53061,"Snohomish County, Washington",786620,8016,223,1019,28,1,125,29,7,0,46,63,125,75,70,109,36,145,270,46,0,40,13,17,11,23,3,46,54,28,26
53,Washington/WA,5311705,"Snohomish County (Central & Southeast)--Lake Stevens & Monroe Cities PUMA, Washington/WA",53061,"Snohomish County, Washington",786620,8016,223,1019,28,1,236,0,24,51,0,0,287,0,24,0,24,24,311,76,16,0,8,0,0,0,8,92,8,0,8
53,Washington/WA,5311706,"Snohomish County (North)--Marysville & Arlington Cities PUMA, Washington/WA",53061,"Snohomish County, Washington",786620,8016,223,1019,28,1,277,51,98,57,14,0,334,65,98,14,149,163,497,56,11,3,30,3,10,0,20,67,33,13,20
53,Washington/WA,5311801,"Kitsap County (North)--Bainbridge Island City & Silverdale PUMA, Washington/WA",53035,"Kitsap County, Washington",262475,1175,14,448,5,1,88,0,0,0,0,0,88,0,0,0,0,0,88,100,0,0,0,0,0,0,0,100,0,0,0
53,Washington/WA,5311802,"Kitsap County (South)--Bremerton & Port Orchard Cities PUMA, Washington/WA",53035,"Kitsap County, Washington",262475,1175,14,448,5,1,98,0,0,0,0,0,98,0,0,0,0,0,98,100,0,0,0,0,0,0,0,100,0,0,0
53,Washington/WA,5311900,"Clallam & Jefferson Counties PUMA, Washington/WA",53009,"Clallam County, Washington",74487,228,1,306,1,0.705,87,36,75,44,0,0,131,36,75,0,111,111,242,36,18,0,46,0,15,0,31,54,46,15,31
53,Washington/WA,5311900,"Clallam & Jefferson Counties PUMA, Washington/WA",53031,"Jefferson County, Washington",30856,71,0,230,0,0.295,37,15,31,18,0,0,55,15,31,0,46,46,101,37,18,0,46,0,15,0,31,54,46,15,31
54,West Virginia/WV,5400100,"Ohio, Marshall, Hancock & Brooke Counties PUMA, West Virginia/WV",54009,"Brooke County, West Virginia",22772,111,1,487,4,0.181,40,0,0,0,0,0,40,0,0,0,0,0,40,100,0,0,0,0,0,0,0,100,0,0,0
54,West Virginia/WV,5400100,"Ohio, Marshall, Hancock & Brooke Counties PUMA, West Virginia/WV",54029,"Hancock County, West Virginia",29680,148,0,499,0,0.233,51,0,0,0,0,0,51,0,0,0,0,0,51,100,0,0,0,0,0,0,0,100,0,0,0
54,West Virginia/WV,5400100,"Ohio, Marshall, Hancock & Brooke Counties PUMA, West Virginia/WV",54051,"Marshall County, West Virginia",31645,170,1,537,3,0.251,55,0,0,0,0,0,55,0,0,0,0,0,55,100,0,0,0,0,0,0,0,100,0,0,0
54,West Virginia/WV,5400100,"Ohio, Marshall, Hancock & Brooke Counties PUMA, West Virginia/WV",54069,"Ohio County, West Virginia",42547,367,6,863,14,0.335,73,0,0,0,0,0,73,0,0,0,0,0,73,100,0,0,0,0,0,0,0,100,0,0,0
54,West Virginia/WV,5400200,"Harrison, Marion, Taylor & Doddridge Counties PUMA, West Virginia/WV",54017,"Doddridge County, West Virginia",8536,22,1,258,12,0.056,14,0,0,0,0,0,14,0,0,0,0,0,14,100,0,0,0,0,0,0,0,100,0,0,0
54,West Virginia/WV,5400200,"Harrison, Marion, Taylor & Doddridge Counties PUMA, West Virginia/WV",54033,"Harrison County, West Virginia",68209,349,9,512,13,0.455,113,0,0,0,0,0,113,0,0,0,0,0,113,100,0,0,0,0,0,0,0,100,0,0,0
54,West Virginia/WV,5400200,"Harrison, Marion, Taylor & Doddridge Counties PUMA, West Virginia/WV",54049,"Marion County, West Virginia",56497,265,3,469,5,0.376,93,0,0,0,0,0,93,0,0,0,0,0,93,100,0,0,0,0,0,0,0,100,0,0,0
54,West Virginia/WV,5400200,"Harrison, Marion, Taylor & Doddridge Counties PUMA, West Virginia/WV",54091,"Taylor County, West Virginia",16951,120,6,708,35,0.112,28,0,0,0,0,0,28,0,0,0,0,0,28,100,0,0,0,0,0,0,0,100,0,0,0
54,West Virginia/WV,5400300,"Monongalia & Preston Counties--Morgantown City PUMA, West Virginia/WV",54061,"Monongalia County, West Virginia",105252,1980,5,1881,5,0.756,104,0,0,0,0,0,104,0,0,0,0,0,104,100,0,0,0,0,0,0,0,100,0,0,0
54,West Virginia/WV,5400300,"Monongalia & Preston Counties--Morgantown City PUMA, West Virginia/WV",54077,"Preston County, West Virginia",33837,152,4,449,12,0.244,34,0,0,0,0,0,34,0,0,0,0,0,34,100,0,0,0,0,0,0,0,100,0,0,0
54,West Virginia/WV,5400400,"Berkeley, Jefferson, Mineral, Hampshire & Morgan Counties PUMA, West Virginia/WV",54003,"Berkeley County, West Virginia",113495,976,13,860,11,0.477,312,0,69,2,3,0,314,3,69,3,69,72,386,81,1,1,18,1,0,0,18,81,19,1,18
54,West Virginia/WV,5400400,"Berkeley, Jefferson, Mineral, Hampshire & Morgan Counties PUMA, West Virginia/WV",54027,"Hampshire County, West Virginia",23363,104,1,445,4,0.098,64,0,14,0,1,0,64,1,14,1,14,15,79,81,0,1,18,1,0,0,18,81,19,1,18
54,West Virginia/WV,5400400,"Berkeley, Jefferson, Mineral, Hampshire & Morgan Counties PUMA, West Virginia/WV",54037,"Jefferson County, West Virginia",56179,427,4,760,7,0.237,155,0,34,1,1,0,156,1,34,1,34,35,191,81,1,1,18,1,0,0,18,82,18,1,18
54,West Virginia/WV,5400400,"Berkeley, Jefferson, Mineral, Hampshire & Morgan Counties PUMA, West Virginia/WV",54057,"Mineral County, West Virginia",27278,172,4,631,15,0.115,75,0,17,0,1,0,75,1,17,1,17,18,93,81,0,1,18,1,0,0,18,81,19,1,18
54,West Virginia/WV,5400400,"Berkeley, Jefferson, Mineral, Hampshire & Morgan Counties PUMA, West Virginia/WV",54065,"Morgan County, West Virginia",17624,53,0,301,0,0.074,48,0,11,0,0,0,48,0,11,0,11,11,59,81,0,0,19,0,0,0,19,81,19,0,19
54,West Virginia/WV,5400500,"Randolph, Upshur, Barbour, Lewis, Hardy, Grant, Pendleton & Tucker Counties PUMA, West Virginia/WV",54001,"Barbour County, West Virginia",16730,53,1,317,6,0.133,147,9,0,9,0,4,156,9,4,4,9,13,169,87,5,2,5,0,5,2,0,92,8,5,2
54,West Virginia/WV,5400500,"Randolph, Upshur, Barbour, Lewis, Hardy, Grant, Pendleton & Tucker Counties PUMA, West Virginia/WV",54023,"Grant County, West Virginia",11641,158,7,1357,60,0.093,103,6,0,6,0,3,109,6,3,3,6,9,118,87,5,3,5,0,5,3,0,92,8,5,3
54,West Virginia/WV,5400500,"Randolph, Upshur, Barbour, Lewis, Hardy, Grant, Pendleton & Tucker Counties PUMA, West Virginia/WV",54031,"Hardy County, West Virginia",13842,88,1,636,7,0.11,122,7,0,7,0,3,129,7,3,3,7,10,139,88,5,2,5,0,5,2,0,93,7,5,2
54,West Virginia/WV,5400500,"Randolph, Upshur, Barbour, Lewis, Hardy, Grant, Pendleton & Tucker Counties PUMA, West Virginia/WV",54041,"Lewis County, West Virginia",16276,38,2,233,12,0.129,143,8,0,9,0,4,152,8,4,4,8,12,164,87,5,2,5,0,5,2,0,93,7,5,2
54,West Virginia/WV,5400500,"Randolph, Upshur, Barbour, Lewis, Hardy, Grant, Pendleton & Tucker Counties PUMA, West Virginia/WV",54071,"Pendleton County, West Virginia",7056,52,1,737,14,0.056,62,4,0,4,0,2,66,4,2,2,4,6,72,86,6,3,6,0,6,3,0,92,8,6,3
54,West Virginia/WV,5400500,"Randolph, Upshur, Barbour, Lewis, Hardy, Grant, Pendleton & Tucker Counties PUMA, West Virginia/WV",54083,"Randolph County, West Virginia",29065,240,1,826,3,0.229,254,15,0,15,0,7,269,15,7,7,15,22,291,87,5,2,5,0,5,2,0,92,8,5,2
54,West Virginia/WV,5400500,"Randolph, Upshur, Barbour, Lewis, Hardy, Grant, Pendleton & Tucker Counties PUMA, West Virginia/WV",54093,"Tucker County, West Virginia",7027,20,0,285,0,0.055,61,4,0,4,0,2,65,4,2,2,4,6,71,86,6,3,6,0,6,3,0,92,8,6,3
54,West Virginia/WV,5400500,"Randolph, Upshur, Barbour, Lewis, Hardy, Grant, Pendleton & Tucker Counties PUMA, West Virginia/WV",54097,"Upshur County, West Virginia",24605,64,0,260,0,0.195,216,13,0,13,0,6,229,13,6,6,13,19,248,87,5,2,5,0,5,2,0,92,8,5,2
54,West Virginia/WV,5400600,"Jackson, Wetzel, Roane, Braxton, Ritchie, Tyler, Gilmer & Calhoun Counties PUMA, West Virginia/WV",54007,"Braxton County, West Virginia",14282,13,0,91,0,0.134,17,0,0,0,0,0,17,0,0,0,0,0,17,100,0,0,0,0,0,0,0,100,0,0,0
54,West Virginia/WV,5400600,"Jackson, Wetzel, Roane, Braxton, Ritchie, Tyler, Gilmer & Calhoun Counties PUMA, West Virginia/WV",54013,"Calhoun County, West Virginia",7396,25,0,338,0,0.068,9,0,0,0,0,0,9,0,0,0,0,0,9,100,0,0,0,0,0,0,0,100,0,0,0
54,West Virginia/WV,5400600,"Jackson, Wetzel, Roane, Braxton, Ritchie, Tyler, Gilmer & Calhoun Counties PUMA, West Virginia/WV",54021,"Gilmer County, West Virginia",8205,43,0,524,0,0.076,10,0,0,0,0,0,10,0,0,0,0,0,10,100,0,0,0,0,0,0,0,100,0,0,0
54,West Virginia/WV,5400600,"Jackson, Wetzel, Roane, Braxton, Ritchie, Tyler, Gilmer & Calhoun Counties PUMA, West Virginia/WV",54035,"Jackson County, West Virginia",29018,259,23,893,79,0.27,35,0,0,0,0,0,35,0,0,0,0,0,35,100,0,0,0,0,0,0,0,100,0,0,0
54,West Virginia/WV,5400600,"Jackson, Wetzel, Roane, Braxton, Ritchie, Tyler, Gilmer & Calhoun Counties PUMA, West Virginia/WV",54085,"Ritchie County, West Virginia",9932,12,0,121,0,0.092,12,0,0,0,0,0,12,0,0,0,0,0,12,100,0,0,0,0,0,0,0,100,0,0,0
54,West Virginia/WV,5400600,"Jackson, Wetzel, Roane, Braxton, Ritchie, Tyler, Gilmer & Calhoun Counties PUMA, West Virginia/WV",54087,"Roane County, West Virginia",14205,49,2,345,14,0.132,17,0,0,0,0,0,17,0,0,0,0,0,17,100,0,0,0,0,0,0,0,100,0,0,0
54,West Virginia/WV,5400600,"Jackson, Wetzel, Roane, Braxton, Ritchie, Tyler, Gilmer & Calhoun Counties PUMA, West Virginia/WV",54095,"Tyler County, West Virginia",8909,16,0,180,0,0.083,11,0,0,0,0,0,11,0,0,0,0,0,11,100,0,0,0,0,0,0,0,100,0,0,0
54,West Virginia/WV,5400600,"Jackson, Wetzel, Roane, Braxton, Ritchie, Tyler, Gilmer & Calhoun Counties PUMA, West Virginia/WV",54103,"Wetzel County, West Virginia",15614,53,0,339,0,0.145,19,0,0,0,0,0,19,0,0,0,0,0,19,100,0,0,0,0,0,0,0,100,0,0,0
54,West Virginia/WV,5400700,"Wood, Pleasants & Wirt Counties PUMA, West Virginia/WV",54073,"Pleasants County, West Virginia",7507,17,3,226,40,0.077,5,0,0,0,0,0,5,0,0,0,0,0,5,100,0,0,0,0,0,0,0,100,0,0,0
54,West Virginia/WV,5400700,"Wood, Pleasants & Wirt Counties PUMA, West Virginia/WV",54105,"Wirt County, West Virginia",5797,12,0,207,0,0.059,4,0,0,0,0,0,4,0,0,0,0,0,4,100,0,0,0,0,0,0,0,100,0,0,0
54,West Virginia/WV,5400700,"Wood, Pleasants & Wirt Counties PUMA, West Virginia/WV",54107,"Wood County, West Virginia",85556,356,6,416,7,0.865,55,0,0,0,0,0,55,0,0,0,0,0,55,100,0,0,0,0,0,0,0,100,0,0,0
54,West Virginia/WV,5400800,"Cabell, Wayne & Mason Counties--Huntington City PUMA, West Virginia/WV",54011,"Cabell County, West Virginia",95318,767,10,805,10,0.588,117,0,0,0,0,0,117,0,0,0,0,0,117,100,0,0,0,0,0,0,0,100,0,0,0
54,West Virginia/WV,5400800,"Cabell, Wayne & Mason Counties--Huntington City PUMA, West Virginia/WV",54053,"Mason County, West Virginia",26939,141,6,523,22,0.164,33,0,0,0,0,0,33,0,0,0,0,0,33,100,0,0,0,0,0,0,0,100,0,0,0
54,West Virginia/WV,5400800,"Cabell, Wayne & Mason Counties--Huntington City PUMA, West Virginia/WV",54099,"Wayne County, West Virginia",40708,389,10,956,25,0.248,49,0,0,0,0,0,49,0,0,0,0,0,49,100,0,0,0,0,0,0,0,100,0,0,0
54,West Virginia/WV,5400900,"Putnam, Boone & Lincoln Counties PUMA, West Virginia/WV",54005,"Boone County, West Virginia",22817,218,1,955,4,0.226,4,0,0,0,0,0,4,0,0,0,0,0,4,100,0,0,0,0,0,0,0,100,0,0,0
54,West Virginia/WV,5400900,"Putnam, Boone & Lincoln Counties PUMA, West Virginia/WV",54043,"Lincoln County, West Virginia",21078,164,2,778,9,0.21,4,0,0,0,0,0,4,0,0,0,0,0,4,100,0,0,0,0,0,0,0,100,0,0,0
54,West Virginia/WV,5400900,"Putnam, Boone & Lincoln Counties PUMA, West Virginia/WV",54079,"Putnam County, West Virginia",56652,538,5,950,9,0.564,10,0,0,0,0,0,10,0,0,0,0,0,10,100,0,0,0,0,0,0,0,100,0,0,0
54,West Virginia/WV,5401000,"Kanawha & Clay Counties--Charleston City PUMA, West Virginia/WV",54015,"Clay County, West Virginia",8785,34,2,387,23,0.045,9,0,0,0,0,0,9,0,0,0,0,0,9,100,0,0,0,0,0,0,0,100,0,0,0
54,West Virginia/WV,5401000,"Kanawha & Clay Counties--Charleston City PUMA, West Virginia/WV",54039,"Kanawha County, West Virginia",185710,2554,76,1375,41,0.955,181,0,0,0,0,0,181,0,0,0,0,0,181,100,0,0,0,0,0,0,0,100,0,0,0
54,West Virginia/WV,5401100,"Greenbrier, Nicholas, Summers, Monroe & Pocahontas Counties PUMA, West Virginia/WV",54025,"Greenbrier County, West Virginia",35347,125,3,354,8,0.339,55,0,25,3,0,0,58,0,25,0,25,25,83,66,4,0,30,0,0,0,30,70,30,0,30
54,West Virginia/WV,5401100,"Greenbrier, Nicholas, Summers, Monroe & Pocahontas Counties PUMA, West Virginia/WV",54063,"Monroe County, West Virginia",13467,147,7,1092,52,0.129,21,0,10,1,0,0,22,0,10,0,10,10,32,66,3,0,31,0,0,0,31,69,31,0,31
54,West Virginia/WV,5401100,"Greenbrier, Nicholas, Summers, Monroe & Pocahontas Counties PUMA, West Virginia/WV",54067,"Nicholas County, West Virginia",25324,99,3,391,12,0.243,39,0,18,2,0,0,41,0,18,0,18,18,59,66,3,0,31,0,0,0,31,69,31,0,31
54,West Virginia/WV,5401100,"Greenbrier, Nicholas, Summers, Monroe & Pocahontas Counties PUMA, West Virginia/WV",54075,"Pocahontas County, West Virginia",8531,59,0,692,0,0.082,13,0,6,1,0,0,14,0,6,0,6,6,20,65,5,0,30,0,0,0,30,70,30,0,30
54,West Virginia/WV,5401100,"Greenbrier, Nicholas, Summers, Monroe & Pocahontas Counties PUMA, West Virginia/WV",54089,"Summers County, West Virginia",13018,49,0,376,0,0.124,20,0,9,1,0,0,21,0,9,0,9,9,30,67,3,0,30,0,0,0,30,70,30,0,30
54,West Virginia/WV,5401100,"Greenbrier, Nicholas, Summers, Monroe & Pocahontas Counties PUMA, West Virginia/WV",54101,"Webster County, West Virginia",8518,7,0,82,0,0.083,13,0,6,1,0,0,14,0,6,0,6,6,20,65,5,0,30,0,0,0,30,70,30,0,30
54,West Virginia/WV,5401200,"Raleigh, Mercer & Fayette Counties PUMA, West Virginia/WV",54019,"Fayette County, West Virginia",44126,599,13,1357,29,0.244,31,0,0,0,0,0,31,0,0,0,0,0,31,100,0,0,0,0,0,0,0,100,0,0,0
54,West Virginia/WV,5401200,"Raleigh, Mercer & Fayette Counties PUMA, West Virginia/WV",54055,"Mercer County, West Virginia",60486,409,28,676,46,0.333,43,0,0,0,0,0,43,0,0,0,0,0,43,100,0,0,0,0,0,0,0,100,0,0,0
54,West Virginia/WV,5401200,"Raleigh, Mercer & Fayette Counties PUMA, West Virginia/WV",54081,"Raleigh County, West Virginia",76232,501,8,657,10,0.422,54,0,0,0,0,0,54,0,0,0,0,0,54,100,0,0,0,0,0,0,0,100,0,0,0
54,West Virginia/WV,5401300,"Logan, Mingo, Wyoming & McDowell Counties PUMA, West Virginia/WV",54045,"Logan County, West Virginia",33801,606,39,1793,115,0.34,17,0,0,0,0,0,17,0,0,0,0,0,17,100,0,0,0,0,0,0,0,100,0,0,0
54,West Virginia/WV,5401300,"Logan, Mingo, Wyoming & McDowell Counties PUMA, West Virginia/WV",54047,"McDowell County, West Virginia",19217,81,0,422,0,0.193,10,0,0,0,0,0,10,0,0,0,0,0,10,100,0,0,0,0,0,0,0,100,0,0,0
54,West Virginia/WV,5401300,"Logan, Mingo, Wyoming & McDowell Counties PUMA, West Virginia/WV",54059,"Mingo County, West Virginia",24741,372,9,1504,36,0.248,13,0,0,0,0,0,13,0,0,0,0,0,13,100,0,0,0,0,0,0,0,100,0,0,0
54,West Virginia/WV,5401300,"Logan, Mingo, Wyoming & McDowell Counties PUMA, West Virginia/WV",54109,"Wyoming County, West Virginia",21711,110,3,507,14,0.219,11,0,0,0,0,0,11,0,0,0,0,0,11,100,0,0,0,0,0,0,0,100,0,0,0
55,Wisconsin/WI,5500100,"Northwest Wisconsin PUMA, Wisconsin/WI",55003,"Ashland County, Wisconsin",15712,100,2,636,13,0.09,193,4,18,2,0,3,195,4,21,3,22,25,220,88,1,1,10,0,2,1,8,89,11,2,10
55,Wisconsin/WI,5500100,"Northwest Wisconsin PUMA, Wisconsin/WI",55007,"Bayfield County, Wisconsin",14992,105,1,700,7,0.085,182,4,17,2,0,3,184,4,20,3,21,24,208,88,1,1,10,0,2,1,8,88,12,2,10
55,Wisconsin/WI,5500100,"Northwest Wisconsin PUMA, Wisconsin/WI",55013,"Burnett County, Wisconsin",15258,179,3,1173,20,0.087,186,4,17,2,0,3,188,4,20,3,21,24,212,88,1,1,10,0,2,1,8,89,11,2,9
55,Wisconsin/WI,5500100,"Northwest Wisconsin PUMA, Wisconsin/WI",55031,"Douglas County, Wisconsin",43402,421,0,970,0,0.248,531,11,48,5,0,8,536,11,56,8,59,67,603,88,1,1,10,0,2,1,8,89,11,2,9
55,Wisconsin/WI,5500100,"Northwest Wisconsin PUMA, Wisconsin/WI",55051,"Iron County, Wisconsin",5715,145,1,2537,17,0.033,71,1,6,1,0,1,72,1,7,1,7,8,80,89,1,1,9,0,1,1,8,90,10,1,9
55,Wisconsin/WI,5500100,"Northwest Wisconsin PUMA, Wisconsin/WI",55099,"Price County, Wisconsin",13490,75,0,556,0,0.077,165,3,15,2,0,3,167,3,18,3,18,21,188,88,1,2,10,0,2,2,8,89,11,2,10
55,Wisconsin/WI,5500100,"Northwest Wisconsin PUMA, Wisconsin/WI",55107,"Rusk County, Wisconsin",14183,65,1,458,7,0.081,174,3,16,2,0,3,176,3,19,3,19,22,198,88,1,2,10,0,2,2,8,89,11,2,10
55,Wisconsin/WI,5500100,"Northwest Wisconsin PUMA, Wisconsin/WI",55113,"Sawyer County, Wisconsin",16370,202,1,1234,6,0.093,199,4,18,2,0,3,201,4,21,3,22,25,226,88,1,1,10,0,2,1,8,89,11,2,9
55,Wisconsin/WI,5500100,"Northwest Wisconsin PUMA, Wisconsin/WI",55119,"Taylor County, Wisconsin",20356,170,4,835,20,0.117,251,5,23,3,0,4,254,5,27,4,28,32,286,88,1,1,10,0,2,1,8,89,11,2,9
55,Wisconsin/WI,5500100,"Northwest Wisconsin PUMA, Wisconsin/WI",55129,"Washburn County, Wisconsin",15689,102,1,650,6,0.089,191,4,17,2,0,3,193,4,20,3,21,24,217,88,1,1,10,0,2,1,8,89,11,2,9
55,Wisconsin/WI,5500101,"Madison City (Central) PUMA, Wisconsin/WI",55025,"Dane County, Wisconsin",529843,9816,41,1853,8,1,293,0,0,0,0,88,293,0,88,88,0,88,381,77,0,23,0,0,0,23,0,77,23,0,23
55,Wisconsin/WI,5500102,"Dane County (East) PUMA, Wisconsin/WI",55025,"Dane County, Wisconsin",529843,9816,41,1853,8,1,848,282,405,17,94,75,865,376,480,169,687,856,1721,49,1,10,40,5,16,4,24,50,50,22,28
55,Wisconsin/WI,5500103,"Dane County (West) PUMA, Wisconsin/WI",55025,"Dane County, Wisconsin",529843,9816,41,1853,8,1,458,0,121,0,143,0,458,143,121,143,121,264,722,63,0,20,17,20,0,0,17,63,37,20,17
55,Wisconsin/WI,5500200,"Green Bay City PUMA, Wisconsin/WI",55009,"Brown County, Wisconsin",259786,8681,62,3342,24,1,701,277,1472,410,22,226,1111,299,1698,248,1749,1997,3108,23,13,8,56,1,9,7,47,36,64,10,55
55,Wisconsin/WI,5500300,"Outer Green Bay City PUMA, Wisconsin/WI",55009,"Brown County, Wisconsin",259786,8681,62,3342,24,1,1483,0,315,172,0,0,1655,0,315,0,315,315,1970,75,9,0,16,0,0,0,16,84,16,0,16
55,Wisconsin/WI,5500600,"Oneida, Lincoln, Vilas, Langlade & Forest Counties PUMA, Wisconsin/WI",55041,"Forest County, Wisconsin",9018,260,4,2883,44,0.08,69,0,7,4,1,0,73,1,7,1,7,8,81,85,5,1,9,1,0,0,9,90,10,1,9
55,Wisconsin/WI,5500600,"Oneida, Lincoln, Vilas, Langlade & Forest Counties PUMA, Wisconsin/WI",55067,"Langlade County, Wisconsin",19164,160,2,835,10,0.17,147,0,15,10,3,0,157,3,15,3,15,18,175,84,6,2,9,2,0,0,9,90,10,2,9
55,Wisconsin/WI,5500600,"Oneida, Lincoln, Vilas, Langlade & Forest Counties PUMA, Wisconsin/WI",55069,"Lincoln County, Wisconsin",27848,197,1,707,4,0.246,213,0,22,14,4,0,227,4,22,4,22,26,253,84,6,2,9,2,0,0,9,90,10,2,9
55,Wisconsin/WI,5500600,"Oneida, Lincoln, Vilas, Langlade & Forest Counties PUMA, Wisconsin/WI",55085,"Oneida County, Wisconsin",35345,425,2,1202,6,0.314,272,0,28,18,5,0,290,5,28,5,28,33,323,84,6,2,9,2,0,0,9,90,10,2,9
55,Wisconsin/WI,5500600,"Oneida, Lincoln, Vilas, Langlade & Forest Counties PUMA, Wisconsin/WI",55125,"Vilas County, Wisconsin",21593,198,1,917,5,0.189,164,0,17,11,3,0,175,3,17,3,17,20,195,84,6,2,9,2,0,0,9,90,10,2,9
55,Wisconsin/WI,5500700,"West Central Wisconsin--Northern Mississippi Region PUMA, Wisconsin/WI",55011,"Buffalo County, Wisconsin",13167,138,2,1048,15,0.064,234,2,41,2,5,0,236,7,41,5,43,48,284,82,1,2,15,2,1,0,14,83,17,2,14
55,Wisconsin/WI,5500700,"West Central Wisconsin--Northern Mississippi Region PUMA, Wisconsin/WI",55023,"Crawford County, Wisconsin",16288,160,0,982,0,0.08,293,2,51,3,6,0,296,8,51,6,53,59,355,83,1,2,15,2,1,0,14,83,17,2,14
55,Wisconsin/WI,5500700,"West Central Wisconsin--Northern Mississippi Region PUMA, Wisconsin/WI",55053,"Jackson County, Wisconsin",20506,137,1,668,5,0.1,366,3,63,3,8,0,369,11,63,8,66,74,443,83,1,2,15,2,1,0,14,83,17,2,14
55,Wisconsin/WI,5500700,"West Central Wisconsin--Northern Mississippi Region PUMA, Wisconsin/WI",55081,"Monroe County, Wisconsin",45502,489,2,1075,4,0.223,817,7,141,7,17,0,824,24,141,17,148,165,989,83,1,2,15,2,1,0,14,83,17,2,14
55,Wisconsin/WI,5500700,"West Central Wisconsin--Northern Mississippi Region PUMA, Wisconsin/WI",55091,"Pepin County, Wisconsin",7262,61,0,840,0,0.036,132,1,23,1,3,0,133,4,23,3,24,27,160,82,1,2,15,2,1,0,14,83,17,2,14
55,Wisconsin/WI,5500700,"West Central Wisconsin--Northern Mississippi Region PUMA, Wisconsin/WI",55093,"Pierce County, Wisconsin",41603,668,7,1606,17,0.202,740,6,128,7,16,0,747,22,128,16,134,150,897,82,1,2,15,2,1,0,14,83,17,2,14
55,Wisconsin/WI,5500700,"West Central Wisconsin--Northern Mississippi Region PUMA, Wisconsin/WI",55121,"Trempealeau County, Wisconsin",29438,627,2,2130,7,0.145,531,4,92,5,11,0,536,15,92,11,96,107,643,83,1,2,15,2,1,0,14,83,17,2,14
55,Wisconsin/WI,5500700,"West Central Wisconsin--Northern Mississippi Region PUMA, Wisconsin/WI",55123,"Vernon County, Wisconsin",30516,213,0,698,0,0.151,553,5,96,5,12,0,558,17,96,12,101,113,671,82,1,2,15,2,1,0,14,83,17,3,14
55,Wisconsin/WI,5500800,"Grant, Green, Iowa, Richland & Lafayette Counties PUMA, Wisconsin/WI",55043,"Grant County, Wisconsin",51828,968,19,1868,37,0.355,1132,7,97,39,12,43,1171,19,140,55,104,159,1330,85,3,4,8,1,1,3,7,88,12,1,11
55,Wisconsin/WI,5500800,"Grant, Green, Iowa, Richland & Lafayette Counties PUMA, Wisconsin/WI",55045,"Green County, Wisconsin",36864,495,2,1343,5,0.252,804,5,69,27,9,31,831,14,100,40,74,114,945,85,3,4,8,1,1,3,7,88,12,1,11
55,Wisconsin/WI,5500800,"Grant, Green, Iowa, Richland & Lafayette Counties PUMA, Wisconsin/WI",55049,"Iowa County, Wisconsin",23620,201,0,851,0,0.161,514,3,44,18,5,20,532,8,64,25,47,72,604,85,3,4,8,1,0,3,7,88,12,1,11
55,Wisconsin/WI,5500800,"Grant, Green, Iowa, Richland & Lafayette Counties PUMA, Wisconsin/WI",55065,"Lafayette County, Wisconsin",16735,266,0,1589,0,0.114,364,2,31,12,4,14,376,6,45,18,33,51,427,85,3,4,8,1,0,3,7,88,12,1,11
55,Wisconsin/WI,5500800,"Grant, Green, Iowa, Richland & Lafayette Counties PUMA, Wisconsin/WI",55103,"Richland County, Wisconsin",17539,129,4,736,23,0.119,380,2,33,13,4,15,393,6,48,19,35,54,447,85,3,4,8,1,0,3,7,88,12,1,11
55,Wisconsin/WI,5500900,"La Crosse County PUMA, Wisconsin/WI",55063,"La Crosse County, Wisconsin",117850,3098,2,2629,2,1,604,0,0,0,61,0,604,61,0,61,0,61,665,91,0,9,0,9,0,0,0,91,9,9,0
55,Wisconsin/WI,5501000,"Sauk & Columbia Counties PUMA, Wisconsin/WI",55021,"Columbia County, Wisconsin",56954,622,2,1092,4,0.471,693,0,87,26,0,4,719,0,91,4,87,91,810,86,3,0,11,0,0,0,11,89,11,0,11
55,Wisconsin/WI,5501000,"Sauk & Columbia Counties PUMA, Wisconsin/WI",55111,"Sauk County, Wisconsin",63596,927,3,1458,5,0.529,779,0,98,30,0,5,809,0,103,5,98,103,912,85,3,1,11,0,0,1,11,89,11,0,11
55,Wisconsin/WI,5501001,"Dodge & Jefferson Counties PUMA, Wisconsin/WI",55027,"Dodge County, Wisconsin",87776,1806,14,2058,16,0.51,1119,32,278,3,0,66,1122,32,344,66,310,376,1498,75,0,4,21,0,2,4,19,75,25,2,23
55,Wisconsin/WI,5501001,"Dodge & Jefferson Counties PUMA, Wisconsin/WI",55055,"Jefferson County, Wisconsin",84652,1405,8,1660,9,0.49,1075,30,267,3,0,64,1078,30,331,64,297,361,1439,75,0,4,21,0,2,4,19,75,25,2,23
55,Wisconsin/WI,5501300,"Marinette, Oconto, Door & Florence Counties PUMA, Wisconsin/WI",55029,"Door County, Wisconsin",27439,328,3,1195,11,0.251,271,12,43,0,0,0,271,12,43,0,55,55,326,83,0,0,17,0,4,0,13,83,17,4,13
55,Wisconsin/WI,5501300,"Marinette, Oconto, Door & Florence Counties PUMA, Wisconsin/WI",55037,"Florence County, Wisconsin",4337,87,1,2006,23,0.041,44,2,7,0,0,0,44,2,7,0,9,9,53,83,0,0,17,0,4,0,13,83,17,4,13
55,Wisconsin/WI,5501300,"Marinette, Oconto, Door & Florence Counties PUMA, Wisconsin/WI",55075,"Marinette County, Wisconsin",40537,873,8,2154,20,0.368,397,17,64,0,0,0,397,17,64,0,81,81,478,83,0,0,17,0,4,0,13,83,17,4,13
55,Wisconsin/WI,5501300,"Marinette, Oconto, Door & Florence Counties PUMA, Wisconsin/WI",55083,"Oconto County, Wisconsin",37556,841,4,2239,11,0.34,367,16,59,0,0,0,367,16,59,0,75,75,442,83,0,0,17,0,4,0,13,83,17,4,13
55,Wisconsin/WI,5501301,"Manitowoc & Kewaunee Counties PUMA, Wisconsin/WI",55061,"Kewaunee County, Wisconsin",20360,491,2,2412,10,0.204,374,4,65,19,6,1,393,10,66,7,69,76,469,80,4,1,15,1,1,0,14,84,16,2,14
55,Wisconsin/WI,5501301,"Manitowoc & Kewaunee Counties PUMA, Wisconsin/WI",55071,"Manitowoc County, Wisconsin",79407,1071,3,1349,4,0.796,1457,18,256,75,21,6,1532,39,262,27,274,301,1833,79,4,1,15,1,1,0,14,84,16,2,14
55,Wisconsin/WI,5501400,"East Central Wisconsin PUMA, Wisconsin/WI",55047,"Green Lake County, Wisconsin",18757,295,0,1573,0,0.121,452,14,49,32,0,2,484,14,51,2,63,65,549,82,6,0,11,0,3,0,9,88,12,3,9
55,Wisconsin/WI,5501400,"East Central Wisconsin PUMA, Wisconsin/WI",55077,"Marquette County, Wisconsin",15207,246,1,1618,7,0.097,362,11,39,26,0,1,388,11,40,1,50,51,439,82,6,0,11,0,3,0,9,88,12,3,9
55,Wisconsin/WI,5501400,"East Central Wisconsin PUMA, Wisconsin/WI",55078,"Menominee County, Wisconsin",4579,63,0,1376,0,0.029,108,3,12,8,0,0,116,3,12,0,15,15,131,82,6,0,11,0,2,0,9,89,11,2,9
55,Wisconsin/WI,5501400,"East Central Wisconsin PUMA, Wisconsin/WI",55115,"Shawano County, Wisconsin",41009,737,1,1797,2,0.265,990,31,108,71,1,4,1061,32,112,5,139,144,1205,82,6,0,12,0,3,0,9,88,12,3,9
55,Wisconsin/WI,5501400,"East Central Wisconsin PUMA, Wisconsin/WI",55135,"Waupaca County, Wisconsin",51444,1096,20,2130,39,0.332,1241,39,135,89,1,5,1330,40,140,6,174,180,1510,82,6,0,12,0,3,0,9,88,12,3,9
55,Wisconsin/WI,5501400,"East Central Wisconsin PUMA, Wisconsin/WI",55137,"Waushara County, Wisconsin",24116,326,2,1352,8,0.156,583,18,63,42,1,2,625,19,65,3,81,84,709,82,6,0,11,0,3,0,9,88,12,3,9
55,Wisconsin/WI,5501401,"Fond du Lac & Calumet Counties PUMA, Wisconsin/WI",55015,"Calumet County, Wisconsin",49807,1056,3,2120,6,0.327,922,18,76,23,0,43,945,18,119,43,94,137,1082,85,2,4,9,0,2,4,7,87,13,2,11
55,Wisconsin/WI,5501401,"Fond du Lac & Calumet Counties PUMA, Wisconsin/WI",55039,"Fond du Lac County, Wisconsin",102315,2005,13,1960,13,0.673,1899,37,155,48,0,90,1947,37,245,90,192,282,2229,85,2,4,9,0,2,4,7,87,13,2,11
55,Wisconsin/WI,5501500,"Outagamie County PUMA, Wisconsin/WI",55087,"Outagamie County, Wisconsin",184754,4265,29,2308,16,1,1403,121,373,38,74,219,1441,195,592,293,494,787,2228,63,2,13,22,3,5,10,17,65,35,9,27
55,Wisconsin/WI,5501501,"Winnebago County PUMA, Wisconsin/WI",55139,"Winnebago County, Wisconsin",169926,3519,25,2071,15,1,547,0,136,100,0,93,647,0,229,93,136,229,876,62,11,11,16,0,0,11,16,74,26,0,26
55,Wisconsin/WI,5501600,"Marathon County PUMA, Wisconsin/WI",55073,"Marathon County, Wisconsin",135264,1333,14,985,10,1,2028,33,569,66,179,69,2094,212,638,248,602,850,2944,69,2,8,20,6,1,2,19,71,29,7,22
55,Wisconsin/WI,5501601,"Central Sands--Wood, Portage, Juneau & Adams Counties PUMA, Wisconsin/WI",55001,"Adams County, Wisconsin",20073,239,4,1191,20,0.106,380,1,51,24,6,1,404,7,52,7,52,59,463,82,5,2,11,1,0,0,11,87,13,2,11
55,Wisconsin/WI,5501601,"Central Sands--Wood, Portage, Juneau & Adams Counties PUMA, Wisconsin/WI",55057,"Juneau County, Wisconsin",26419,368,2,1393,8,0.138,494,1,67,31,7,1,525,8,68,8,68,76,601,82,5,1,11,1,0,0,11,87,13,1,11
55,Wisconsin/WI,5501601,"Central Sands--Wood, Portage, Juneau & Adams Counties PUMA, Wisconsin/WI",55097,"Portage County, Wisconsin",70599,1372,4,1943,6,0.371,1329,2,180,85,20,2,1414,22,182,22,182,204,1618,82,5,1,11,1,0,0,11,87,13,1,11
55,Wisconsin/WI,5501601,"Central Sands--Wood, Portage, Juneau & Adams Counties PUMA, Wisconsin/WI",55141,"Wood County, Wisconsin",73274,808,5,1103,7,0.385,1379,2,186,88,21,2,1467,23,188,23,188,211,1678,82,5,1,11,1,0,0,11,87,13,1,11
55,Wisconsin/WI,5502400,"Rock County PUMA, Wisconsin/WI",55105,"Rock County, Wisconsin",161769,2641,32,1633,20,1,1997,113,430,225,26,45,2222,139,475,71,543,614,2836,70,8,3,19,1,4,2,15,78,22,5,17
55,Wisconsin/WI,5502500,"Sheboygan County PUMA, Wisconsin/WI",55117,"Sheboygan County, Wisconsin",115205,1610,16,1398,14,1,1592,0,252,11,361,28,1603,361,280,389,252,641,2244,71,0,17,11,16,0,1,11,71,29,16,12
55,Wisconsin/WI,5510000,"Kenosha County PUMA, Wisconsin/WI",55059,"Kenosha County, Wisconsin",168330,3829,65,2275,39,1,521,25,184,170,25,0,691,50,184,25,209,234,925,56,18,3,23,3,3,0,20,75,25,5,20
55,Wisconsin/WI,5520000,"Washington & Ozaukee Counties PUMA, Wisconsin/WI",55089,"Ozaukee County, Wisconsin",88284,1399,19,1585,22,0.397,244,0,32,11,0,0,255,0,32,0,32,32,287,85,4,0,11,0,0,0,11,89,11,0,11
55,Wisconsin/WI,5520000,"Washington & Ozaukee Counties PUMA, Wisconsin/WI",55131,"Washington County, Wisconsin",134535,2569,32,1910,24,0.603,371,0,49,16,0,0,387,0,49,0,49,49,436,85,4,0,11,0,0,0,11,89,11,0,11
55,Wisconsin/WI,5530000,"Racine County PUMA, Wisconsin/WI",55101,"Racine County, Wisconsin",195398,5200,95,2661,49,1,857,14,95,226,0,0,1083,14,95,0,109,109,1192,72,19,0,9,0,1,0,8,91,9,1,8
55,Wisconsin/WI,5540101,"Milwaukee County (Northeast) PUMA, Wisconsin/WI",55079,"Milwaukee County, Wisconsin",954209,29640,527,3106,55,1,142,0,0,0,0,0,142,0,0,0,0,0,142,100,0,0,0,0,0,0,0,100,0,0,0
55,Wisconsin/WI,5540301,"Milwaukee County (South) PUMA, Wisconsin/WI",55079,"Milwaukee County, Wisconsin",954209,29640,527,3106,55,1,215,0,184,56,214,84,271,214,268,298,184,482,753,29,7,40,24,28,0,11,24,36,64,28,36
55,Wisconsin/WI,5540701,"Milwaukee County (West) PUMA, Wisconsin/WI",55079,"Milwaukee County, Wisconsin",954209,29640,527,3106,55,1,450,74,31,221,90,0,671,164,31,90,105,195,866,52,26,10,12,10,9,0,4,77,23,19,4
55,Wisconsin/WI,5541001,"Milwaukee City (North) PUMA, Wisconsin/WI",55079,"Milwaukee County, Wisconsin",954209,29640,527,3106,55,1,60,0,0,21,0,19,81,0,19,19,0,19,100,60,21,19,0,0,0,19,0,81,19,0,19
55,Wisconsin/WI,5541002,"Milwaukee City (North Central) PUMA, Wisconsin/WI",55079,"Milwaukee County, Wisconsin",954209,29640,527,3106,55,1,502,0,57,88,13,0,590,13,57,13,57,70,660,76,13,2,9,2,0,0,9,89,11,2,9
55,Wisconsin/WI,5541003,"Milwaukee City (Central) PUMA, Wisconsin/WI",55079,"Milwaukee County, Wisconsin",954209,29640,527,3106,55,1,258,0,0,21,0,57,279,0,57,57,0,57,336,77,6,17,0,0,0,17,0,83,17,0,17
55,Wisconsin/WI,5541004,"Milwaukee City (South Central) PUMA, Wisconsin/WI",55079,"Milwaukee County, Wisconsin",954209,29640,527,3106,55,1,174,120,760,470,0,0,644,120,760,0,880,880,1524,11,31,0,58,0,8,0,50,42,58,8,50
55,Wisconsin/WI,5541005,"Milwaukee City (South) PUMA, Wisconsin/WI",55079,"Milwaukee County, Wisconsin",954209,29640,527,3106,55,1,190,0,176,205,0,501,395,0,677,501,176,677,1072,18,19,47,16,0,0,47,16,37,63,0,63
55,Wisconsin/WI,5550000,"Walworth County PUMA, Wisconsin/WI",55127,"Walworth County, Wisconsin",103013,2695,35,2616,34,1,846,72,325,73,144,0,919,216,325,144,397,541,1460,58,5,10,27,10,5,0,22,63,37,15,22
55,Wisconsin/WI,5555101,"Barron, Polk, Clark & Chippewa (North) Counties PUMA, Wisconsin/WI",55005,"Barron County, Wisconsin",45252,465,4,1028,9,0.343,1286,37,157,48,21,53,1334,58,210,74,194,268,1602,80,3,5,12,1,2,3,10,83,17,4,13
55,Wisconsin/WI,5555101,"Barron, Polk, Clark & Chippewa (North) Counties PUMA, Wisconsin/WI",55017,"Chippewa County, Wisconsin",63635,543,0,853,0,0.068,255,7,31,10,4,11,265,11,42,15,38,53,318,80,3,5,12,1,2,3,10,83,17,3,13
55,Wisconsin/WI,5555101,"Barron, Polk, Clark & Chippewa (North) Counties PUMA, Wisconsin/WI",55019,"Clark County, Wisconsin",34491,405,8,1174,23,0.261,979,28,119,37,16,40,1016,44,159,56,147,203,1219,80,3,5,12,1,2,3,10,83,17,4,13
55,Wisconsin/WI,5555101,"Barron, Polk, Clark & Chippewa (North) Counties PUMA, Wisconsin/WI",55095,"Polk County, Wisconsin",43349,246,2,567,5,0.328,1230,36,150,46,20,51,1276,56,201,71,186,257,1533,80,3,5,12,1,2,3,10,83,17,4,13
55,Wisconsin/WI,5555102,"St. Croix & Dunn Counties PUMA, Wisconsin/WI",55033,"Dunn County, Wisconsin",44498,497,0,1117,0,0.337,442,0,47,3,0,0,445,0,47,0,47,47,492,90,1,0,10,0,0,0,10,90,10,0,10
55,Wisconsin/WI,5555102,"St. Croix & Dunn Counties PUMA, Wisconsin/WI",55109,"St. Croix County, Wisconsin",87917,949,8,1079,9,0.663,871,0,93,7,0,0,878,0,93,0,93,93,971,90,1,0,10,0,0,0,10,90,10,0,10
55,Wisconsin/WI,5555103,"Eau Claire & Chippewa (South) Counties PUMA, Wisconsin/WI",55017,"Chippewa County, Wisconsin",63635,543,0,853,0,0.346,439,0,0,0,33,0,439,33,0,33,0,33,472,93,0,7,0,7,0,0,0,93,7,7,0
55,Wisconsin/WI,5555103,"Eau Claire & Chippewa (South) Counties PUMA, Wisconsin/WI",55035,"Eau Claire County, Wisconsin",102991,1797,6,1745,6,0.654,831,0,0,0,63,0,831,63,0,63,0,63,894,93,0,7,0,7,0,0,0,93,7,7,0
55,Wisconsin/WI,5570101,"Waukesha County (West) PUMA, Wisconsin/WI",55133,"Waukesha County, Wisconsin",398879,7740,87,1940,22,1,198,0,3,0,91,26,198,91,29,117,3,120,318,62,0,37,1,29,0,8,1,62,38,29,9
55,Wisconsin/WI,5570201,"Waukesha County (East) PUMA, Wisconsin/WI",55133,"Waukesha County, Wisconsin",398879,7740,87,1940,22,1,169,0,2,0,29,0,169,29,2,29,2,31,200,84,0,14,1,14,0,0,1,84,16,14,1
55,Wisconsin/WI,5570301,"Waukesha County (Central) PUMA, Wisconsin/WI",55133,"Waukesha County, Wisconsin",398879,7740,87,1940,22,1,420,0,61,33,0,0,453,0,61,0,61,61,514,82,6,0,12,0,0,0,12,88,12,0,12
56,Wyoming/WY,5600100,"Sheridan, Park, Teton, Lincoln & Big Horn Counties PUMA, Wyoming/WY",56003,"Big Horn County, Wyoming",11901,54,2,454,17,0.105,61,0,2,0,0,0,61,0,2,0,2,2,63,97,0,0,3,0,0,0,3,97,3,0,3
56,Wyoming/WY,5600100,"Sheridan, Park, Teton, Lincoln & Big Horn Counties PUMA, Wyoming/WY",56023,"Lincoln County, Wyoming",19011,170,1,894,5,0.168,97,0,4,0,0,0,97,0,4,0,4,4,101,96,0,0,4,0,0,0,4,96,4,0,4
56,Wyoming/WY,5600100,"Sheridan, Park, Teton, Lincoln & Big Horn Counties PUMA, Wyoming/WY",56029,"Park County, Wyoming",29121,227,2,780,7,0.258,149,0,5,0,0,0,149,0,5,0,5,5,154,97,0,0,3,0,0,0,3,97,3,0,3
56,Wyoming/WY,5600100,"Sheridan, Park, Teton, Lincoln & Big Horn Counties PUMA, Wyoming/WY",56033,"Sheridan County, Wyoming",30012,272,4,906,13,0.265,153,0,6,0,0,0,153,0,6,0,6,6,159,96,0,0,4,0,0,0,4,96,4,0,4
56,Wyoming/WY,5600100,"Sheridan, Park, Teton, Lincoln & Big Horn Counties PUMA, Wyoming/WY",56039,"Teton County, Wyoming",23059,532,1,2307,4,0.204,118,0,4,0,0,0,118,0,4,0,4,4,122,97,0,0,3,0,0,0,3,97,3,0,3
56,Wyoming/WY,5600200,"Campbell, Goshen, Platte, Johnson, Washakie, Weston, Crook & Niobrara Counties PUMA, Wyoming/WY",56005,"Campbell County, Wyoming",47708,294,1,616,2,0.466,459,0,30,77,5,0,536,5,30,5,30,35,571,80,13,1,5,1,0,0,5,94,6,1,5
56,Wyoming/WY,5600200,"Campbell, Goshen, Platte, Johnson, Washakie, Weston, Crook & Niobrara Counties PUMA, Wyoming/WY",56011,"Crook County, Wyoming",7410,40,0,540,0,0.071,70,0,5,12,1,0,82,1,5,1,5,6,88,80,14,1,6,1,0,0,6,93,7,1,6
56,Wyoming/WY,5600200,"Campbell, Goshen, Platte, Johnson, Washakie, Weston, Crook & Niobrara Counties PUMA, Wyoming/WY",56015,"Goshen County, Wyoming",13438,86,2,640,15,0.128,126,0,8,21,1,0,147,1,8,1,8,9,156,81,13,1,5,1,0,0,5,94,6,1,5
56,Wyoming/WY,5600200,"Campbell, Goshen, Platte, Johnson, Washakie, Weston, Crook & Niobrara Counties PUMA, Wyoming/WY",56019,"Johnson County, Wyoming",8515,33,1,388,12,0.081,80,0,5,13,1,0,93,1,5,1,5,6,99,81,13,1,5,1,0,0,5,94,6,1,5
56,Wyoming/WY,5600200,"Campbell, Goshen, Platte, Johnson, Washakie, Weston, Crook & Niobrara Counties PUMA, Wyoming/WY",56027,"Niobrara County, Wyoming",2448,4,0,163,0,0.024,24,0,2,4,0,0,28,0,2,0,2,2,30,80,13,0,7,0,0,0,7,93,7,0,7
56,Wyoming/WY,5600200,"Campbell, Goshen, Platte, Johnson, Washakie, Weston, Crook & Niobrara Counties PUMA, Wyoming/WY",56031,"Platte County, Wyoming",8673,27,1,311,12,0.083,82,0,5,14,1,0,96,1,5,1,5,6,102,80,14,1,5,1,0,0,5,94,6,1,5
56,Wyoming/WY,5600200,"Campbell, Goshen, Platte, Johnson, Washakie, Weston, Crook & Niobrara Counties PUMA, Wyoming/WY",56043,"Washakie County, Wyoming",8129,113,6,1390,74,0.079,78,0,5,13,1,0,91,1,5,1,5,6,97,80,13,1,5,1,0,0,5,94,6,1,5
56,Wyoming/WY,5600200,"Campbell, Goshen, Platte, Johnson, Washakie, Weston, Crook & Niobrara Counties PUMA, Wyoming/WY",56045,"Weston County, Wyoming",7100,35,0,493,0,0.069,68,0,4,11,1,0,79,1,4,1,4,5,84,81,13,1,5,1,0,0,5,94,6,1,5
56,Wyoming/WY,5600300,"Laramie & Albany Counties PUMA, Wyoming/WY",56001,"Albany County, Wyoming",38102,480,0,1260,0,0.28,80,8,0,0,0,0,80,8,0,0,8,8,88,91,0,0,9,0,9,0,0,91,9,9,0
56,Wyoming/WY,5600300,"Laramie & Albany Counties PUMA, Wyoming/WY",56021,"Laramie County, Wyoming",97692,678,4,694,4,0.72,204,19,0,0,0,0,204,19,0,0,19,19,223,91,0,0,9,0,9,0,0,91,9,9,0
56,Wyoming/WY,5600400,"Natrona, Carbon & Converse Counties PUMA, Wyoming/WY",56007,"Carbon County, Wyoming",15477,222,2,1434,13,0.141,86,0,10,0,0,0,86,0,10,0,10,10,96,90,0,0,10,0,0,0,10,90,10,0,10
56,Wyoming/WY,5600400,"Natrona, Carbon & Converse Counties PUMA, Wyoming/WY",56009,"Converse County, Wyoming",13997,113,0,807,0,0.128,78,0,9,0,0,0,78,0,9,0,9,9,87,90,0,0,10,0,0,0,10,90,10,0,10
56,Wyoming/WY,5600400,"Natrona, Carbon & Converse Counties PUMA, Wyoming/WY",56025,"Natrona County, Wyoming",80610,528,4,655,5,0.731,446,0,54,0,0,0,446,0,54,0,54,54,500,89,0,0,11,0,0,0,11,89,11,0,11
56,Wyoming/WY,5600500,"Sweetwater, Fremont, Uinta, Sublette & Hot Springs Counties--Wind River Reservation PUMA, Wyoming/WY",56013,"Fremont County, Wyoming",40076,699,14,1744,35,0.336,196,0,1,18,10,0,214,10,1,10,1,11,225,87,8,4,0,4,0,0,0,95,5,4,0
56,Wyoming/WY,5600500,"Sweetwater, Fremont, Uinta, Sublette & Hot Springs Counties--Wind River Reservation PUMA, Wyoming/WY",56017,"Hot Springs County, Wyoming",4680,38,0,812,0,0.039,23,0,0,2,1,0,25,1,0,1,0,1,26,88,8,4,0,4,0,0,0,96,4,4,0
56,Wyoming/WY,5600500,"Sweetwater, Fremont, Uinta, Sublette & Hot Springs Counties--Wind River Reservation PUMA, Wyoming/WY",56035,"Sublette County, Wyoming",9951,95,1,955,10,0.082,48,0,0,5,2,0,53,2,0,2,0,2,55,87,9,4,0,4,0,0,0,96,4,4,0
56,Wyoming/WY,5600500,"Sweetwater, Fremont, Uinta, Sublette & Hot Springs Counties--Wind River Reservation PUMA, Wyoming/WY",56037,"Sweetwater County, Wyoming",44117,332,2,753,5,0.369,215,0,1,20,11,0,235,11,1,11,1,12,247,87,8,4,0,4,0,0,0,95,5,4,0
56,Wyoming/WY,5600500,"Sweetwater, Fremont, Uinta, Sublette & Hot Springs Counties--Wind River Reservation PUMA, Wyoming/WY",56041,"Uinta County, Wyoming",20609,348,2,1689,10,0.174,101,0,1,10,5,0,111,5,1,5,1,6,117,86,9,4,1,4,0,0,1,95,5,4,1
